JURISDICTIONCODE,NAME,Year,Total_Taxable_Property_Values,Total_Tax_Exempt_Values,Total,Taxable_as_a___of_Total,Tax_Exempt_as_a___of_Total
1,Abington,2003,995841000,72358700,1068199700,93.23,6.77
1,Abington,2004,1494676600,98304800,1592981400,93.83,6.17
1,Abington,2005,1787735400,120765300,1908500700,93.67,6.33
1,Abington,2006,1984637500,134319900,2118957400,93.66,6.34
1,Abington,2007,2027507500,134031900,2161539400,93.8,6.2
1,Abington,2008,1999801200,131676400,2131477600,93.82,6.18
1,Abington,2009,1975647800,131646900,2107294700,93.75,6.25
1,Abington,2010,1841792600,131518083,1973310683,93.34,6.66
1,Abington,2011,1775754800,132219183,1907973983,93.07,6.93
1,Abington,2012,1766231234,134381849,1900613083,92.93,7.07
1,Abington,2013,1694292700,132476000,1826768700,92.75,7.25
1,Abington,2014,1654752800,130937400,1785690200,92.67,7.33
1,Abington,2015,1725866400,131535400,1857401800,92.92,7.08
1,Abington,2016,1762181100,131497500,1893678600,93.06,6.94
2,Acton,2003,3093786673,180640900,3274427573,94.48,5.52
2,Acton,2004,3328663383,197857800,3526521183,94.39,5.61
2,Acton,2005,3542254777,197857800,3740112577,94.71,5.29
2,Acton,2006,3776365916,215158500,3991524416,94.61,5.39
2,Acton,2007,3947971323,244198800,4192170123,94.17,5.83
2,Acton,2008,3851376136,245444300,4096820436,94.01,5.99
2,Acton,2009,3751255130,241192800,3992447930,93.96,6.04
2,Acton,2010,3741421414,239375500,3980796914,93.99,6.01
2,Acton,2011,3640773825,245960000,3886733825,93.67,6.33
2,Acton,2012,3641550118,245361400,3886911518,93.69,6.31
2,Acton,2013,3679116507,270067600,3949184107,93.16,6.84
2,Acton,2014,3716266225,270760700,3987026925,93.21,6.79
2,Acton,2015,3905754158,271518900,4177273058,93.5,6.5
2,Acton,2016,4034183348,286688100,4320871448,93.37,6.63
3,Acushnet,2003,576639752,38811000,615450752,93.69,6.31
3,Acushnet,2004,840287333,48710016,888997349,94.52,5.48
3,Acushnet,2005,963001911,50979916,1013981827,94.97,5.03
3,Acushnet,2006,1118644873,56376512,1175021385,95.2,4.8
3,Acushnet,2007,1238612324,59074456,1297686780,95.45,4.55
3,Acushnet,2008,1256193644,58267856,1314461500,95.57,4.43
3,Acushnet,2009,1249728518,57737856,1307466374,95.58,4.42
3,Acushnet,2010,1191724554,58361956,1250086510,95.33,4.67
3,Acushnet,2011,1126630210,57306102,1183936312,95.16,4.84
3,Acushnet,2012,1065467881,55210600,1120678481,95.07,4.93
3,Acushnet,2013,1035820941,55567300,1091388241,94.91,5.09
3,Acushnet,2014,1011828885,54372600,1066201485,94.9,5.1
3,Acushnet,2015,1022874645,54575900,1077450545,94.93,5.07
3,Acushnet,2016,1062424323,54410600,1116834923,95.13,4.87
4,Adams,2003,340456200,43747600,384203800,88.61,11.39
4,Adams,2004,341238800,45481400,386720200,88.24,11.76
4,Adams,2005,357934500,43930300,401864800,89.07,10.93
4,Adams,2006,451142517,56786700,507929217,88.82,11.18
4,Adams,2007,451870547,56886000,508756547,88.82,11.18
4,Adams,2008,472461771,59489900,531951671,88.82,11.18
4,Adams,2009,492008878,62310400,554319278,88.76,11.24
4,Adams,2010,494010962,67514100,561525062,87.98,12.02
4,Adams,2011,496897189,67337300,564234489,88.07,11.93
4,Adams,2012,494039099,67312700,561351799,88.01,11.99
4,Adams,2013,465558447,63405600,528964047,88.01,11.99
4,Adams,2014,466302433,63926300,530228733,87.94,12.06
4,Adams,2015,470221030,63502100,533723130,88.1,11.9
4,Adams,2016,482882333,62994800,545877133,88.46,11.54
5,Agawam,2003,1916018984,257135920,2173154904,88.17,11.83
5,Agawam,2004,2016303057,258476360,2274779417,88.64,11.36
5,Agawam,2005,2231893423,292791760,2524685183,88.4,11.6
5,Agawam,2006,2583304394,313547180,2896851574,89.18,10.82
5,Agawam,2007,2741090684,318243900,3059334584,89.6,10.4
5,Agawam,2008,2855698631,319257400,3174956031,89.94,10.06
5,Agawam,2009,2864660697,391294756,3255955453,87.98,12.02
5,Agawam,2010,2796296393,388207312,3184503705,87.81,12.19
5,Agawam,2011,2689617727,368638044,3058255771,87.95,12.05
5,Agawam,2012,2715790563,368726244,3084516807,88.05,11.95
5,Agawam,2013,2701515986,370821636,3072337622,87.93,12.07
5,Agawam,2014,2760508610,370871336,3131379946,88.16,11.84
5,Agawam,2015,2812761280,371583836,3184345116,88.33,11.67
5,Agawam,2016,2807578717,375404556,3182983273,88.21,11.79
6,Alford,2003,122412325,1665969,124078294,98.66,1.34
6,Alford,2004,127427095,1718769,129145864,98.67,1.33
6,Alford,2005,180734950,2440400,183175350,98.67,1.33
6,Alford,2006,187219707,2440400,189660107,98.71,1.29
6,Alford,2007,194342991,2440400,196783391,98.76,1.24
6,Alford,2008,247216237,3686100,250902337,98.53,1.47
6,Alford,2009,250117176,3686100,253803276,98.55,1.45
6,Alford,2010,249106377,4592200,253698577,98.19,1.81
6,Alford,2011,253843343,4499900,258343243,98.26,1.74
6,Alford,2012,256673118,4505000,261178118,98.28,1.72
6,Alford,2013,262073161,5105300,267178461,98.09,1.91
6,Alford,2014,269041302,5584900,274626202,97.97,2.03
6,Alford,2015,271040108,5589300,276629408,97.98,2.02
6,Alford,2016,273428704,5742500,279171204,97.94,2.06
7,Amesbury,2003,1380507630,163059600,1543567230,89.44,10.56
7,Amesbury,2004,1605365800,183825600,1789191400,89.73,10.27
7,Amesbury,2005,1819211110,169884600,1989095710,91.46,8.54
7,Amesbury,2006,2022526070,175931100,2198457170,92,8
7,Amesbury,2007,2108698590,184768000,2293466590,91.94,8.06
7,Amesbury,2008,2045958833,225419950,2271378783,90.08,9.92
7,Amesbury,2009,1977220345,227185290,2204405635,89.69,10.31
7,Amesbury,2010,1907592445,192536970,2100129415,90.83,9.17
7,Amesbury,2011,1850966073,182180110,2033146183,91.04,8.96
7,Amesbury,2012,1841900043,178329200,2020229243,91.17,8.83
7,Amesbury,2013,1774921435,174861500,1949782935,91.03,8.97
7,Amesbury,2014,1759014345,179178900,1938193245,90.76,9.24
7,Amesbury,2015,1844082827,180000100,2024082927,91.11,8.89
7,Amesbury,2016,1917185149,185043360,2102228509,91.2,8.8
8,Amherst,2003,1448569000,332456900,1781025900,81.33,18.67
8,Amherst,2004,1485946000,344730700,1830676700,81.17,18.83
8,Amherst,2005,1713756900,402089200,2115846100,81,19
8,Amherst,2006,2027621762,437820800,2465442562,82.24,17.76
8,Amherst,2007,2045921630,403409700,2449331330,83.53,16.47
8,Amherst,2008,2084591660,412011000,2496602660,83.5,16.5
8,Amherst,2009,2204262100,429800800,2634062900,83.68,16.32
8,Amherst,2010,2127375010,425075900,2552450910,83.35,16.65
8,Amherst,2011,2117159900,417907500,2535067400,83.51,16.49
8,Amherst,2012,2043770600,408824200,2452594800,83.33,16.67
8,Amherst,2013,2050011060,410181400,2460192460,83.33,16.67
8,Amherst,2014,2062663700,509959800,2572623500,80.18,19.82
8,Amherst,2015,2190527500,875724500,3066252000,71.44,28.56
8,Amherst,2016,2200466300,893507853,3093974153,71.12,28.88
9,Andover,2003,5913651684,528858300,6442509984,91.79,8.21
9,Andover,2004,6113567902,540246600,6653814502,91.88,8.12
9,Andover,2005,6350543459,562267100,6912810559,91.87,8.13
9,Andover,2006,6805544272,607194000,7412738272,91.81,8.19
9,Andover,2007,7191035284,657708600,7848743884,91.62,8.38
9,Andover,2008,7179753075,652471000,7832224075,91.67,8.33
9,Andover,2009,7160470363,622838700,7783309063,92,8
9,Andover,2010,6837657244,681979800,7519637044,90.93,9.07
9,Andover,2011,6616551562,670875300,7287426862,90.79,9.21
9,Andover,2012,6798505246,635525600,7434030846,91.45,8.55
9,Andover,2013,6802719926,631709800,7434429726,91.5,8.5
9,Andover,2014,6840526136,632655000,7473181136,91.53,8.47
9,Andover,2015,7229946734,642530900,7872477634,91.84,8.16
9,Andover,2016,7542476182,684030800,8226506982,91.69,8.31
10,Arlington,2003,4500135559,277185000,4777320559,94.2,5.8
10,Arlington,2004,5990614666,335514800,6326129466,94.7,5.3
10,Arlington,2005,6007309836,339807400,6347117236,94.65,5.35
10,Arlington,2006,6483756733,337532300,6821289033,95.05,4.95
10,Arlington,2007,7011721520,374482100,7386203620,94.93,5.07
10,Arlington,2008,6883264284,419079000,7302343284,94.26,5.74
10,Arlington,2009,6790772343,422236000,7213008343,94.15,5.85
10,Arlington,2010,6892736257,436653700,7329389957,94.04,5.96
10,Arlington,2011,6926589397,436947000,7363536397,94.07,5.93
10,Arlington,2012,6954794567,436718900,7391513467,94.09,5.91
10,Arlington,2013,7201277082,457655300,7658932382,94.02,5.98
10,Arlington,2014,7377629421,468856500,7846485921,94.02,5.98
10,Arlington,2015,7770112271,499629300,8269741571,93.96,6.04
10,Arlington,2016,8513898549,540634800,9054533349,94.03,5.97
11,Ashburnham,2003,419432235,53733700,473165935,88.64,11.36
11,Ashburnham,2004,481484195,55512700,536996895,89.66,10.34
11,Ashburnham,2005,559678668,64037900,623716568,89.73,10.27
11,Ashburnham,2006,625403918,76804900,702208818,89.06,10.94
11,Ashburnham,2007,660244905,85041100,745286005,88.59,11.41
11,Ashburnham,2008,669584735,84857200,754441935,88.75,11.25
11,Ashburnham,2009,691016094,87459800,778475894,88.77,11.23
11,Ashburnham,2010,627539382,85984900,713524282,87.95,12.05
11,Ashburnham,2011,606776865,85973600,692750465,87.59,12.41
11,Ashburnham,2012,575771428,89320300,665091728,86.57,13.43
11,Ashburnham,2013,572781675,90183500,662965175,86.4,13.6
11,Ashburnham,2014,560427319,97106900,657534219,85.23,14.77
11,Ashburnham,2015,563925497,105328000,669253497,84.26,15.74
11,Ashburnham,2016,565846177,105988000,671834177,84.22,15.78
12,Ashby,2003,228753800,15167900,243921700,93.78,6.22
12,Ashby,2004,253655200,15686800,269342000,94.18,5.82
12,Ashby,2005,294241300,22520000,316761300,92.89,7.11
12,Ashby,2006,338987900,26843400,365831300,92.66,7.34
12,Ashby,2007,350003100,25585200,375588300,93.19,6.81
12,Ashby,2008,350386764,25907700,376294464,93.12,6.88
12,Ashby,2009,351803275,25439470,377242745,93.26,6.74
12,Ashby,2010,319193905,22304926,341498831,93.47,6.53
12,Ashby,2011,302321755,21972000,324293755,93.22,6.78
12,Ashby,2012,282400824,19549700,301950524,93.53,6.47
12,Ashby,2013,282920377,19637300,302557677,93.51,6.49
12,Ashby,2014,267193652,18300100,285493752,93.59,6.41
12,Ashby,2015,267380967,18522700,285903667,93.52,6.48
12,Ashby,2016,269811112,18525500,288336612,93.58,6.42
13,Ashfield,2003,138414002,12300300,150714302,91.84,8.16
13,Ashfield,2004,146896971,10445600,157342571,93.36,6.64
13,Ashfield,2005,176752758,13018400,189771158,93.14,6.86
13,Ashfield,2006,214368547,15905100,230273647,93.09,6.91
13,Ashfield,2007,220939388,15610900,236550288,93.4,6.6
13,Ashfield,2008,225989071,16166100,242155171,93.32,6.68
13,Ashfield,2009,226094659,16159200,242253859,93.33,6.67
13,Ashfield,2010,221102925,15988510,237091435,93.26,6.74
13,Ashfield,2011,222278461,16941400,239219861,92.92,7.08
13,Ashfield,2012,219833306,17521600,237354906,92.62,7.38
13,Ashfield,2013,220389397,17689800,238079197,92.57,7.43
13,Ashfield,2014,215673135,17449012,233122147,92.52,7.48
13,Ashfield,2015,224035671,18383503,242419174,92.42,7.58
13,Ashfield,2016,225114616,18382403,243497019,92.45,7.55
14,Ashland,2003,1708607000,79673300,1788280300,95.54,4.46
14,Ashland,2004,1749259677,91260500,1840520177,95.04,4.96
14,Ashland,2005,1960158570,91575300,2051733870,95.54,4.46
14,Ashland,2006,2301419000,106570800,2407989800,95.57,4.43
14,Ashland,2007,2399139000,108120600,2507259600,95.69,4.31
14,Ashland,2008,2407230540,123565900,2530796440,95.12,4.88
14,Ashland,2009,2324281660,123288200,2447569860,94.96,5.04
14,Ashland,2010,2200543850,114755800,2315299650,95.04,4.96
14,Ashland,2011,2149782860,110617000,2260399860,95.11,4.89
14,Ashland,2012,2123243440,109638700,2232882140,95.09,4.91
14,Ashland,2013,2101056070,110927000,2211983070,94.99,5.01
14,Ashland,2014,2138826500,114125900,2252952400,94.93,5.07
14,Ashland,2015,2224313748,128833200,2353146948,94.53,5.47
14,Ashland,2016,2352225396,132993600,2485218996,94.65,5.35
15,Athol,2003,383642024,39726900,423368924,90.62,9.38
15,Athol,2004,589035050,59395100,648430150,90.84,9.16
15,Athol,2005,697153148,64943300,762096448,91.48,8.52
15,Athol,2006,749532850,65811700,815344550,91.93,8.07
15,Athol,2007,856446545,77293000,933739545,91.72,8.28
15,Athol,2008,853120471,75706400,928826871,91.85,8.15
15,Athol,2009,817603317,76284700,893888017,91.47,8.53
15,Athol,2010,724403038,62484500,786887538,92.06,7.94
15,Athol,2011,702008332,58500900,760509232,92.31,7.69
15,Athol,2012,662782198,57835700,720617898,91.97,8.03
15,Athol,2013,634618604,57664124,692282728,91.67,8.33
15,Athol,2014,615636724,81283811,696920535,88.34,11.66
15,Athol,2015,622282458,80544611,702827069,88.54,11.46
15,Athol,2016,624755332,80388511,705143843,88.6,11.4
16,Attleboro,2003,2559468202,264461400,2823929602,90.63,9.37
16,Attleboro,2004,2660940226,277834800,2938775026,90.55,9.45
16,Attleboro,2005,3825297739,304518700,4129816439,92.63,7.37
16,Attleboro,2006,4189306198,308710500,4498016698,93.14,6.86
16,Attleboro,2007,4435047415,320547600,4755595015,93.26,6.74
16,Attleboro,2008,4698377635,359071054,5057448689,92.9,7.1
16,Attleboro,2009,4563359780,359990358,4923350138,92.69,7.31
16,Attleboro,2010,4267810373,364869465,4632679838,92.12,7.88
16,Attleboro,2011,4038909830,434537702,4473447532,90.29,9.71
16,Attleboro,2012,3977037322,428312348,4405349670,90.28,9.72
16,Attleboro,2013,3866869905,419863773,4286733678,90.21,9.79
16,Attleboro,2014,3741130675,425304833,4166435508,89.79,10.21
16,Attleboro,2015,3920472187,418636400,4339108587,90.35,9.65
16,Attleboro,2016,4029850773,425720146,4455570919,90.45,9.55
17,Auburn,2003,1201751494,66741600,1268493094,94.74,5.26
17,Auburn,2004,1525994302,70914300,1596908602,95.56,4.44
17,Auburn,2005,1695008536,74262600,1769271136,95.8,4.2
17,Auburn,2006,1925349021,86435500,2011784521,95.7,4.3
17,Auburn,2007,2122674600,126180200,2248854800,94.39,5.61
17,Auburn,2008,2122877754,124006100,2246883854,94.48,5.52
17,Auburn,2009,2079966364,153108500,2233074864,93.14,6.86
17,Auburn,2010,1862433986,128514000,1990947986,93.55,6.45
17,Auburn,2011,1825542442,123287000,1948829442,93.67,6.33
17,Auburn,2012,1822524051,118282300,1940806351,93.91,6.09
17,Auburn,2013,1812700075,122469100,1935169175,93.67,6.33
17,Auburn,2014,1826098129,136088800,1962186929,93.06,6.94
17,Auburn,2015,1882803252,140688900,2023492152,93.05,6.95
17,Auburn,2016,1931183618,165947300,2097130918,92.09,7.91
18,Avon,2003,539940500,25906600,565847100,95.42,4.58
18,Avon,2004,551939700,25955000,577894700,95.51,4.49
18,Avon,2005,794874717,41661500,836536217,95.02,4.98
18,Avon,2006,835954528,42387700,878342228,95.17,4.83
18,Avon,2007,870980766,48512000,919492766,94.72,5.28
18,Avon,2008,898559671,55236600,953796271,94.21,5.79
18,Avon,2009,873361804,54617400,927979204,94.11,5.89
18,Avon,2010,845197825,54397500,899595325,93.95,6.05
18,Avon,2011,792234354,50324700,842559054,94.03,5.97
18,Avon,2012,781681550,49322000,831003550,94.06,5.94
18,Avon,2013,762392554,48435700,810828254,94.03,5.97
18,Avon,2014,749103033,47552000,796655033,94.03,5.97
18,Avon,2015,755550788,45480400,801031188,94.32,5.68
18,Avon,2016,763627123,46883500,810510623,94.22,5.78
19,Ayer,2003,751771830,87303800,839075630,89.6,10.4
19,Ayer,2004,798694890,81997200,880692090,90.69,9.31
19,Ayer,2005,880104230,90222100,970326330,90.7,9.3
19,Ayer,2006,929522680,93892500,1023415180,90.83,9.17
19,Ayer,2007,958053580,98011000,1056064580,90.72,9.28
19,Ayer,2008,1006830060,103859200,1110689260,90.65,9.35
19,Ayer,2009,990763100,105014400,1095777500,90.42,9.58
19,Ayer,2010,972743450,106470500,1079213950,90.13,9.87
19,Ayer,2011,967365590,106216800,1073582390,90.11,9.89
19,Ayer,2012,971629320,111025000,1082654320,89.75,10.25
19,Ayer,2013,969263490,109942430,1079205920,89.81,10.19
19,Ayer,2014,982811670,110242600,1093054270,89.91,10.09
19,Ayer,2015,1015810400,110054900,1125865300,90.22,9.78
19,Ayer,2016,1046115680,117411700,1163527380,89.91,10.09
20,Barnstable,2003,7509669295,935051400,8444720695,88.93,11.07
20,Barnstable,2004,11280791852,1436091200,12716883052,88.71,11.29
20,Barnstable,2005,12819013444,1556271200,14375284644,89.17,10.83
20,Barnstable,2006,14263212110,1601511300,15864723410,89.91,10.09
20,Barnstable,2007,14945745106,1589492574,16535237680,90.39,9.61
20,Barnstable,2008,14834706750,1587331600,16422038350,90.33,9.67
20,Barnstable,2009,14544783185,1609150465,16153933650,90.04,9.96
20,Barnstable,2010,13360218025,1323548455,14683766480,90.99,9.01
20,Barnstable,2011,12987343865,1273807155,14261151020,91.07,8.93
20,Barnstable,2012,12825115470,1313770220,14138885690,90.71,9.29
20,Barnstable,2013,12721413515,1302428455,14023841970,90.71,9.29
20,Barnstable,2014,12594100005,1292044335,13886144340,90.7,9.3
20,Barnstable,2015,12702783525,1274275600,13977059125,90.88,9.12
20,Barnstable,2016,13142891360,1159330220,14302221580,91.89,8.11
21,Barre,2003,246947645,41380020,288327665,85.65,14.35
21,Barre,2004,333419241,53191700,386610941,86.24,13.76
21,Barre,2005,391869112,61580380,453449492,86.42,13.58
21,Barre,2006,433363244,65068800,498432044,86.95,13.05
21,Barre,2007,474526461,76863900,551390361,86.06,13.94
21,Barre,2008,497257439,78420660,575678099,86.38,13.62
21,Barre,2009,482545604,76666296,559211900,86.29,13.71
21,Barre,2010,451387618,73584935,524972553,85.98,14.02
21,Barre,2011,431918829,75450835,507369664,85.13,14.87
21,Barre,2012,406530656,74802125,481332781,84.46,15.54
21,Barre,2013,400626653,95876168,496502821,80.69,19.31
21,Barre,2014,386430694,95165400,481596094,80.24,19.76
21,Barre,2015,386058832,92060750,478119582,80.75,19.25
21,Barre,2016,400479913,91774275,492254188,81.36,18.64
22,Becket,2003,236662600,15938700,252601300,93.69,6.31
22,Becket,2004,312625900,18627500,331253400,94.38,5.62
22,Becket,2005,328300700,22329400,350630100,93.63,6.37
22,Becket,2006,401118400,24857000,425975400,94.16,5.84
22,Becket,2007,461981800,29741500,491723300,93.95,6.05
22,Becket,2008,500805400,29839000,530644400,94.38,5.62
22,Becket,2009,527170100,29735400,556905500,94.66,5.34
22,Becket,2010,551987800,31241200,583229000,94.64,5.36
22,Becket,2011,530765800,30210400,560976200,94.61,5.39
22,Becket,2012,520019427,28421300,548440727,94.82,5.18
22,Becket,2013,523677526,28941900,552619426,94.76,5.24
22,Becket,2014,497325132,28004400,525329532,94.67,5.33
22,Becket,2015,500323071,28132400,528455471,94.68,5.32
22,Becket,2016,502028856,28760000,530788856,94.58,5.42
23,Bedford,2003,2262717200,417718200,2680435400,84.42,15.58
23,Bedford,2004,2359868400,431912700,2791781100,84.53,15.47
23,Bedford,2005,2540090000,421768900,2961858900,85.76,14.24
23,Bedford,2006,2660171670,433891100,3094062770,85.98,14.02
23,Bedford,2007,2799213600,437281200,3236494800,86.49,13.51
23,Bedford,2008,2893298665,487504645,3380803310,85.58,14.42
23,Bedford,2009,2830696757,451020200,3281716957,86.26,13.74
23,Bedford,2010,2755935570,451616600,3207552170,85.92,14.08
23,Bedford,2011,2752075404,460675100,3212750504,85.66,14.34
23,Bedford,2012,2755593345,396430900,3152024245,87.42,12.58
23,Bedford,2013,2771855371,394224200,3166079571,87.55,12.45
23,Bedford,2014,2863622121,392138800,3255760921,87.96,12.04
23,Bedford,2015,3157091927,415498043,3572589970,88.37,11.63
23,Bedford,2016,3194692927,416914143,3611607070,88.46,11.54
24,Belchertown,2003,795609570,94178400,889787970,89.42,10.58
24,Belchertown,2004,900451819,99025800,999477619,90.09,9.91
24,Belchertown,2005,1039497719,118278900,1157776619,89.78,10.22
24,Belchertown,2006,1196664261,117794600,1314458861,91.04,8.96
24,Belchertown,2007,1331818953,136653000,1468471953,90.69,9.31
24,Belchertown,2008,1390001470,141656600,1531658070,90.75,9.25
24,Belchertown,2009,1421340807,149440700,1570781507,90.49,9.51
24,Belchertown,2010,1377547114,145487700,1523034814,90.45,9.55
24,Belchertown,2011,1351874466,140893900,1492768366,90.56,9.44
24,Belchertown,2012,1319671454,136248900,1455920354,90.64,9.36
24,Belchertown,2013,1318029305,138939900,1456969205,90.46,9.54
24,Belchertown,2014,1316202108,136199400,1452401508,90.62,9.38
24,Belchertown,2015,1346660763,135399900,1482060663,90.86,9.14
24,Belchertown,2016,1369925597,144837300,1514762897,90.44,9.56
25,Bellingham,2003,1544080267,76181600,1620261867,95.3,4.7
25,Bellingham,2004,1919044262,84722100,2003766362,95.77,4.23
25,Bellingham,2005,2041309407,95645800,2136955207,95.52,4.48
25,Bellingham,2006,2247331945,106980700,2354312645,95.46,4.54
25,Bellingham,2007,2544933036,126839100,2671772136,95.25,4.75
25,Bellingham,2008,2410170367,127035400,2537205767,94.99,5.01
25,Bellingham,2009,2403009679,129188900,2532198579,94.9,5.1
25,Bellingham,2010,2206813918,117217500,2324031418,94.96,5.04
25,Bellingham,2011,2182758551,115866600,2298625151,94.96,5.04
25,Bellingham,2012,2134358065,114978750,2249336815,94.89,5.11
25,Bellingham,2013,2091386006,115489500,2206875506,94.77,5.23
25,Bellingham,2014,2102349169,114725300,2217074469,94.83,5.17
25,Bellingham,2015,2129580173,118875500,2248455673,94.71,5.29
25,Bellingham,2016,2207255751,123728400,2330984151,94.69,5.31
26,Belmont,2003,4375119400,510453000,4885572400,89.55,10.45
26,Belmont,2004,4766358350,598572000,5364930350,88.84,11.16
26,Belmont,2005,4986952850,581921933,5568874783,89.55,10.45
26,Belmont,2006,5304559050,601373000,5905932050,89.82,10.18
26,Belmont,2007,5575357490,651749000,6227106490,89.53,10.47
26,Belmont,2008,5319178160,626238000,5945416160,89.47,10.53
26,Belmont,2009,5257657170,625837000,5883494170,89.36,10.64
26,Belmont,2010,5291129740,633751000,5924880740,89.3,10.7
26,Belmont,2011,5110692950,635617000,5746309950,88.94,11.06
26,Belmont,2012,5233510490,625236000,5858746490,89.33,10.67
26,Belmont,2013,5405665551,657111000,6062776551,89.16,10.84
26,Belmont,2014,5481015161,657455000,6138470161,89.29,10.71
26,Belmont,2015,5927739291,702963000,6630702291,89.4,10.6
26,Belmont,2016,6598368011,731012000,7329380011,90.03,9.97
27,Berkley,2003,380886249,24558100,405444349,93.94,6.06
27,Berkley,2004,551766421,31391000,583157421,94.62,5.38
27,Berkley,2005,673841498,34263700,708105198,95.16,4.84
27,Berkley,2006,794419242,54487100,848906342,93.58,6.42
27,Berkley,2007,885530424,58548900,944079324,93.8,6.2
27,Berkley,2008,871453134,59215100,930668234,93.64,6.36
27,Berkley,2009,867804588,68065800,935870388,92.73,7.27
27,Berkley,2010,839889562,74210100,914099662,91.88,8.12
27,Berkley,2011,802511362,76629600,879140962,91.28,8.72
27,Berkley,2012,766806353,75367000,842173353,91.05,8.95
27,Berkley,2013,763994212,78349600,842343812,90.7,9.3
27,Berkley,2014,742419076,75499800,817918876,90.77,9.23
27,Berkley,2015,736711606,74469100,811180706,90.82,9.18
27,Berkley,2016,750634414,75620900,826255314,90.85,9.15
28,Berlin,2003,333751030,26439200,360190230,92.66,7.34
28,Berlin,2004,441455500,30441300,471896800,93.55,6.45
28,Berlin,2005,481927260,31212100,513139360,93.92,6.08
28,Berlin,2006,527687080,34530700,562217780,93.86,6.14
28,Berlin,2007,583562875,40646100,624208975,93.49,6.51
28,Berlin,2008,596327415,42122200,638449615,93.4,6.6
28,Berlin,2009,608542886,42871600,651414486,93.42,6.58
28,Berlin,2010,559301500,43226800,602528300,92.83,7.17
28,Berlin,2011,561648401,43614300,605262701,92.79,7.21
28,Berlin,2012,551847179,43510900,595358079,92.69,7.31
28,Berlin,2013,519429385,42898000,562327385,92.37,7.63
28,Berlin,2014,500468332,45112400,545580732,91.73,8.27
28,Berlin,2015,518461970,44210600,562672570,92.14,7.86
28,Berlin,2016,558020217,43321200,601341417,92.8,7.2
29,Bernardston,2003,115960772,10388900,126349672,91.78,8.22
29,Bernardston,2004,144843053,13454000,158297053,91.5,8.5
29,Bernardston,2005,147400126,14898500,162298626,90.82,9.18
29,Bernardston,2006,188139531,18207200,206346731,91.18,8.82
29,Bernardston,2007,214173045,21158500,235331545,91.01,8.99
29,Bernardston,2008,217898016,21053800,238951816,91.19,8.81
29,Bernardston,2009,219635310,18443000,238078310,92.25,7.75
29,Bernardston,2010,212301511,19199500,231501011,91.71,8.29
29,Bernardston,2011,214389598,17122900,231512498,92.6,7.4
29,Bernardston,2012,217557544,16857600,234415144,92.81,7.19
29,Bernardston,2013,211148233,15427700,226575933,93.19,6.81
29,Bernardston,2014,213637664,15422700,229060364,93.27,6.73
29,Bernardston,2015,215262013,15431600,230693613,93.31,6.69
29,Bernardston,2016,210174131,15290600,225464731,93.22,6.78
30,Beverly,2003,4217587189,388388300,4605975489,91.57,8.43
30,Beverly,2004,4636005236,440409590,5076414826,91.32,8.68
30,Beverly,2005,5345700570,491943200,5837643770,91.57,8.43
30,Beverly,2006,5675250127,554320354,6229570481,91.1,8.9
30,Beverly,2007,5813679676,656887314,6470566990,89.85,10.15
30,Beverly,2008,5914039722,347548194,6261587916,94.45,5.55
30,Beverly,2009,5838018685,606873494,6444892179,90.58,9.42
30,Beverly,2010,5650101694,592372394,6242474088,90.51,9.49
30,Beverly,2011,5475688255,573933940,6049622195,90.51,9.49
30,Beverly,2012,5441690367,576190940,6017881307,90.43,9.57
30,Beverly,2013,5348526099,568320640,5916846739,90.39,9.61
30,Beverly,2014,5351050826,565656940,5916707766,90.44,9.56
30,Beverly,2015,5591093213,632099320,6223192533,89.84,10.16
30,Beverly,2016,5665455652,658006420,6323462072,89.59,10.41
31,Billerica,2003,4323030256,207088200,4530118456,95.43,4.57
31,Billerica,2004,4759121689,215717800,4974839489,95.66,4.34
31,Billerica,2005,5059795907,232548100,5292344007,95.61,4.39
31,Billerica,2006,5552091920,330543594,5882635514,94.38,5.62
31,Billerica,2007,5673025295,335499894,6008525189,94.42,5.58
31,Billerica,2008,5798673069,340551878,6139224947,94.45,5.55
31,Billerica,2009,5715827226,351670561,6067497787,94.2,5.8
31,Billerica,2010,5453285443,339713300,5792998743,94.14,5.86
31,Billerica,2011,5317935324,328430800,5646366124,94.18,5.82
31,Billerica,2012,5300490673,326241650,5626732323,94.2,5.8
31,Billerica,2013,5281771420,323198950,5604970370,94.23,5.77
31,Billerica,2014,5459090486,329079050,5788169536,94.31,5.69
31,Billerica,2015,5584578413,336238722,5920817135,94.32,5.68
31,Billerica,2016,5782739242,344450715,6127189957,94.38,5.62
32,Blackstone,2003,765805258,44829000,810634258,94.47,5.53
32,Blackstone,2004,918825006,69390000,988215006,92.98,7.02
32,Blackstone,2005,957253466,68703800,1025957266,93.3,6.7
32,Blackstone,2006,1074563064,69816400,1144379464,93.9,6.1
32,Blackstone,2007,1101820704,76298300,1178119004,93.52,6.48
32,Blackstone,2008,1085140178,75883500,1161023678,93.46,6.54
32,Blackstone,2009,1005976057,77309900,1083285957,92.86,7.14
32,Blackstone,2010,954708462,81151700,1035860162,92.17,7.83
32,Blackstone,2011,882550766,78550800,961101566,91.83,8.17
32,Blackstone,2012,830632795,75802800,906435595,91.64,8.36
32,Blackstone,2013,815051395,75714900,890766295,91.5,8.5
32,Blackstone,2014,807791020,76691700,884482720,91.33,8.67
32,Blackstone,2015,814952499,76826800,891779299,91.38,8.62
32,Blackstone,2016,852550754,75791500,928342254,91.84,8.16
33,Blandford,2003,88363158,6498900,94862058,93.15,6.85
33,Blandford,2004,109752120,8276900,118029020,92.99,7.01
33,Blandford,2005,115418911,10396900,125815811,91.74,8.26
33,Blandford,2006,146487530,33519500,180007030,81.38,18.62
33,Blandford,2007,148295065,27938000,176233065,84.15,15.85
33,Blandford,2008,161446862,28591900,190038762,84.95,15.05
33,Blandford,2009,159275062,28122300,187397362,84.99,15.01
33,Blandford,2010,169714215,38181300,207895515,81.63,18.37
33,Blandford,2011,167308474,36804500,204112974,81.97,18.03
33,Blandford,2012,164001832,36893100,200894932,81.64,18.36
33,Blandford,2013,164797913,33438900,198236813,83.13,16.87
33,Blandford,2014,165426291,32614200,198040491,83.53,16.47
33,Blandford,2015,165829451,32941300,198770751,83.43,16.57
33,Blandford,2016,171908687,32514600,204423287,84.09,15.91
34,Bolton,2003,811115710,39235000,850350710,95.39,4.61
34,Bolton,2004,833913162,40780700,874693862,95.34,4.66
34,Bolton,2005,877046810,41351600,918398410,95.5,4.5
34,Bolton,2006,961378148,47551100,1008929248,95.29,4.71
34,Bolton,2007,987612731,47019300,1034632031,95.46,4.54
34,Bolton,2008,969350160,49461100,1018811260,95.15,4.85
34,Bolton,2009,971947836,50338200,1022286036,95.08,4.92
34,Bolton,2010,931523796,48726000,980249796,95.03,4.97
34,Bolton,2011,878135162,47236500,925371662,94.9,5.1
34,Bolton,2012,880376239,60878300,941254539,93.53,6.47
34,Bolton,2013,859744392,61015100,920759492,93.37,6.63
34,Bolton,2014,873687629,60687500,934375129,93.51,6.49
34,Bolton,2015,898801476,59997100,958798576,93.74,6.26
34,Bolton,2016,934606956,59532500,994139456,94.01,5.99
35,Boston,2003,57533345415,18376884256,75910229671,75.79,24.21
35,Boston,2004,66141729727,20121181527,86262911254,76.67,23.33
35,Boston,2005,69253527870,20438278964,89691806834,77.21,22.79
35,Boston,2006,74738001337,22800368671,97538370008,76.62,23.38
35,Boston,2007,86516105759,27457481586,113973587345,75.91,24.09
35,Boston,2008,90067296838,28235838384,118303135222,76.13,23.87
35,Boston,2009,90387170824,35954948044,126342118868,71.54,28.46
35,Boston,2010,87256532047,34838001520,122094533567,71.47,28.53
35,Boston,2011,86800582862,34497308877,121297891739,71.56,28.44
35,Boston,2012,88500410287,34800454788,123300865075,71.78,28.22
35,Boston,2013,92199271698,36838181252,129037452950,71.45,28.55
35,Boston,2014,99832812559,38809222553,138642035112,72.01,27.99
35,Boston,2015,110736862222,41490496874,152227359096,72.74,27.26
35,Boston,2016,128047080703,45978652935,174025733638,73.58,26.42
36,Bourne,2003,2950045650,878713208,3828758858,77.05,22.95
36,Bourne,2004,3415093460,838075908,4253169368,80.3,19.7
36,Bourne,2005,4000092650,870677708,4870770358,82.12,17.88
36,Bourne,2006,4530488005,922711510,5453199515,83.08,16.92
36,Bourne,2007,4782680280,946678898,5729359178,83.48,16.52
36,Bourne,2008,4877943640,1052767458,5930711098,82.25,17.75
36,Bourne,2009,4615387380,1039217928,5654605308,81.62,18.38
36,Bourne,2010,4609880940,1038893270,5648774210,81.61,18.39
36,Bourne,2011,4394123960,1051269180,5445393140,80.69,19.31
36,Bourne,2012,4087996000,1064922960,5152918960,79.33,20.67
36,Bourne,2013,4082891000,1058304790,5141195790,79.42,20.58
36,Bourne,2014,4106004970,1041241270,5147246240,79.77,20.23
36,Bourne,2015,4095521960,1035284640,5130806600,79.82,20.18
36,Bourne,2016,4219514210,1046256650,5265770860,80.13,19.87
37,Boxborough,2003,857949826,27173000,885122826,96.93,3.07
37,Boxborough,2004,882204914,27778200,909983114,96.95,3.05
37,Boxborough,2005,927197964,28523600,955721564,97.02,2.98
37,Boxborough,2006,1019796577,38282600,1058079177,96.38,3.62
37,Boxborough,2007,1028095223,38237300,1066332523,96.41,3.59
37,Boxborough,2008,1052195628,38673100,1090868728,96.45,3.55
37,Boxborough,2009,1038988751,40586500,1079575251,96.24,3.76
37,Boxborough,2010,961330741,38230900,999561641,96.18,3.82
37,Boxborough,2011,943586088,38861600,982447688,96.04,3.96
37,Boxborough,2012,944316252,37694800,982011052,96.16,3.84
37,Boxborough,2013,944949427,35996100,980945527,96.33,3.67
37,Boxborough,2014,940732633,36160600,976893233,96.3,3.7
37,Boxborough,2015,976999303,36516100,1013515403,96.4,3.6
37,Boxborough,2016,1018102406,101821700,1119924106,90.91,9.09
38,Boxford,2003,1401181668,25480700,1426662368,98.21,1.79
38,Boxford,2004,1413148079,31622200,1444770279,97.81,2.19
38,Boxford,2005,1691052817,40958500,1732011317,97.64,2.36
38,Boxford,2006,1875235838,125902500,2001138338,93.71,6.29
38,Boxford,2007,1879640181,126274500,2005914681,93.7,6.3
38,Boxford,2008,1890188928,128627200,2018816128,93.63,6.37
38,Boxford,2009,1820319501,138407500,1958727001,92.93,7.07
38,Boxford,2010,1746156477,133878300,1880034777,92.88,7.12
38,Boxford,2011,1622530979,130727300,1753258279,92.54,7.46
38,Boxford,2012,1612221131,129553100,1741774231,92.56,7.44
38,Boxford,2013,1578618621,144459000,1723077621,91.62,8.38
38,Boxford,2014,1556386995,143573300,1699960295,91.55,8.45
38,Boxford,2015,1625298251,153804900,1779103151,91.35,8.65
38,Boxford,2016,1668617741,157304700,1825922441,91.38,8.62
39,Boylston,2003,433676049,68906200,502582249,86.29,13.71
39,Boylston,2004,544336896,85517700,629854596,86.42,13.58
39,Boylston,2005,630838700,83910500,714749200,88.26,11.74
39,Boylston,2006,656234200,84341400,740575600,88.61,11.39
39,Boylston,2007,716103200,88404100,804507300,89.01,10.99
39,Boylston,2008,729054740,128052300,857107040,85.06,14.94
39,Boylston,2009,692635640,128997300,821632940,84.3,15.7
39,Boylston,2010,688997540,128168500,817166040,84.32,15.68
39,Boylston,2011,590326840,124479700,714806540,82.59,17.41
39,Boylston,2012,594788840,123823700,718612540,82.77,17.23
39,Boylston,2013,594959400,125973400,720932800,82.53,17.47
39,Boylston,2014,594147100,121368300,715515400,83.04,16.96
39,Boylston,2015,600295400,122481100,722776500,83.05,16.95
39,Boylston,2016,648226700,124213000,772439700,83.92,16.08
40,Braintree,2003,4090062260,331913500,4421975760,92.49,7.51
40,Braintree,2004,4278719801,326996200,4605716001,92.9,7.1
40,Braintree,2005,4850534495,341898700,5192433195,93.42,6.58
40,Braintree,2006,5568213625,399697700,5967911325,93.3,6.7
40,Braintree,2007,5605124805,401669400,6006794205,93.31,6.69
40,Braintree,2008,5603463489,400677200,6004140689,93.33,6.67
40,Braintree,2009,5537329189,428227500,5965556689,92.82,7.18
40,Braintree,2010,5359518266,428036000,5787554266,92.6,7.4
40,Braintree,2011,5220854188,427044500,5647898688,92.44,7.56
40,Braintree,2012,5278531923,420461400,5698993323,92.62,7.38
40,Braintree,2013,5143940012,417148200,5561088212,92.5,7.5
40,Braintree,2014,5200927730,421234000,5622161730,92.51,7.49
40,Braintree,2015,5628419407,438432800,6066852207,92.77,7.23
40,Braintree,2016,5912466560,449707900,6362174460,92.93,7.07
41,Brewster,2003,2269820570,198142100,2467962670,91.97,8.03
41,Brewster,2004,2592429100,243545700,2835974800,91.41,8.59
41,Brewster,2005,3220008020,282477500,3502485520,91.93,8.07
41,Brewster,2006,3652243750,326168600,3978412350,91.8,8.2
41,Brewster,2007,3861018450,352568500,4213586950,91.63,8.37
41,Brewster,2008,3858992120,353951900,4212944020,91.6,8.4
41,Brewster,2009,3793661290,337142200,4130803490,91.84,8.16
41,Brewster,2010,3752841370,300082500,4052923870,92.6,7.4
41,Brewster,2011,3427607340,269192500,3696799840,92.72,7.28
41,Brewster,2012,3346182410,256108500,3602290910,92.89,7.11
41,Brewster,2013,3251967110,236499700,3488466810,93.22,6.78
41,Brewster,2014,3313114540,233083800,3546198340,93.43,6.57
41,Brewster,2015,3379744690,212603200,3592347890,94.08,5.92
41,Brewster,2016,3474653670,222588900,3697242570,93.98,6.02
42,Bridgewater,2003,1905699100,283014400,2188713500,87.07,12.93
42,Bridgewater,2004,1934586160,284702500,2219288660,87.17,12.83
42,Bridgewater,2005,2353996400,322683700,2676680100,87.94,12.06
42,Bridgewater,2006,2725420180,364306400,3089726580,88.21,11.79
42,Bridgewater,2007,2768778350,391121700,3159900050,87.62,12.38
42,Bridgewater,2008,2704089260,409573700,3113662960,86.85,13.15
42,Bridgewater,2009,2616668770,447426300,3064095070,85.4,14.6
42,Bridgewater,2010,2445667180,438696600,2884363780,84.79,15.21
42,Bridgewater,2011,2341467970,440252900,2781720870,84.17,15.83
42,Bridgewater,2012,2303580440,414879400,2718459840,84.74,15.26
42,Bridgewater,2013,2269220470,437686200,2706906670,83.83,16.17
42,Bridgewater,2014,2272889910,419160100,2692050010,84.43,15.57
42,Bridgewater,2015,2368994490,420856600,2789851090,84.91,15.09
42,Bridgewater,2016,2512988630,426908500,2939897130,85.48,14.52
43,Brimfield,2003,239419918,21504300,260924218,91.76,8.24
43,Brimfield,2004,246012122,22959000,268971122,91.46,8.54
43,Brimfield,2005,323816026,30002500,353818526,91.52,8.48
43,Brimfield,2006,375386450,31287000,406673450,92.31,7.69
43,Brimfield,2007,405899955,32182500,438082455,92.65,7.35
43,Brimfield,2008,428921069,35126900,464047969,92.43,7.57
43,Brimfield,2009,437428688,34902200,472330888,92.61,7.39
43,Brimfield,2010,443946757,34617500,478564257,92.77,7.23
43,Brimfield,2011,402985426,32279600,435265026,92.58,7.42
43,Brimfield,2012,400357737,29678400,430036137,93.1,6.9
43,Brimfield,2013,405957060,29922300,435879360,93.14,6.86
43,Brimfield,2014,384721484,32916000,417637484,92.12,7.88
43,Brimfield,2015,392658854,32796600,425455454,92.29,7.71
43,Brimfield,2016,394636953,33003000,427639953,92.28,7.72
44,Brockton,2003,5002305886,1037890040,6040195926,82.82,17.18
44,Brockton,2004,5821685828,1048155700,6869841528,84.74,15.26
44,Brockton,2005,6679639761,1170867560,7850507321,85.09,14.91
44,Brockton,2006,7757717940,1171976380,8929694320,86.88,13.12
44,Brockton,2007,8230247748,1259934322,9490182070,86.72,13.28
44,Brockton,2008,8156759550,1448925522,9605685072,84.92,15.08
44,Brockton,2009,7174223590,1481188152,8655411742,82.89,17.11
44,Brockton,2010,5868201889,1413218212,7281420101,80.59,19.41
44,Brockton,2011,5629189085,1138417452,6767606537,83.18,16.82
44,Brockton,2012,5634634091,1061932852,6696566943,84.14,15.86
44,Brockton,2013,5486239872,1062904882,6549144754,83.77,16.23
44,Brockton,2014,5362178891,1050468910,6412647801,83.62,16.38
44,Brockton,2015,5462968131,1057873410,6520841541,83.78,16.22
44,Brockton,2016,6104303935,1060060400,7164364335,85.2,14.8
45,Brookfield,2003,139731379,22308300,162039679,86.23,13.77
45,Brookfield,2004,193598014,28100300,221698314,87.32,12.68
45,Brookfield,2005,204123793,27577600,231701393,88.1,11.9
45,Brookfield,2006,259416817,33835100,293251917,88.46,11.54
45,Brookfield,2007,298902385,38629900,337532285,88.56,11.44
45,Brookfield,2008,306659543,38447900,345107443,88.86,11.14
45,Brookfield,2009,309030872,38519900,347550772,88.92,11.08
45,Brookfield,2010,293133163,37679300,330812463,88.61,11.39
45,Brookfield,2011,294194635,37924340,332118975,88.58,11.42
45,Brookfield,2012,265542188,38000374,303542562,87.48,12.52
45,Brookfield,2013,253523850,33301168,286825018,88.39,11.61
45,Brookfield,2014,245998017,31987600,277985617,88.49,11.51
45,Brookfield,2015,247902528,31726400,279628928,88.65,11.35
45,Brookfield,2016,249070925,31760700,280831625,88.69,11.31
46,Brookline,2003,10512687900,1061194300,11573882200,90.83,9.17
46,Brookline,2004,11623271900,1035635900,12658907800,91.82,8.18
46,Brookline,2005,12615710980,1210091900,13825802880,91.25,8.75
46,Brookline,2006,14103339350,1327852500,15431191850,91.4,8.6
46,Brookline,2007,14336259450,1312404700,15648664150,91.61,8.39
46,Brookline,2008,14231497380,1350615300,15582112680,91.33,8.67
46,Brookline,2009,14709311180,1412150800,16121461980,91.24,8.76
46,Brookline,2010,14841644460,1529248900,16370893360,90.66,9.34
46,Brookline,2011,14926437080,1640844900,16567281980,90.1,9.9
46,Brookline,2012,15264163420,1871907300,17136070720,89.08,10.92
46,Brookline,2013,15519229380,1874262100,17393491480,89.22,10.78
46,Brookline,2014,16342661940,1980736000,18323397940,89.19,10.81
46,Brookline,2015,17974054838,2104886700,20078941538,89.52,10.48
46,Brookline,2016,19691528576,2183749900,21875278476,90.02,9.98
47,Buckland,2003,107996644,15307400,123304044,87.59,12.41
47,Buckland,2004,137069676,18755500,155825176,87.96,12.04
47,Buckland,2005,147562995,19191650,166754645,88.49,11.51
47,Buckland,2006,174275521,20882800,195158321,89.3,10.7
47,Buckland,2007,208065746,25218400,233284146,89.19,10.81
47,Buckland,2008,210432894,25325100,235757994,89.26,10.74
47,Buckland,2009,213013943,25284100,238298043,89.39,10.61
47,Buckland,2010,216886891,25067300,241954191,89.64,10.36
47,Buckland,2011,216958810,24851500,241810310,89.72,10.28
47,Buckland,2012,212741109,24975700,237716809,89.49,10.51
47,Buckland,2013,212841463,25006900,237848363,89.49,10.51
47,Buckland,2014,208736356,24095900,232832256,89.65,10.35
47,Buckland,2015,208175417,24225700,232401117,89.58,10.42
47,Buckland,2016,209913168,24414700,234327868,89.58,10.42
48,Burlington,2003,3739266775,386449200,4125715975,90.63,9.37
48,Burlington,2004,3945985377,391408700,4337394077,90.98,9.02
48,Burlington,2005,4020865045,441550900,4462415945,90.11,9.89
48,Burlington,2006,4279756995,481001700,4760758695,89.9,10.1
48,Burlington,2007,4514750045,505425700,5020175745,89.93,10.07
48,Burlington,2008,4612065275,516202104,5128267379,89.93,10.07
48,Burlington,2009,4819890565,494543304,5314433869,90.69,9.31
48,Burlington,2010,4519333825,449272904,4968606729,90.96,9.04
48,Burlington,2011,4468767182,443021708,4911788890,90.98,9.02
48,Burlington,2012,4599047268,458350300,5057397568,90.94,9.06
48,Burlington,2013,4663288818,464699700,5127988518,90.94,9.06
48,Burlington,2014,4767295033,465347800,5232642833,91.11,8.89
48,Burlington,2015,5289708724,491929596,5781638320,91.49,8.51
48,Burlington,2016,5534799894,493642046,6028441940,91.81,8.19
49,Cambridge,2003,17750735596,8548208325,26298943921,67.5,32.5
49,Cambridge,2004,19226572680,8523060569,27749633249,69.29,30.71
49,Cambridge,2005,21348000524,6832499900,28180500424,75.75,24.25
49,Cambridge,2006,21846898010,7350631700,29197529710,74.82,25.18
49,Cambridge,2007,22167135334,7672839600,29839974934,74.29,25.71
49,Cambridge,2008,23541195566,7424707500,30965903066,76.02,23.98
49,Cambridge,2009,23876058621,7535268876,31411327497,76.01,23.99
49,Cambridge,2010,24271700606,8635161388,32906861994,73.76,26.24
49,Cambridge,2011,24162077598,9461312488,33623390086,71.86,28.14
49,Cambridge,2012,24446954999,943572400,25390527399,96.28,3.72
49,Cambridge,2013,25213972501,10289985584,35503958085,71.02,28.98
49,Cambridge,2014,27161648788,11861236196,39022884984,69.6,30.4
49,Cambridge,2015,30143180521,12993522076,43136702597,69.88,30.12
49,Cambridge,2016,34680060680,13771359124,48451419804,71.58,28.42
50,Canton,2003,2440408600,219945400,2660354000,91.73,8.27
50,Canton,2004,3411584500,278481700,3690066200,92.45,7.55
50,Canton,2005,3606842800,275665300,3882508100,92.9,7.1
50,Canton,2006,3863200980,280992500,4144193480,93.22,6.78
50,Canton,2007,4208933320,353011300,4561944620,92.26,7.74
50,Canton,2008,4130149680,346368700,4476518380,92.26,7.74
50,Canton,2009,4173596550,346636200,4520232750,92.33,7.67
50,Canton,2010,3989630980,396855800,4386486780,90.95,9.05
50,Canton,2011,3974669080,398931300,4373600380,90.88,9.12
50,Canton,2012,3954593860,398161800,4352755660,90.85,9.15
50,Canton,2013,3971663460,404238400,4375901860,90.76,9.24
50,Canton,2014,3884619110,373788100,4258407210,91.22,8.78
50,Canton,2015,4069871500,379018200,4448889700,91.48,8.52
50,Canton,2016,4320712330,393731900,4714444230,91.65,8.35
51,Carlisle,2003,983742110,48672800,1032414910,95.29,4.71
51,Carlisle,2004,1255331791,56620200,1311951991,95.68,4.32
51,Carlisle,2005,1271859510,59529500,1331389010,95.53,4.47
51,Carlisle,2006,1289612044,59557200,1349169244,95.59,4.41
51,Carlisle,2007,1449914440,78407071,1528321511,94.87,5.13
51,Carlisle,2008,1463198525,84262300,1547460825,94.55,5.45
51,Carlisle,2009,1388348687,83810500,1472159187,94.31,5.69
51,Carlisle,2010,1385741490,60710800,1446452290,95.8,4.2
51,Carlisle,2011,1301285229,79524900,1380810129,94.24,5.76
51,Carlisle,2012,1257707646,77354400,1335062046,94.21,5.79
51,Carlisle,2013,1227847711,70592700,1298440411,94.56,5.44
51,Carlisle,2014,1238921992,68417500,1307339492,94.77,5.23
51,Carlisle,2015,1261338172,67915600,1329253772,94.89,5.11
51,Carlisle,2016,1435942392,72021000,1507963392,95.22,4.78
52,Carver,2003,788855868,53959700,842815568,93.6,6.4
52,Carver,2004,854047700,58098100,912145800,93.63,6.37
52,Carver,2005,1047448920,83537300,1130986220,92.61,7.39
52,Carver,2006,1200729270,75276500,1276005770,94.1,5.9
52,Carver,2007,1305999830,78773300,1384773130,94.31,5.69
52,Carver,2008,1288682460,79184100,1367866560,94.21,5.79
52,Carver,2009,1228759730,77955400,1306715130,94.03,5.97
52,Carver,2010,1166102780,76903300,1243006080,93.81,6.19
52,Carver,2011,1138299580,74574700,1212874280,93.85,6.15
52,Carver,2012,1122183200,74653300,1196836500,93.76,6.24
52,Carver,2013,1095596610,71720100,1167316710,93.86,6.14
52,Carver,2014,1100980260,70267600,1171247860,94,6
52,Carver,2015,1122143520,66251100,1188394620,94.43,5.57
52,Carver,2016,1166878870,69075600,1235954470,94.41,5.59
53,Charlemont,2003,78388443,12614900,91003343,86.14,13.86
53,Charlemont,2004,91959965,13756600,105716565,86.99,13.01
53,Charlemont,2005,104712371,14640800,119353171,87.73,12.27
53,Charlemont,2006,107094221,16078400,123172621,86.95,13.05
53,Charlemont,2007,124356404,17142300,141498704,87.89,12.11
53,Charlemont,2008,129791669,17375400,147167069,88.19,11.81
53,Charlemont,2009,131988460,17625000,149613460,88.22,11.78
53,Charlemont,2010,132465578,17830600,150296178,88.14,11.86
53,Charlemont,2011,131017894,18312100,149329994,87.74,12.26
53,Charlemont,2012,131277493,18822100,150099593,87.46,12.54
53,Charlemont,2013,128035065,18881700,146916765,87.15,12.85
53,Charlemont,2014,123865263,18757200,142622463,86.85,13.15
53,Charlemont,2015,125982938,18673800,144656738,87.09,12.91
53,Charlemont,2016,129052287,18673800,147726087,87.36,12.64
54,Charlton,2003,803237398,91631000,894868398,89.76,10.24
54,Charlton,2004,837338690,246211200,1083549890,77.28,22.72
54,Charlton,2005,1232604424,255798000,1488402424,82.81,17.19
54,Charlton,2006,1355100320,253873800,1608974120,84.22,15.78
54,Charlton,2007,1581971041,272913300,1854884341,85.29,14.71
54,Charlton,2008,1650945605,277551800,1928497405,85.61,14.39
54,Charlton,2009,1593269199,277727096,1870996295,85.16,14.84
54,Charlton,2010,1482114942,273942096,1756057038,84.4,15.6
54,Charlton,2011,1383733226,270599296,1654332522,83.64,16.36
54,Charlton,2012,1382323626,268580300,1650903926,83.73,16.27
54,Charlton,2013,1390327527,268941100,1659268627,83.79,16.21
54,Charlton,2014,1397192331,263782300,1660974631,84.12,15.88
54,Charlton,2015,1381343568,276748000,1658091568,83.31,16.69
54,Charlton,2016,1407903300,277009200,1684912500,83.56,16.44
55,Chatham,2003,3026949679,201333000,3228282679,93.76,6.24
55,Chatham,2004,4473968771,314997500,4788966271,93.42,6.58
55,Chatham,2005,5269028044,377743644,5646771688,93.31,6.69
55,Chatham,2006,5804392605,383543840,6187936445,93.8,6.2
55,Chatham,2007,6452763018,412233600,6864996618,94,6
55,Chatham,2008,6367551172,395007400,6762558572,94.16,5.84
55,Chatham,2009,6411697516,411568200,6823265716,93.97,6.03
55,Chatham,2010,6364049234,419481400,6783530634,93.82,6.18
55,Chatham,2011,5852076150,388403300,6240479450,93.78,6.22
55,Chatham,2012,5870093810,392495500,6262589310,93.73,6.27
55,Chatham,2013,5791889030,404144200,6196033230,93.48,6.52
55,Chatham,2014,5778263310,400908200,6179171510,93.51,6.49
55,Chatham,2015,5949396990,408228800,6357625790,93.58,6.42
55,Chatham,2016,6203316460,424373200,6627689660,93.6,6.4
56,Chelmsford,2003,3791882263,150436400,3942318663,96.18,3.82
56,Chelmsford,2004,4281293952,201510600,4482804552,95.5,4.5
56,Chelmsford,2005,4450896140,209787000,4660683140,95.5,4.5
56,Chelmsford,2006,4808227090,218737100,5026964190,95.65,4.35
56,Chelmsford,2007,5364493390,279853900,5644347290,95.04,4.96
56,Chelmsford,2008,5248209200,281018400,5529227600,94.92,5.08
56,Chelmsford,2009,5071019145,277267000,5348286145,94.82,5.18
56,Chelmsford,2010,4855429025,266770800,5122199825,94.79,5.21
56,Chelmsford,2011,4567053990,261521400,4828575390,94.58,5.42
56,Chelmsford,2012,4514921320,263917100,4778838420,94.48,5.52
56,Chelmsford,2013,4478669470,263459800,4742129270,94.44,5.56
56,Chelmsford,2014,4437114133,289018000,4726132133,93.88,6.12
56,Chelmsford,2015,4652433926,293609100,4946043026,94.06,5.94
56,Chelmsford,2016,4976053006,288828200,5264881206,94.51,5.49
57,Chelsea,2003,1827700590,689870700,2517571290,72.6,27.4
57,Chelsea,2004,2152149370,700698100,2852847470,75.44,24.56
57,Chelsea,2005,2283134905,700316700,2983451605,76.53,23.47
57,Chelsea,2006,2480976960,725250300,3206227260,77.38,22.62
57,Chelsea,2007,2681215409,809618000,3490833409,76.81,23.19
57,Chelsea,2008,2655232550,838589100,3493821650,76,24
57,Chelsea,2009,2429032650,865785600,3294818250,73.72,26.28
57,Chelsea,2010,2131640190,868553400,3000193590,71.05,28.95
57,Chelsea,2011,2101605425,886543700,2988149125,70.33,29.67
57,Chelsea,2012,2047008800,872576800,2919585600,70.11,29.89
57,Chelsea,2013,2108663490,980094700,3088758190,68.27,31.73
57,Chelsea,2014,2119305920,977389500,3096695420,68.44,31.56
57,Chelsea,2015,2399373740,1004406300,3403780040,70.49,29.51
57,Chelsea,2016,2622245420,1039735500,3661980920,71.61,28.39
58,Cheshire,2003,174457100,39181700,213638800,81.66,18.34
58,Cheshire,2004,175953500,39271800,215225300,81.75,18.25
58,Cheshire,2005,211016989,47126200,258143189,81.74,18.26
58,Cheshire,2006,237523485,69173708,306697193,77.45,22.55
58,Cheshire,2007,289746285,49182600,338928885,85.49,14.51
58,Cheshire,2008,290275283,49234200,339509483,85.5,14.5
58,Cheshire,2009,292470836,49133900,341604736,85.62,14.38
58,Cheshire,2010,304883087,49288000,354171087,86.08,13.92
58,Cheshire,2011,304915866,49028500,353944366,86.15,13.85
58,Cheshire,2012,307610006,49086500,356696506,86.24,13.76
58,Cheshire,2013,294815820,49180500,343996320,85.7,14.3
58,Cheshire,2014,294910459,51537400,346447859,85.12,14.88
58,Cheshire,2015,295541054,51674100,347215154,85.12,14.88
58,Cheshire,2016,302765482,52723200,355488682,85.17,14.83
59,Chester,2003,77424702,4857400,82282102,94.1,5.9
59,Chester,2004,78388027,4765300,83153327,94.27,5.73
59,Chester,2005,85664713,10255000,95919713,89.31,10.69
59,Chester,2006,102037978,12011200,114049178,89.47,10.53
59,Chester,2007,112113659,12935500,125049159,89.66,10.34
59,Chester,2008,121756528,13454100,135210628,90.05,9.95
59,Chester,2009,127119061,13121300,140240361,90.64,9.36
59,Chester,2010,127534262,13093600,140627862,90.69,9.31
59,Chester,2011,118897601,13076000,131973601,90.09,9.91
59,Chester,2012,119268971,12744100,132013071,90.35,9.65
59,Chester,2013,116668139,11852400,128520539,90.78,9.22
59,Chester,2014,117758511,11996000,129754511,90.75,9.25
59,Chester,2015,117842822,12085200,129928022,90.7,9.3
59,Chester,2016,116822944,11484400,128307344,91.05,8.95
60,Chesterfield,2003,78661380,8170300,86831680,90.59,9.41
60,Chesterfield,2004,92006840,10209400,102216240,90.01,9.99
60,Chesterfield,2005,94204020,9703700,103907720,90.66,9.34
60,Chesterfield,2006,127626910,12547600,140174510,91.05,8.95
60,Chesterfield,2007,143917840,15901700,159819540,90.05,9.95
60,Chesterfield,2008,146842730,15564700,162407430,90.42,9.58
60,Chesterfield,2009,151942100,15989800,167931900,90.48,9.52
60,Chesterfield,2010,144472810,16128900,160601710,89.96,10.04
60,Chesterfield,2011,142324360,15914200,158238560,89.94,10.06
60,Chesterfield,2012,144445950,15827700,160273650,90.12,9.88
60,Chesterfield,2013,138447150,16051100,154498250,89.61,10.39
60,Chesterfield,2014,139750930,18017900,157768830,88.58,11.42
60,Chesterfield,2015,140105660,18018600,158124260,88.6,11.4
60,Chesterfield,2016,146144480,19094300,165238780,88.44,11.56
61,Chicopee,2003,2261844510,437140830,2698985340,83.8,16.2
61,Chicopee,2004,2294683040,440055522,2734738562,83.91,16.09
61,Chicopee,2005,2868983860,529080500,3398064360,84.43,15.57
61,Chicopee,2006,3118330220,529287100,3647617320,85.49,14.51
61,Chicopee,2007,3452858550,533680680,3986539230,86.61,13.39
61,Chicopee,2008,3746883400,582714800,4329598200,86.54,13.46
61,Chicopee,2009,3748947324,578829986,4327777310,86.63,13.37
61,Chicopee,2010,3665344340,649406000,4314750340,84.95,15.05
61,Chicopee,2011,3623193820,674629800,4297823620,84.3,15.7
61,Chicopee,2012,3631755730,693210200,4324965930,83.97,16.03
61,Chicopee,2013,3584845830,682011600,4266857430,84.02,15.98
61,Chicopee,2014,3623878380,687406600,4311284980,84.06,15.94
61,Chicopee,2015,3670124210,698752300,4368876510,84.01,15.99
61,Chicopee,2016,3729040780,697856880,4426897660,84.24,15.76
62,Chilmark,2003,2516260692,121152800,2637413492,95.41,4.59
62,Chilmark,2004,2478008292,124720200,2602728492,95.21,4.79
62,Chilmark,2005,2540597050,125987500,2666584550,95.28,4.72
62,Chilmark,2006,2794317500,143973600,2938291100,95.1,4.9
62,Chilmark,2007,2904616200,159852300,3064468500,94.78,5.22
62,Chilmark,2008,2920742450,169426000,3090168450,94.52,5.48
62,Chilmark,2009,3106996400,186978700,3293975100,94.32,5.68
62,Chilmark,2010,3060583926,184120400,3244704326,94.33,5.67
62,Chilmark,2011,3076542100,182217600,3258759700,94.41,5.59
62,Chilmark,2012,3196293470,190897500,3387190970,94.36,5.64
62,Chilmark,2013,3144300790,181088500,3325389290,94.55,5.45
62,Chilmark,2014,3138733776,175436500,3314170276,94.71,5.29
62,Chilmark,2015,3114495690,156599600,3271095290,95.21,4.79
62,Chilmark,2016,3126956840,154714700,3281671540,95.29,4.71
63,Clarksburg,2003,67244682,4875900,72120582,93.24,6.76
63,Clarksburg,2004,82816255,5886464,88702719,93.36,6.64
63,Clarksburg,2005,84069064,7168364,91237428,92.14,7.86
63,Clarksburg,2006,95215828,8451500,103667328,91.85,8.15
63,Clarksburg,2007,118361284,11545100,129906384,91.11,8.89
63,Clarksburg,2008,119135523,11545100,130680623,91.17,8.83
63,Clarksburg,2009,120694550,8929800,129624350,93.11,6.89
63,Clarksburg,2010,122700394,9279100,131979494,92.97,7.03
63,Clarksburg,2011,123105014,9279100,132384114,92.99,7.01
63,Clarksburg,2012,123742868,9349900,133092768,92.97,7.03
63,Clarksburg,2013,118715510,8667600,127383110,93.2,6.8
63,Clarksburg,2014,118778991,8691400,127470391,93.18,6.82
63,Clarksburg,2015,120986566,8862600,129849166,93.17,6.83
63,Clarksburg,2016,112169420,8263000,120432420,93.14,6.86
64,Clinton,2003,792220510,95046300,887266810,89.29,10.71
64,Clinton,2004,821357492,124745900,946103392,86.81,13.19
64,Clinton,2005,1030307420,131280100,1161587520,88.7,11.3
64,Clinton,2006,1196430596,152015200,1348445796,88.73,11.27
64,Clinton,2007,1235397338,152514100,1387911438,89.01,10.99
64,Clinton,2008,1259671639,154584400,1414256039,89.07,10.93
64,Clinton,2009,1210206007,149333500,1359539507,89.02,10.98
64,Clinton,2010,1164793537,150681000,1315474537,88.55,11.45
64,Clinton,2011,1106650950,150605200,1257256150,88.02,11.98
64,Clinton,2012,1059015003,196146800,1255161803,84.37,15.63
64,Clinton,2013,1069466079,196190800,1265656879,84.5,15.5
64,Clinton,2014,1074393385,198007200,1272400585,84.44,15.56
64,Clinton,2015,1088248772,197939600,1286188372,84.61,15.39
64,Clinton,2016,1157307120,198686900,1355994020,85.35,14.65
65,Cohasset,2003,1602813423,93377000,1696190423,94.49,5.51
65,Cohasset,2004,1730261119,104698700,1834959819,94.29,5.71
65,Cohasset,2005,2086149189,128153400,2214302589,94.21,5.79
65,Cohasset,2006,2173147423,143859540,2317006963,93.79,6.21
65,Cohasset,2007,2324029983,149665635,2473695618,93.95,6.05
65,Cohasset,2008,2403120204,150751035,2553871239,94.1,5.9
65,Cohasset,2009,2455174229,155500781,2610675010,94.04,5.96
65,Cohasset,2010,2438739752,153657300,2592397052,94.07,5.93
65,Cohasset,2011,2440301624,151434750,2591736374,94.16,5.84
65,Cohasset,2012,2465755221,162883349,2628638570,93.8,6.2
65,Cohasset,2013,2521526250,163614833,2685141083,93.91,6.09
65,Cohasset,2014,2542277461,164318033,2706595494,93.93,6.07
65,Cohasset,2015,2613497066,166637733,2780134799,94.01,5.99
65,Cohasset,2016,2675601045,171117392,2846718437,93.99,6.01
66,Colrain,2003,97513579,6389500,103903079,93.85,6.15
66,Colrain,2004,113855058,6803300,120658358,94.36,5.64
66,Colrain,2005,121450074,7146000,128596074,94.44,5.56
66,Colrain,2006,128692693,7562500,136255193,94.45,5.55
66,Colrain,2007,154392531,11554800,165947331,93.04,6.96
66,Colrain,2008,161135120,12332800,173467920,92.89,7.11
66,Colrain,2009,163983790,12388600,176372390,92.98,7.02
66,Colrain,2010,168907869,12222400,181130269,93.25,6.75
66,Colrain,2011,169390827,12222300,181613127,93.27,6.73
66,Colrain,2012,163166257,12164900,175331157,93.06,6.94
66,Colrain,2013,163882588,11909800,175792388,93.23,6.77
66,Colrain,2014,161308676,11243100,172551776,93.48,6.52
66,Colrain,2015,165683835,11362400,177046235,93.58,6.42
66,Colrain,2016,168122526,11513500,179636026,93.59,6.41
67,Concord,2003,4408301807,507734600,4916036407,89.67,10.33
67,Concord,2004,4411852520,503701200,4915553720,89.75,10.25
67,Concord,2005,5117100515,712379050,5829479565,87.78,12.22
67,Concord,2006,5207535371,818639600,6026174971,86.42,13.58
67,Concord,2007,5309253831,810307000,6119560831,86.76,13.24
67,Concord,2008,5498736316,969841100,6468577416,85.01,14.99
67,Concord,2009,5264591702,945220300,6209812002,84.78,15.22
67,Concord,2010,5026552229,935260600,5961812829,84.31,15.69
67,Concord,2011,5045140030,779722900,5824862930,86.61,13.39
67,Concord,2012,5090058629,736752600,5826811229,87.36,12.64
67,Concord,2013,5054970094,736001200,5790971294,87.29,12.71
67,Concord,2014,5130493662,757809200,5888302862,87.13,12.87
67,Concord,2015,5412298562,818279600,6230578162,86.87,13.13
67,Concord,2016,5841889295,842403700,6684292995,87.4,12.6
68,Conway,2003,143893408,10390900,154284308,93.27,6.73
68,Conway,2004,147937330,10749100,158686430,93.23,6.77
68,Conway,2005,203889600,14864700,218754300,93.2,6.8
68,Conway,2006,224236243,15286800,239523043,93.62,6.38
68,Conway,2007,245290328,15671600,260961928,93.99,6.01
68,Conway,2008,262258197,14778400,277036597,94.67,5.33
68,Conway,2009,260092971,14749400,274842371,94.63,5.37
68,Conway,2010,259788153,14722400,274510553,94.64,5.36
68,Conway,2011,263180978,17939000,281119978,93.62,6.38
68,Conway,2012,258882956,17803300,276686256,93.57,6.43
68,Conway,2013,254292607,17414000,271706607,93.59,6.41
68,Conway,2014,244083296,17806300,261889596,93.2,6.8
68,Conway,2015,245916874,16944500,262861374,93.55,6.45
68,Conway,2016,245647098,17087700,262734798,93.5,6.5
69,Cummington,2003,74287032,15200200,89487232,83.01,16.99
69,Cummington,2004,82072710,15135300,97208010,84.43,15.57
69,Cummington,2005,97533156,19791000,117324156,83.13,16.87
69,Cummington,2006,107775812,20100000,127875812,84.28,15.72
69,Cummington,2007,118091138,21069700,139160838,84.86,15.14
69,Cummington,2008,131287891,22008900,153296791,85.64,14.36
69,Cummington,2009,128133044,22623100,150756144,84.99,15.01
69,Cummington,2010,127188208,21790300,148978508,85.37,14.63
69,Cummington,2011,128039465,22127800,150167265,85.26,14.74
69,Cummington,2012,139200174,23865500,163065674,85.36,14.64
69,Cummington,2013,130647312,22764800,153412112,85.16,14.84
69,Cummington,2014,129158979,22777400,151936379,85.01,14.99
69,Cummington,2015,129864817,23243100,153107917,84.82,15.18
69,Cummington,2016,129585795,23462900,153048695,84.67,15.33
70,Dalton,2003,384121172,55309040,439430212,87.41,12.59
70,Dalton,2004,428341054,57738860,486079914,88.12,11.88
70,Dalton,2005,447111318,58191860,505303178,88.48,11.52
70,Dalton,2006,507430837,64780329,572211166,88.68,11.32
70,Dalton,2007,605943795,73081089,679024884,89.24,10.76
70,Dalton,2008,614477890,73484189,687962079,89.32,10.68
70,Dalton,2009,617699159,73690989,691390148,89.34,10.66
70,Dalton,2010,615400197,76736203,692136400,88.91,11.09
70,Dalton,2011,592354137,76585603,668939740,88.55,11.45
70,Dalton,2012,604889342,79799703,684689045,88.35,11.65
70,Dalton,2013,593936009,77892124,671828133,88.41,11.59
70,Dalton,2014,593398192,79096766,672494958,88.24,11.76
70,Dalton,2015,590091316,79142050,669233366,88.17,11.83
70,Dalton,2016,595474465,82375172,677849637,87.85,12.15
71,Danvers,2003,2997297229,471934039,3469231268,86.4,13.6
71,Danvers,2004,3644123457,572557957,4216681414,86.42,13.58
71,Danvers,2005,3844150475,602858582,4447009057,86.44,13.56
71,Danvers,2006,4126089734,612555357,4738645091,87.07,12.93
71,Danvers,2007,4556941112,656709868,5213650980,87.4,12.6
71,Danvers,2008,4363590583,659417106,5023007689,86.87,13.13
71,Danvers,2009,4292626505,656107545,4948734050,86.74,13.26
71,Danvers,2010,4096958924,573049756,4670008680,87.73,12.27
71,Danvers,2011,3930282886,575292838,4505575724,87.23,12.77
71,Danvers,2012,3922581465,577356642,4499938107,87.17,12.83
71,Danvers,2013,3894807200,569456544,4464263744,87.24,12.76
71,Danvers,2014,3934210567,602500384,4536710951,86.72,13.28
71,Danvers,2015,4056879982,604286819,4661166801,87.04,12.96
71,Danvers,2016,4391700413,630971705,5022672118,87.44,12.56
72,Dartmouth,2003,2922977326,355549800,3278527126,89.16,10.84
72,Dartmouth,2004,3992352878,420487400,4412840278,90.47,9.53
72,Dartmouth,2005,4704761290,456320300,5161081590,91.16,8.84
72,Dartmouth,2006,5396974620,517184700,5914159320,91.26,8.74
72,Dartmouth,2007,5614456420,570099200,6184555620,90.78,9.22
72,Dartmouth,2008,5797151400,602014500,6399165900,90.59,9.41
72,Dartmouth,2009,5592184580,588406100,6180590680,90.48,9.52
72,Dartmouth,2010,5292640560,571350000,5863990560,90.26,9.74
72,Dartmouth,2011,5074611650,539531100,5614142750,90.39,9.61
72,Dartmouth,2012,4987163980,537691800,5524855780,90.27,9.73
72,Dartmouth,2013,4892354870,532714000,5425068870,90.18,9.82
72,Dartmouth,2014,4787140590,510241900,5297382490,90.37,9.63
72,Dartmouth,2015,5010784630,502868900,5513653530,90.88,9.12
72,Dartmouth,2016,5225069750,503513400,5728583150,91.21,8.79
73,Dedham,2003,2396747610,215091900,2611839510,91.76,8.24
73,Dedham,2004,3446276510,264071600,3710348110,92.88,7.12
73,Dedham,2005,3656393920,289358100,3945752020,92.67,7.33
73,Dedham,2006,3848519830,297778300,4146298130,92.82,7.18
73,Dedham,2007,4254152940,330410200,4584563140,92.79,7.21
73,Dedham,2008,4077842270,326733000,4404575270,92.58,7.42
73,Dedham,2009,4072391160,335147400,4407538560,92.4,7.6
73,Dedham,2010,4005879086,383136600,4389015686,91.27,8.73
73,Dedham,2011,4020196720,390915300,4411112020,91.14,8.86
73,Dedham,2012,3932320480,599483000,4531803480,86.77,13.23
73,Dedham,2013,3953207410,668031300,4621238710,85.54,14.46
73,Dedham,2014,4026029320,671028300,4697057620,85.71,14.29
73,Dedham,2015,4138032980,679485900,4817518880,85.9,14.1
73,Dedham,2016,4320165750,698209500,5018375250,86.09,13.91
74,Deerfield,2003,439128164,125095333,564223497,77.83,22.17
74,Deerfield,2004,456246517,127895733,584142250,78.11,21.89
74,Deerfield,2005,568670435,155011145,723681580,78.58,21.42
74,Deerfield,2006,618576494,152233455,770809949,80.25,19.75
74,Deerfield,2007,669712529,158843632,828556161,80.83,19.17
74,Deerfield,2008,690165064,241787012,931952076,74.06,25.94
74,Deerfield,2009,684750979,245935312,930686291,73.57,26.43
74,Deerfield,2010,685685457,245940312,931625769,73.6,26.4
74,Deerfield,2011,677445357,238569016,916014373,73.96,26.04
74,Deerfield,2012,663976535,241127028,905103563,73.36,26.64
74,Deerfield,2013,651257271,247425928,898683199,72.47,27.53
74,Deerfield,2014,659782412,262069618,921852030,71.57,28.43
74,Deerfield,2015,660442398,271582518,932024916,70.86,29.14
74,Deerfield,2016,659913566,272892618,932806184,70.74,29.26
75,Dennis,2003,4016650250,105345500,4121995750,97.44,2.56
75,Dennis,2004,5059012340,131813200,5190825540,97.46,2.54
75,Dennis,2005,5593559948,136581400,5730141348,97.62,2.38
75,Dennis,2006,6246852010,156364300,6403216310,97.56,2.44
75,Dennis,2007,6653803930,169612300,6823416230,97.51,2.49
75,Dennis,2008,6704585330,172226600,6876811930,97.5,2.5
75,Dennis,2009,6585260060,170056360,6755316420,97.48,2.52
75,Dennis,2010,6311438960,177482960,6488921920,97.26,2.74
75,Dennis,2011,6061430270,169651040,6231081310,97.28,2.72
75,Dennis,2012,5858178100,163826110,6022004210,97.28,2.72
75,Dennis,2013,5841108100,163108510,6004216610,97.28,2.72
75,Dennis,2014,5890401460,192089400,6082490860,96.84,3.16
75,Dennis,2015,6084855680,203980100,6288835780,96.76,3.24
75,Dennis,2016,6137893050,206763400,6344656450,96.74,3.26
76,Dighton,2003,438507361,59421006,497928367,88.07,11.93
76,Dighton,2004,622320362,70410600,692730962,89.84,10.16
76,Dighton,2005,719727032,74746000,794473032,90.59,9.41
76,Dighton,2006,878710702,80627200,959337902,91.6,8.4
76,Dighton,2007,966593067,98308400,1064901467,90.77,9.23
76,Dighton,2008,945148879,96621600,1041770479,90.73,9.27
76,Dighton,2009,948024516,99742400,1047766916,90.48,9.52
76,Dighton,2010,904797423,92989900,997787323,90.68,9.32
76,Dighton,2011,888461663,96674600,985136263,90.19,9.81
76,Dighton,2012,838801062,95705200,934506262,89.76,10.24
76,Dighton,2013,834679642,100326300,935005942,89.27,10.73
76,Dighton,2014,807566976,95393900,902960876,89.44,10.56
76,Dighton,2015,838630293,93001900,931632193,90.02,9.98
76,Dighton,2016,856225937,97891100,954117037,89.74,10.26
77,Douglas,2003,544739900,41616600,586356500,92.9,7.1
77,Douglas,2004,560942756,56608700,617551456,90.83,9.17
77,Douglas,2005,825231359,80318500,905549859,91.13,8.87
77,Douglas,2006,926213678,84133100,1010346778,91.67,8.33
77,Douglas,2007,1022193165,88908100,1111101265,92,8
77,Douglas,2008,1023591566,93443200,1117034766,91.63,8.37
77,Douglas,2009,988449373,93649800,1082099173,91.35,8.65
77,Douglas,2010,939198196,91697300,1030895496,91.11,8.89
77,Douglas,2011,850874293,81813400,932687693,91.23,8.77
77,Douglas,2012,846826192,78763300,925589492,91.49,8.51
77,Douglas,2013,854687630,78793300,933480930,91.56,8.44
77,Douglas,2014,857627091,77901800,935528891,91.67,8.33
77,Douglas,2015,876822085,88630600,965452685,90.82,9.18
77,Douglas,2016,884177063,90324800,974501863,90.73,9.27
78,Dover,2003,1718511428,219701646,1938213074,88.66,11.34
78,Dover,2004,1932183947,251308396,2183492343,88.49,11.51
78,Dover,2005,2212267999,292893961,2505161960,88.31,11.69
78,Dover,2006,2311929628,313496511,2625426139,88.06,11.94
78,Dover,2007,2369624586,315303311,2684927897,88.26,11.74
78,Dover,2008,2348365777,321803796,2670169573,87.95,12.05
78,Dover,2009,2415408671,326069500,2741478171,88.11,11.89
78,Dover,2010,2291620903,322903900,2614524803,87.65,12.35
78,Dover,2011,2203955637,314763100,2518718737,87.5,12.5
78,Dover,2012,2221504984,307915500,2529420484,87.83,12.17
78,Dover,2013,2137444532,303767900,2441212432,87.56,12.44
78,Dover,2014,2167270931,303223400,2470494331,87.73,12.27
78,Dover,2015,2317964289,313932500,2631896789,88.07,11.93
78,Dover,2016,2366676132,317070300,2683746432,88.19,11.81
79,Dracut,2003,2152614110,85947500,2238561610,96.16,3.84
79,Dracut,2004,2184136224,86713500,2270849724,96.18,3.82
79,Dracut,2005,2802799972,149587600,2952387572,94.93,5.07
79,Dracut,2006,3145784444,177272800,3323057244,94.67,5.33
79,Dracut,2007,3187413627,175609200,3363022827,94.78,5.22
79,Dracut,2008,3085904579,177385600,3263290179,94.56,5.44
79,Dracut,2009,3104532807,208847300,3313380107,93.7,6.3
79,Dracut,2010,2952877574,204321200,3157198774,93.53,6.47
79,Dracut,2011,2837174198,203513900,3040688098,93.31,6.69
79,Dracut,2012,2873936086,201696400,3075632486,93.44,6.56
79,Dracut,2013,2792540325,199680200,2992220525,93.33,6.67
79,Dracut,2014,2778391123,200767400,2979158523,93.26,6.74
79,Dracut,2015,2904745093,214351700,3119096793,93.13,6.87
79,Dracut,2016,3024231256,216790200,3241021456,93.31,6.69
80,Dudley,2003,572814032,56318300,629132332,91.05,8.95
80,Dudley,2004,630146363,66348400,696494763,90.47,9.53
80,Dudley,2005,872739632,75943600,948683232,91.99,8.01
80,Dudley,2006,946117973,77680900,1023798873,92.41,7.59
80,Dudley,2007,1009592489,77993200,1087585689,92.83,7.17
80,Dudley,2008,1055531508,78686700,1134218208,93.06,6.94
80,Dudley,2009,988187451,82016300,1070203751,92.34,7.66
80,Dudley,2010,907845917,82686200,990532117,91.65,8.35
80,Dudley,2011,859171651,77998700,937170351,91.68,8.32
80,Dudley,2012,834561656,101270200,935831856,89.18,10.82
80,Dudley,2013,811389272,101858900,913248172,88.85,11.15
80,Dudley,2014,826923189,102037000,928960189,89.02,10.98
80,Dudley,2015,851288128,109426250,960714378,88.61,11.39
80,Dudley,2016,880168520,110781250,990949770,88.82,11.18
81,Dunstable,2003,331589975,14004800,345594775,95.95,4.05
81,Dunstable,2004,368970772,16110400,385081172,95.82,4.18
81,Dunstable,2005,425650072,19242300,444892372,95.67,4.33
81,Dunstable,2006,471559052,23161900,494720952,95.32,4.68
81,Dunstable,2007,517564752,25828700,543393452,95.25,4.75
81,Dunstable,2008,535162772,27708400,562871172,95.08,4.92
81,Dunstable,2009,510867566,29015600,539883166,94.63,5.37
81,Dunstable,2010,493855899,28006900,521862799,94.63,5.37
81,Dunstable,2011,484785421,28109800,512895221,94.52,5.48
81,Dunstable,2012,459475441,25741800,485217241,94.69,5.31
81,Dunstable,2013,459895571,26740900,486636471,94.5,5.5
81,Dunstable,2014,456199952,25957700,482157652,94.62,5.38
81,Dunstable,2015,459074618,27168900,486243518,94.41,5.59
81,Dunstable,2016,478410464,30441200,508851664,94.02,5.98
82,Duxbury,2003,2575357610,291185900,2866543510,89.84,10.16
82,Duxbury,2004,2875209840,338928800,3214138640,89.46,10.54
82,Duxbury,2005,3297507320,401316300,3698823620,89.15,10.85
82,Duxbury,2006,3593172400,434822800,4027995200,89.2,10.8
82,Duxbury,2007,3668240970,437212000,4105452970,89.35,10.65
82,Duxbury,2008,3651481380,409630500,4061111880,89.91,10.09
82,Duxbury,2009,3734744800,374189000,4108933800,90.89,9.11
82,Duxbury,2010,3502291940,350092000,3852383940,90.91,9.09
82,Duxbury,2011,3352883200,337733100,3690616300,90.85,9.15
82,Duxbury,2012,3200635311,305104600,3505739911,91.3,8.7
82,Duxbury,2013,3214667680,323857700,3538525380,90.85,9.15
82,Duxbury,2014,3276537630,328718330,3605255960,90.88,9.12
82,Duxbury,2015,3506420685,453208007,3959628692,88.55,11.45
82,Duxbury,2016,3631924735,401172391,4033097126,90.05,9.95
83,East Bridgewater,2003,848029900,68523500,916553400,92.52,7.48
83,East Bridgewater,2004,1275229300,82860400,1358089700,93.9,6.1
83,East Bridgewater,2005,1386273290,83162800,1469436090,94.34,5.66
83,East Bridgewater,2006,1495351690,83820000,1579171690,94.69,5.31
83,East Bridgewater,2007,1683155430,114396500,1797551930,93.64,6.36
83,East Bridgewater,2008,1702423130,114751700,1817174830,93.69,6.31
83,East Bridgewater,2009,1662303660,115822400,1778126060,93.49,6.51
83,East Bridgewater,2010,1615344350,113955900,1729300250,93.41,6.59
83,East Bridgewater,2011,1571026880,114184800,1685211680,93.22,6.78
83,East Bridgewater,2012,1531786400,112723100,1644509500,93.15,6.85
83,East Bridgewater,2013,1552171830,112452500,1664624330,93.24,6.76
83,East Bridgewater,2014,1473372150,112313700,1585685850,92.92,7.08
83,East Bridgewater,2015,1503175130,114449400,1617624530,92.92,7.08
83,East Bridgewater,2016,1515180600,116207700,1631388300,92.88,7.12
84,East Brookfield,2003,130818788,13970300,144789088,90.35,9.65
84,East Brookfield,2004,134639642,13827500,148467142,90.69,9.31
84,East Brookfield,2005,206407321,16500000,222907321,92.6,7.4
84,East Brookfield,2006,243502911,16926200,260429111,93.5,6.5
84,East Brookfield,2007,250050602,16914900,266965502,93.66,6.34
84,East Brookfield,2008,248860227,17637200,266497427,93.38,6.62
84,East Brookfield,2009,253004706,26132100,279136806,90.64,9.36
84,East Brookfield,2010,234719181,24034250,258753431,90.71,9.29
84,East Brookfield,2011,221476942,21913000,243389942,91,9
84,East Brookfield,2012,222864941,21950000,244814941,91.03,8.97
84,East Brookfield,2013,222657289,22729300,245386589,90.74,9.26
84,East Brookfield,2014,195810169,19576900,215387069,90.91,9.09
84,East Brookfield,2015,197525245,19576900,217102145,90.98,9.02
84,East Brookfield,2016,198808023,19451500,218259523,91.09,8.91
85,East Longmeadow,2003,1152746426,98971600,1251718026,92.09,7.91
85,East Longmeadow,2004,1169679260,102841100,1272520360,91.92,8.08
85,East Longmeadow,2005,1454793188,126716400,1581509588,91.99,8.01
85,East Longmeadow,2006,1549430201,129241100,1678671301,92.3,7.7
85,East Longmeadow,2007,1707703906,132015300,1839719206,92.82,7.18
85,East Longmeadow,2008,1813614311,167134700,1980749011,91.56,8.44
85,East Longmeadow,2009,1852981080,168220000,2021201080,91.68,8.32
85,East Longmeadow,2010,1795002834,168701000,1963703834,91.41,8.59
85,East Longmeadow,2011,1787452775,172687300,1960140075,91.19,8.81
85,East Longmeadow,2012,1772969942,162874000,1935843942,91.59,8.41
85,East Longmeadow,2013,1774474733,162631000,1937105733,91.6,8.4
85,East Longmeadow,2014,1770777465,157801000,1928578465,91.82,8.18
85,East Longmeadow,2015,1804688796,165311800,1970000596,91.61,8.39
85,East Longmeadow,2016,1817660272,165716500,1983376772,91.64,8.36
86,Eastham,2003,1208911140,64020900,1272932040,94.97,5.03
86,Eastham,2004,2337607330,154808900,2492416230,93.79,6.21
86,Eastham,2005,2486527329,169451900,2655979229,93.62,6.38
86,Eastham,2006,2891126680,186317400,3077444080,93.95,6.05
86,Eastham,2007,3025125790,194542700,3219668490,93.96,6.04
86,Eastham,2008,3001638700,198556500,3200195200,93.8,6.2
86,Eastham,2009,2927099260,188482400,3115581660,93.95,6.05
86,Eastham,2010,2897862240,241519000,3139381240,92.31,7.69
86,Eastham,2011,2760251860,218356600,2978608460,92.67,7.33
86,Eastham,2012,2710948360,213597500,2924545860,92.7,7.3
86,Eastham,2013,2680491360,208963000,2889454360,92.77,7.23
86,Eastham,2014,2642790450,195442900,2838233350,93.11,6.89
86,Eastham,2015,2657994390,196446100,2854440490,93.12,6.88
86,Eastham,2016,2725537180,206845100,2932382280,92.95,7.05
87,Easthampton,2003,733850670,100349300,834199970,87.97,12.03
87,Easthampton,2004,955260620,129273600,1084534220,88.08,11.92
87,Easthampton,2005,1094631946,134137900,1228769846,89.08,10.92
87,Easthampton,2006,1233184576,134450800,1367635376,90.17,9.83
87,Easthampton,2007,1366394000,147434700,1513828700,90.26,9.74
87,Easthampton,2008,1386059330,148325400,1534384730,90.33,9.67
87,Easthampton,2009,1404767970,149181880,1553949850,90.4,9.6
87,Easthampton,2010,1391081830,148610980,1539692810,90.35,9.65
87,Easthampton,2011,1400908597,144521980,1545430577,90.65,9.35
87,Easthampton,2012,1401693688,142109380,1543803068,90.79,9.21
87,Easthampton,2013,1401028336,146186680,1547215016,90.55,9.45
87,Easthampton,2014,1418403303,152448825,1570852128,90.3,9.7
87,Easthampton,2015,1429489523,152367500,1581857023,90.37,9.63
87,Easthampton,2016,1435539281,151397100,1586936381,90.46,9.54
88,Easton,2003,1986755670,161516050,2148271720,92.48,7.52
88,Easton,2004,2386020110,174500150,2560520260,93.18,6.82
88,Easton,2005,2713292920,179308400,2892601320,93.8,6.2
88,Easton,2006,2935473220,184373150,3119846370,94.09,5.91
88,Easton,2007,3333237870,274072750,3607310620,92.4,7.6
88,Easton,2008,3276833080,273550550,3550383630,92.3,7.7
88,Easton,2009,3192976630,274426450,3467403080,92.09,7.91
88,Easton,2010,3058665160,281155050,3339820210,91.58,8.42
88,Easton,2011,2940547730,278147850,3218695580,91.36,8.64
88,Easton,2012,2947436892,283786400,3231223292,91.22,8.78
88,Easton,2013,2881173603,324480400,3205654003,89.88,10.12
88,Easton,2014,2828316107,342716100,3171032207,89.19,10.81
88,Easton,2015,2916678289,363898200,3280576489,88.91,11.09
88,Easton,2016,3134253346,345746100,3479999446,90.06,9.94
89,Edgartown,2003,3626944740,281494100,3908438840,92.8,7.2
89,Edgartown,2004,4345518930,303676100,4649195030,93.47,6.53
89,Edgartown,2005,5416132430,458250800,5874383230,92.2,7.8
89,Edgartown,2006,5949105140,533707800,6482812940,91.77,8.23
89,Edgartown,2007,6323809975,558304400,6882114375,91.89,8.11
89,Edgartown,2008,7009320115,668570290,7677890405,91.29,8.71
89,Edgartown,2009,6878503105,651144120,7529647225,91.35,8.65
89,Edgartown,2010,6748455465,651448020,7399903485,91.2,8.8
89,Edgartown,2011,6563959740,637637120,7201596860,91.15,8.85
89,Edgartown,2012,6666537995,687296220,7353834215,90.65,9.35
89,Edgartown,2013,6597990238,679012820,7277003058,90.67,9.33
89,Edgartown,2014,6613836438,674150920,7287987358,90.75,9.25
89,Edgartown,2015,7028192628,682526720,7710719348,91.15,8.85
89,Edgartown,2016,7276701078,680863000,7957564078,91.44,8.56
90,Egremont,2003,241853429,15689700,257543129,93.91,6.09
90,Egremont,2004,295216860,19090200,314307060,93.93,6.07
90,Egremont,2005,312527938,22986500,335514438,93.15,6.85
90,Egremont,2006,365935564,37500400,403435964,90.7,9.3
90,Egremont,2007,404882639,50924200,455806839,88.83,11.17
90,Egremont,2008,480619130,105029700,585648830,82.07,17.93
90,Egremont,2009,467988238,96616400,564604638,82.89,17.11
90,Egremont,2010,443037371,89023000,532060371,83.27,16.73
90,Egremont,2011,410058628,66440200,476498828,86.06,13.94
90,Egremont,2012,390053318,61553100,451606418,86.37,13.63
90,Egremont,2013,383017297,62046100,445063397,86.06,13.94
90,Egremont,2014,381368729,62368200,443736929,85.94,14.06
90,Egremont,2015,380904827,62628700,443533527,85.88,14.12
90,Egremont,2016,384010808,62714900,446725708,85.96,14.04
91,Erving,2003,586115424,19152500,605267924,96.84,3.16
91,Erving,2004,588966733,21118200,610084933,96.54,3.46
91,Erving,2005,602773284,24480300,627253584,96.1,3.9
91,Erving,2006,582718812,27823100,610541912,95.44,4.56
91,Erving,2007,596669202,27949200,624618402,95.53,4.47
91,Erving,2008,601233832,28248400,629482232,95.51,4.49
91,Erving,2009,619692606,28331000,648023606,95.63,4.37
91,Erving,2010,619262929,28379400,647642329,95.62,4.38
91,Erving,2011,626076819,28440000,654516819,95.65,4.35
91,Erving,2012,628752346,28509700,657262046,95.66,4.34
91,Erving,2013,648965177,32918800,681883977,95.17,4.83
91,Erving,2014,652199643,32616600,684816243,95.24,4.76
91,Erving,2015,652382315,32658200,685040515,95.23,4.77
91,Erving,2016,878569578,35310800,913880378,96.14,3.86
92,Essex,2003,493025930,32999800,526025730,93.73,6.27
92,Essex,2004,614703570,36877300,651580870,94.34,5.66
92,Essex,2005,664671190,37013200,701684390,94.73,5.27
92,Essex,2006,759944450,52437400,812381850,93.55,6.45
92,Essex,2007,815191000,51862900,867053900,94.02,5.98
92,Essex,2008,811316270,57770360,869086630,93.35,6.65
92,Essex,2009,819627810,61161900,880789710,93.06,6.94
92,Essex,2010,829856573,56098280,885954853,93.67,6.33
92,Essex,2011,777138722,51015200,828153922,93.84,6.16
92,Essex,2012,751324126,46493300,797817426,94.17,5.83
92,Essex,2013,755781684,47634600,803416284,94.07,5.93
92,Essex,2014,744678345,47644300,792322645,93.99,6.01
92,Essex,2015,747594356,50110500,797704856,93.72,6.28
92,Essex,2016,765565677,55683900,821249577,93.22,6.78
93,Everett,2003,3376849040,394239000,3771088040,89.55,10.45
93,Everett,2004,3306749745,403698600,3710448345,89.12,10.88
93,Everett,2005,3926642631,523564400,4450207031,88.24,11.76
93,Everett,2006,4560626366,593492600,5154118966,88.49,11.51
93,Everett,2007,4766973989,593435900,5360409889,88.93,11.07
93,Everett,2008,4835851102,596334100,5432185202,89.02,10.98
93,Everett,2009,4438380003,649204600,5087584603,87.24,12.76
93,Everett,2010,3707402590,599062400,4306464990,86.09,13.91
93,Everett,2011,3276697828,645690500,3922388328,83.54,16.46
93,Everett,2012,3535432288,585263540,4120695828,85.8,14.2
93,Everett,2013,3547990080,519431350,4067421430,87.23,12.77
93,Everett,2014,3615430470,537376050,4152806520,87.06,12.94
93,Everett,2015,4009259197,536429250,4545688447,88.2,11.8
93,Everett,2016,4314767780,539396750,4854164530,88.89,11.11
94,Fairhaven,2003,1269993573,113246100,1383239673,91.81,8.19
94,Fairhaven,2004,1397788849,114733900,1512522749,92.41,7.59
94,Fairhaven,2005,1841490449,165479695,2006970144,91.75,8.25
94,Fairhaven,2006,1986103212,172681563,2158784775,92,8
94,Fairhaven,2007,2134694778,180625388,2315320166,92.2,7.8
94,Fairhaven,2008,2243272232,189491345,2432763577,92.21,7.79
94,Fairhaven,2009,2201936518,186617245,2388553763,92.19,7.81
94,Fairhaven,2010,2129465251,187149145,2316614396,91.92,8.08
94,Fairhaven,2011,2029963617,173752573,2203716190,92.12,7.88
94,Fairhaven,2012,1951014819,171749268,2122764087,91.91,8.09
94,Fairhaven,2013,1920946889,174785268,2095732157,91.66,8.34
94,Fairhaven,2014,1849070614,170340668,2019411282,91.56,8.44
94,Fairhaven,2015,1844247558,170706468,2014954026,91.53,8.47
94,Fairhaven,2016,1892927321,170106571,2063033892,91.75,8.25
95,Fall River,2003,3035551747,750923500,3786475247,80.17,19.83
95,Fall River,2004,4171271660,1108444000,5279715660,79.01,20.99
95,Fall River,2005,5003607986,1108444000,6112051986,81.86,18.14
95,Fall River,2006,5960047484,1060648500,7020695984,84.89,15.11
95,Fall River,2007,6558672565,984463100,7543135665,86.95,13.05
95,Fall River,2008,6716692362,1044537000,7761229362,86.54,13.46
95,Fall River,2009,6429439920,1024289300,7453729220,86.26,13.74
95,Fall River,2010,6117043325,979838704,7096882029,86.19,13.81
95,Fall River,2011,5746543529,1015229468,6761772997,84.99,15.01
95,Fall River,2012,5505625991,944068444,6449694435,85.36,14.64
95,Fall River,2013,5310575275,916636828,6227212103,85.28,14.72
95,Fall River,2014,5233861823,908051596,6141913419,85.22,14.78
95,Fall River,2015,5189075984,915837340,6104913324,85,15
95,Fall River,2016,5211516417,920716412,6132232829,84.99,15.01
96,Falmouth,2003,6780987057,520631100,7301618157,92.87,7.13
96,Falmouth,2004,7507947560,573296900,8081244460,92.91,7.09
96,Falmouth,2005,10264707235,906187700,11170894935,91.89,8.11
96,Falmouth,2006,11300454443,1044531400,12344985843,91.54,8.46
96,Falmouth,2007,12306390382,1112484900,13418875282,91.71,8.29
96,Falmouth,2008,12253538623,1040312279,13293850902,92.17,7.83
96,Falmouth,2009,11848159093,1003303000,12851462093,92.19,7.81
96,Falmouth,2010,11175752766,942638300,12118391066,92.22,7.78
96,Falmouth,2011,11045267377,931258728,11976526105,92.22,7.78
96,Falmouth,2012,10579861695,1083186091,11663047786,90.71,9.29
96,Falmouth,2013,10614941343,1139991991,11754933334,90.3,9.7
96,Falmouth,2014,10760779222,1154009291,11914788513,90.31,9.69
96,Falmouth,2015,11045497654,1140976258,12186473912,90.64,9.36
96,Falmouth,2016,11194449029,1150138290,12344587319,90.68,9.32
97,Fitchburg,2003,1592787823,501468200,2094256023,76.06,23.94
97,Fitchburg,2004,1878879332,547144700,2426024032,77.45,22.55
97,Fitchburg,2005,2145562649,571578000,2717140649,78.96,21.04
97,Fitchburg,2006,2424475656,586583200,3011058856,80.52,19.48
97,Fitchburg,2007,2691586276,661901100,3353487376,80.26,19.74
97,Fitchburg,2008,2774561406,665038696,3439600102,80.67,19.33
97,Fitchburg,2009,2673490274,668668696,3342158970,79.99,20.01
97,Fitchburg,2010,2443382008,644406096,3087788104,79.13,20.87
97,Fitchburg,2011,2275143403,640835096,2915978499,78.02,21.98
97,Fitchburg,2012,2168805671,533931600,2702737271,80.24,19.76
97,Fitchburg,2013,2076968585,536459000,2613427585,79.47,20.53
97,Fitchburg,2014,2065732586,561530400,2627262986,78.63,21.37
97,Fitchburg,2015,2093135075,578039700,2671174775,78.36,21.64
97,Fitchburg,2016,2124541595,657349400,2781890995,76.37,23.63
98,Florida,2003,97064000,4056700,101120700,95.99,4.01
98,Florida,2004,98031400,4033000,102064400,96.05,3.95
98,Florida,2005,98948175,3336900,102285075,96.74,3.26
98,Florida,2006,117215202,5300900,122516102,95.67,4.33
98,Florida,2007,123504949,5515900,129020849,95.72,4.28
98,Florida,2008,129191008,5747200,134938208,95.74,4.26
98,Florida,2009,132473467,6089300,138562767,95.61,4.39
98,Florida,2010,123288702,6596500,129885202,94.92,5.08
98,Florida,2011,121575325,6497700,128073025,94.93,5.07
98,Florida,2012,126385031,6517200,132902231,95.1,4.9
98,Florida,2013,119545425,6575500,126120925,94.79,5.21
98,Florida,2014,119887568,6479000,126366568,94.87,5.13
98,Florida,2015,125242645,7216100,132458745,94.55,5.45
98,Florida,2016,125126992,7441800,132568792,94.39,5.61
99,Foxborough,2003,1608167670,494679900,2102847570,76.48,23.52
99,Foxborough,2004,2123625390,530346604,2653971994,80.02,19.98
99,Foxborough,2005,2204719990,531234704,2735954694,80.58,19.42
99,Foxborough,2006,2512856522,539666304,3052522826,82.32,17.68
99,Foxborough,2007,2738599190,558212304,3296811494,83.07,16.93
99,Foxborough,2008,2681133380,558523900,3239657280,82.76,17.24
99,Foxborough,2009,2733832700,575335400,3309168100,82.61,17.39
99,Foxborough,2010,2789786250,730184600,3519970850,79.26,20.74
99,Foxborough,2011,2673488160,726744700,3400232860,78.63,21.37
99,Foxborough,2012,2596958660,713827500,3310786160,78.44,21.56
99,Foxborough,2013,2604132810,715421200,3319554010,78.45,21.55
99,Foxborough,2014,2558998750,759556800,3318555550,77.11,22.89
99,Foxborough,2015,2624494720,763355100,3387849820,77.47,22.53
99,Foxborough,2016,2798264830,711129200,3509394030,79.74,20.26
100,Framingham,2003,6806756950,708849600,7515606550,90.57,9.43
100,Framingham,2004,6869312590,766315700,7635628290,89.96,10.04
100,Framingham,2005,7762568967,829102500,8591671467,90.35,9.65
100,Framingham,2006,8591290114,1164244700,9755534814,88.07,11.93
100,Framingham,2007,8741437605,1176788600,9918226205,88.14,11.86
100,Framingham,2008,8801392729,1180141000,9981533729,88.18,11.82
100,Framingham,2009,8734450587,1022843800,9757294387,89.52,10.48
100,Framingham,2010,7934481314,1004629600,8939110914,88.76,11.24
100,Framingham,2011,7459613764,969230400,8428844164,88.5,11.5
100,Framingham,2012,7529736477,1007711490,8537447967,88.2,11.8
100,Framingham,2013,7268634368,985636292,8254270660,88.06,11.94
100,Framingham,2014,7241593787,989719737,8231313524,87.98,12.02
100,Framingham,2015,7609478571,990822150,8600300721,88.48,11.52
100,Framingham,2016,7945015743,989803500,8934819243,88.92,11.08
101,Franklin,2003,3359725043,383051200,3742776243,89.77,10.23
101,Franklin,2004,3471338018,258297200,3729635218,93.07,6.93
101,Franklin,2005,4384841417,285412400,4670253817,93.89,6.11
101,Franklin,2006,4715004021,296034300,5011038321,94.09,5.91
101,Franklin,2007,4991836869,312654200,5304491069,94.11,5.89
101,Franklin,2008,4751983617,292475100,5044458717,94.2,5.8
101,Franklin,2009,4524655832,357377400,4882033232,92.68,7.32
101,Franklin,2010,4354757148,350283700,4705040848,92.56,7.44
101,Franklin,2011,4192296244,374945400,4567241644,91.79,8.21
101,Franklin,2012,4108754893,372383400,4481138293,91.69,8.31
101,Franklin,2013,4078795875,367872000,4446667875,91.73,8.27
101,Franklin,2014,4256595007,374997200,4631592207,91.9,8.1
101,Franklin,2015,4433084163,381195000,4814279163,92.08,7.92
101,Franklin,2016,4666897901,386145200,5053043101,92.36,7.64
102,Freetown,2003,616828390,51240300,668068690,92.33,7.67
102,Freetown,2004,935911120,81641120,1017552240,91.98,8.02
102,Freetown,2005,1061095420,85558600,1146654020,92.54,7.46
102,Freetown,2006,1182366620,88230200,1270596820,93.06,6.94
102,Freetown,2007,1404758630,98212100,1502970730,93.47,6.53
102,Freetown,2008,1362045960,96304900,1458350860,93.4,6.6
102,Freetown,2009,1285818070,94327600,1380145670,93.17,6.83
102,Freetown,2010,1260402840,93930000,1354332840,93.06,6.94
102,Freetown,2011,1174458580,87318000,1261776580,93.08,6.92
102,Freetown,2012,1138270520,85015200,1223285720,93.05,6.95
102,Freetown,2013,1115773180,83233700,1199006880,93.06,6.94
102,Freetown,2014,1127065820,81327500,1208393320,93.27,6.73
102,Freetown,2015,1176489390,84002800,1260492190,93.34,6.66
102,Freetown,2016,1207543980,84103900,1291647880,93.49,6.51
103,Gardner,2003,753946326,181716400,935662726,80.58,19.42
103,Gardner,2004,767484204,181228100,948712304,80.9,19.1
103,Gardner,2005,1161056691,205528400,1366585091,84.96,15.04
103,Gardner,2006,1241424847,208495200,1449920047,85.62,14.38
103,Gardner,2007,1367293238,220369300,1587662538,86.12,13.88
103,Gardner,2008,1369562761,218144100,1587706861,86.26,13.74
103,Gardner,2009,1314109925,215135200,1529245125,85.93,14.07
103,Gardner,2010,1202156961,213690500,1415847461,84.91,15.09
103,Gardner,2011,1199552248,229833100,1429385348,83.92,16.08
103,Gardner,2012,1185079903,224140900,1409220803,84.09,15.91
103,Gardner,2013,1181385479,222820600,1404206079,84.13,15.87
103,Gardner,2014,1136149615,271453500,1407603115,80.72,19.28
103,Gardner,2015,1131686711,306260500,1437947211,78.7,21.3
103,Gardner,2016,1139021076,304147600,1443168676,78.93,21.07
104,Aquinnah,2003,412939183,30941500,443880683,93.03,6.97
104,Aquinnah,2004,411056199,38476300,449532499,91.44,8.56
104,Aquinnah,2005,555721126,52862900,608584026,91.31,8.69
104,Aquinnah,2006,561915016,52378200,614293216,91.47,8.53
104,Aquinnah,2007,565687496,53462100,619149596,91.37,8.63
104,Aquinnah,2008,732608899,84966700,817575599,89.61,10.39
104,Aquinnah,2009,717848401,84751000,802599401,89.44,10.56
104,Aquinnah,2010,709977649,85990600,795968249,89.2,10.8
104,Aquinnah,2011,716594632,85852900,802447532,89.3,10.7
104,Aquinnah,2012,717554731,72492800,790047531,90.82,9.18
104,Aquinnah,2013,723005048,72384200,795389248,90.9,9.1
104,Aquinnah,2014,732344872,77198400,809543272,90.46,9.54
104,Aquinnah,2015,702216122,75183600,777399722,90.33,9.67
104,Aquinnah,2016,699053296,80104700,779157996,89.72,10.28
105,Georgetown,2003,724026051,47886100,771912151,93.8,6.2
105,Georgetown,2004,985584866,73228400,1058813266,93.08,6.92
105,Georgetown,2005,1109606050,79079800,1188685850,93.35,6.65
105,Georgetown,2006,1212437847,79050300,1291488147,93.88,6.12
105,Georgetown,2007,1286613330,91086000,1377699330,93.39,6.61
105,Georgetown,2008,1308396403,93866600,1402263003,93.31,6.69
105,Georgetown,2009,1254652019,94591900,1349243919,92.99,7.01
105,Georgetown,2010,1229804525,84944400,1314748925,93.54,6.46
105,Georgetown,2011,1141434764,117351900,1258786664,90.68,9.32
105,Georgetown,2012,1141935424,97568100,1239503524,92.13,7.87
105,Georgetown,2013,1133292513,92942100,1226234613,92.42,7.58
105,Georgetown,2014,1128703635,92860000,1221563635,92.4,7.6
105,Georgetown,2015,1135603984,93578600,1229182584,92.39,7.61
105,Georgetown,2016,1177518482,94038000,1271556482,92.6,7.4
106,Gill,2003,83896321,50416600,134312921,62.46,37.54
106,Gill,2004,84750245,50374200,135124445,62.72,37.28
106,Gill,2005,112177575,56753300,168930875,66.4,33.6
106,Gill,2006,109620751,57738500,167359251,65.5,34.5
106,Gill,2007,119505709,59003200,178508909,66.95,33.05
106,Gill,2008,157280213,65642200,222922413,70.55,29.45
106,Gill,2009,146973132,65048300,212021432,69.32,30.68
106,Gill,2010,148862559,65045500,213908059,69.59,30.41
106,Gill,2011,152225205,65388900,217614105,69.95,30.05
106,Gill,2012,151905656,64900100,216805756,70.07,29.93
106,Gill,2013,149216042,64364900,213580942,69.86,30.14
106,Gill,2014,142105491,63876500,205981991,68.99,31.01
106,Gill,2015,143353073,65161200,208514273,68.75,31.25
106,Gill,2016,147336608,65367500,212704108,69.27,30.73
107,Gloucester,2003,3798079634,356249266,4154328900,91.42,8.58
107,Gloucester,2004,4511048769,386598325,4897647094,92.11,7.89
107,Gloucester,2005,5117741080,434918300,5552659380,92.17,7.83
107,Gloucester,2006,5567475330,440002700,6007478030,92.68,7.32
107,Gloucester,2007,5864518784,432679100,6297197884,93.13,6.87
107,Gloucester,2008,5766744290,400119900,6166864190,93.51,6.49
107,Gloucester,2009,5674893000,396083400,6070976400,93.48,6.52
107,Gloucester,2010,5381431000,388743200,5770174200,93.26,6.74
107,Gloucester,2011,5288079920,387674500,5675754420,93.17,6.83
107,Gloucester,2012,5135946590,408554700,5544501290,92.63,7.37
107,Gloucester,2013,5113775160,407296500,5521071660,92.62,7.38
107,Gloucester,2014,5164191030,433792400,5597983430,92.25,7.75
107,Gloucester,2015,5327860200,441123600,5768983800,92.35,7.65
107,Gloucester,2016,5536759220,450398600,5987157820,92.48,7.52
108,Goshen,2003,82048510,6367400,88415910,92.8,7.2
108,Goshen,2004,84316830,6476900,90793730,92.87,7.13
108,Goshen,2005,101064290,10290400,111354690,90.76,9.24
108,Goshen,2006,119425371,7402000,126827371,94.16,5.84
108,Goshen,2007,124361903,7779100,132141003,94.11,5.89
108,Goshen,2008,123878810,7788400,131667210,94.08,5.92
108,Goshen,2009,124922208,7391827,132314035,94.41,5.59
108,Goshen,2010,126752518,7564527,134317045,94.37,5.63
108,Goshen,2011,127802626,7490973,135293599,94.46,5.54
108,Goshen,2012,142362229,8284234,150646463,94.5,5.5
108,Goshen,2013,142147440,8364034,150511474,94.44,5.56
108,Goshen,2014,142926015,8392734,151318749,94.45,5.55
108,Goshen,2015,142483192,8542134,151025326,94.34,5.66
108,Goshen,2016,140225585,8766534,148992119,94.12,5.88
109,Gosnold,2003,132917214,9479400,142396614,93.34,6.66
109,Gosnold,2004,134272500,9502100,143774600,93.39,6.61
109,Gosnold,2005,147842289,10791300,158633589,93.2,6.8
109,Gosnold,2006,243393385,17992800,261386185,93.12,6.88
109,Gosnold,2007,243393385,17992800,261386185,93.12,6.88
109,Gosnold,2008,277918422,18084700,296003122,93.89,6.11
109,Gosnold,2009,280707155,18074000,298781155,93.95,6.05
109,Gosnold,2010,282644455,18074000,300718455,93.99,6.01
109,Gosnold,2011,273659351,20429680,294089031,93.05,6.95
109,Gosnold,2012,273655251,20429680,294084931,93.05,6.95
109,Gosnold,2013,273655151,20429680,294084831,93.05,6.95
109,Gosnold,2014,231443913,17731680,249175593,92.88,7.12
109,Gosnold,2015,232320262,17731680,250051942,92.91,7.09
109,Gosnold,2016,232333901,17731680,250065581,92.91,7.09
110,Grafton,2003,1068373415,146553900,1214927315,87.94,12.06
110,Grafton,2004,1657273070,136415100,1793688170,92.39,7.61
110,Grafton,2005,1862608758,139041100,2001649858,93.05,6.95
110,Grafton,2006,2038937590,193527500,2232465090,91.33,8.67
110,Grafton,2007,2370887333,170100300,2540987633,93.31,6.69
110,Grafton,2008,2354198879,171618400,2525817279,93.21,6.79
110,Grafton,2009,2315463331,192202100,2507665431,92.34,7.66
110,Grafton,2010,2154670006,200156850,2354826856,91.5,8.5
110,Grafton,2011,2073073341,195920700,2268994041,91.37,8.63
110,Grafton,2012,2124833737,206016900,2330850637,91.16,8.84
110,Grafton,2013,2060770425,199774600,2260545025,91.16,8.84
110,Grafton,2014,2139715998,253710100,2393426098,89.4,10.6
110,Grafton,2015,2151037275,246432140,2397469415,89.72,10.28
110,Grafton,2016,2192504829,244107020,2436611849,89.98,10.02
111,Granby,2003,372703100,24003200,396706300,93.95,6.05
111,Granby,2004,381062500,19169400,400231900,95.21,4.79
111,Granby,2005,479292300,21025200,500317500,95.8,4.2
111,Granby,2006,554742200,23504500,578246700,95.94,4.06
111,Granby,2007,611223700,29154700,640378400,95.45,4.55
111,Granby,2008,617290900,29873300,647164200,95.38,4.62
111,Granby,2009,601969843,30551900,632521743,95.17,4.83
111,Granby,2010,580888581,29457600,610346181,95.17,4.83
111,Granby,2011,583793467,32929000,616722467,94.66,5.34
111,Granby,2012,572729524,33987000,606716524,94.4,5.6
111,Granby,2013,575710782,34583100,610293882,94.33,5.67
111,Granby,2014,579281219,34737800,614019019,94.34,5.66
111,Granby,2015,568755914,35525300,604281214,94.12,5.88
111,Granby,2016,572170573,35825600,607996173,94.11,5.89
112,Granville,2003,107353149,30692700,138045849,77.77,22.23
112,Granville,2004,135833485,34940900,170774385,79.54,20.46
112,Granville,2005,140428440,36351000,176779440,79.44,20.56
112,Granville,2006,166735167,43707400,210442567,79.23,20.77
112,Granville,2007,171205180,46508900,217714080,78.64,21.36
112,Granville,2008,192945435,47958200,240903635,80.09,19.91
112,Granville,2009,193462985,47826400,241289385,80.18,19.82
112,Granville,2010,207329457,54156400,261485857,79.29,20.71
112,Granville,2011,202314560,54295400,256609960,78.84,21.16
112,Granville,2012,204884237,59140200,264024437,77.6,22.4
112,Granville,2013,193589900,59978500,253568400,76.35,23.65
112,Granville,2014,192800680,60403800,253204480,76.14,23.86
112,Granville,2015,191058970,58795900,249854870,76.47,23.53
112,Granville,2016,191680730,60641300,252322030,75.97,24.03
113,Great Barrington,2003,693093522,97240750,790334272,87.7,12.3
113,Great Barrington,2004,805151570,113985000,919136570,87.6,12.4
113,Great Barrington,2005,871438862,135897500,1007336362,86.51,13.49
113,Great Barrington,2006,1032428583,154519500,1186948083,86.98,13.02
113,Great Barrington,2007,1246355681,242362000,1488717681,83.72,16.28
113,Great Barrington,2008,1351145810,239529700,1590675510,84.94,15.06
113,Great Barrington,2009,1427357423,243807700,1671165123,85.41,14.59
113,Great Barrington,2010,1451065595,249524600,1700590195,85.33,14.67
113,Great Barrington,2011,1392020846,254537900,1646558746,84.54,15.46
113,Great Barrington,2012,1351621807,254645000,1606266807,84.15,15.85
113,Great Barrington,2013,1360883527,254077794,1614961321,84.27,15.73
113,Great Barrington,2014,1322379245,258382160,1580761405,83.65,16.35
113,Great Barrington,2015,1370499134,260649560,1631148694,84.02,15.98
113,Great Barrington,2016,1386204580,262693160,1648897740,84.07,15.93
114,Greenfield,2003,906827926,137982248,1044810174,86.79,13.21
114,Greenfield,2004,953715609,138943741,1092659350,87.28,12.72
114,Greenfield,2005,1090618575,151040875,1241659450,87.84,12.16
114,Greenfield,2006,1186054190,164721181,1350775371,87.81,12.19
114,Greenfield,2007,1315392432,169853366,1485245798,88.56,11.44
114,Greenfield,2008,1385279593,178866286,1564145879,88.56,11.44
114,Greenfield,2009,1373540953,178232496,1551773449,88.51,11.49
114,Greenfield,2010,1372362883,179943796,1552306679,88.41,11.59
114,Greenfield,2011,1347317108,167434115,1514751223,88.95,11.05
114,Greenfield,2012,1348239176,241012648,1589251824,84.83,15.17
114,Greenfield,2013,1303677248,203803548,1507480796,86.48,13.52
114,Greenfield,2014,1311232857,203156696,1514389553,86.58,13.42
114,Greenfield,2015,1320117556,202728428,1522845984,86.69,13.31
114,Greenfield,2016,1363519928,212113332,1575633260,86.54,13.46
115,Groton,2003,1228795651,183873652,1412669303,86.98,13.02
115,Groton,2004,1265562033,187220952,1452782985,87.11,12.89
115,Groton,2005,1498751638,233686476,1732438114,86.51,13.49
115,Groton,2006,1516285621,238432076,1754717697,86.41,13.59
115,Groton,2007,1612088490,247636320,1859724810,86.68,13.32
115,Groton,2008,1663164325,294932510,1958096835,84.94,15.06
115,Groton,2009,1633572178,294853800,1928425978,84.71,15.29
115,Groton,2010,1534542445,287005050,1821547495,84.24,15.76
115,Groton,2011,1505472325,278075264,1783547589,84.41,15.59
115,Groton,2012,1520537750,280263566,1800801316,84.44,15.56
115,Groton,2013,1509801698,280671061,1790472759,84.32,15.68
115,Groton,2014,1513806755,325914372,1839721127,82.28,17.72
115,Groton,2015,1531004928,328689072,1859694000,82.33,17.67
115,Groton,2016,1547028448,392379072,1939407520,79.77,20.23
116,Groveland,2003,599788056,41913200,641701256,93.47,6.53
116,Groveland,2004,721791696,57453400,779245096,92.63,7.37
116,Groveland,2005,843402730,63403500,906806230,93.01,6.99
116,Groveland,2006,893243699,66749100,959992799,93.05,6.95
116,Groveland,2007,933906914,68878700,1002785614,93.13,6.87
116,Groveland,2008,948863414,69833200,1018696614,93.14,6.86
116,Groveland,2009,885159264,68007900,953167164,92.87,7.13
116,Groveland,2010,857641626,58763200,916404826,93.59,6.41
116,Groveland,2011,838766496,58146300,896912796,93.52,6.48
116,Groveland,2012,832826490,57786400,890612890,93.51,6.49
116,Groveland,2013,795780458,57388100,853168558,93.27,6.73
116,Groveland,2014,786702911,64775900,851478811,92.39,7.61
116,Groveland,2015,839970497,71368500,911338997,92.17,7.83
116,Groveland,2016,867329081,79862400,947191481,91.57,8.43
117,Hadley,2003,502904029,77786700,580690729,86.6,13.4
117,Hadley,2004,512116915,79560700,591677615,86.55,13.45
117,Hadley,2005,709627834,86858400,796486234,89.09,10.91
117,Hadley,2006,789888007,91014100,880902107,89.67,10.33
117,Hadley,2007,830040925,92648100,922689025,89.96,10.04
117,Hadley,2008,901983635,102090100,1004073735,89.83,10.17
117,Hadley,2009,919204410,124404600,1043609010,88.08,11.92
117,Hadley,2010,924919288,149247600,1074166888,86.11,13.89
117,Hadley,2011,910565590,149154900,1059720490,85.93,14.07
117,Hadley,2012,909728621,151392800,1061121421,85.73,14.27
117,Hadley,2013,909423357,151970000,1061393357,85.68,14.32
117,Hadley,2014,913412272,152041300,1065453572,85.73,14.27
117,Hadley,2015,927906174,156756400,1084662574,85.55,14.45
117,Hadley,2016,935709078,190032100,1125741178,83.12,16.88
118,Halifax,2003,582728100,29582800,612310900,95.17,4.83
118,Halifax,2004,687216400,37550800,724767200,94.82,5.18
118,Halifax,2005,793592800,42793800,836386600,94.88,5.12
118,Halifax,2006,867446500,44682900,912129400,95.1,4.9
118,Halifax,2007,964888200,48965100,1013853300,95.17,4.83
118,Halifax,2008,918245700,49135300,967381000,94.92,5.08
118,Halifax,2009,910431300,48715700,959147000,94.92,5.08
118,Halifax,2010,892766000,47502400,940268400,94.95,5.05
118,Halifax,2011,798917480,41636100,840553580,95.05,4.95
118,Halifax,2012,784704940,41103100,825808040,95.02,4.98
118,Halifax,2013,752409260,38658500,791067760,95.11,4.89
118,Halifax,2014,745050310,37296800,782347110,95.23,4.77
118,Halifax,2015,762652740,36885100,799537840,95.39,4.61
118,Halifax,2016,775981560,36292300,812273860,95.53,4.47
119,Hamilton,2003,1091010070,128113200,1219123270,89.49,10.51
119,Hamilton,2004,1211722290,138928800,1350651090,89.71,10.29
119,Hamilton,2005,1323911420,152382900,1476294320,89.68,10.32
119,Hamilton,2006,1477930760,178627100,1656557860,89.22,10.78
119,Hamilton,2007,1489346703,180162300,1669509003,89.21,10.79
119,Hamilton,2008,1479271880,178388100,1657659980,89.24,10.76
119,Hamilton,2009,1437246401,193483600,1630730001,88.14,11.86
119,Hamilton,2010,1377977858,196273100,1574250958,87.53,12.47
119,Hamilton,2011,1332748254,193705100,1526453354,87.31,12.69
119,Hamilton,2012,1291799178,203989000,1495788178,86.36,13.64
119,Hamilton,2013,1291952004,204156800,1496108804,86.35,13.65
119,Hamilton,2014,1303712292,209984500,1513696792,86.13,13.87
119,Hamilton,2015,1365496653,216525700,1582022353,86.31,13.69
119,Hamilton,2016,1434911406,217886500,1652797906,86.82,13.18
120,Hampden,2003,377604584,18281700,395886284,95.38,4.62
120,Hampden,2004,382207323,18589400,400796723,95.36,4.64
120,Hampden,2005,450897907,19599000,470496907,95.83,4.17
120,Hampden,2006,519104505,22379200,541483705,95.87,4.13
120,Hampden,2007,524996826,23979100,548975926,95.63,4.37
120,Hampden,2008,598637140,27358400,625995540,95.63,4.37
120,Hampden,2009,577494000,26727700,604221700,95.58,4.42
120,Hampden,2010,562040110,26749700,588789810,95.46,4.54
120,Hampden,2011,562799620,27125500,589925120,95.4,4.6
120,Hampden,2012,552022720,27484400,579507120,95.26,4.74
120,Hampden,2013,544704608,27665100,572369708,95.17,4.83
120,Hampden,2014,545146154,27291700,572437854,95.23,4.77
120,Hampden,2015,548903070,34196000,583099070,94.14,5.86
120,Hampden,2016,569448260,34201900,603650160,94.33,5.67
121,Hancock,2003,107875000,4888500,112763500,95.66,4.34
121,Hancock,2004,196245327,18270710,214516037,91.48,8.52
121,Hancock,2005,224006718,21546350,245553068,91.23,8.77
121,Hancock,2006,249996525,21529090,271525615,92.07,7.93
121,Hancock,2007,312243695,8633060,320876755,97.31,2.69
121,Hancock,2008,315104293,9423160,324527453,97.1,2.9
121,Hancock,2009,319097219,9349240,328446459,97.15,2.85
121,Hancock,2010,326935449,10958870,337894319,96.76,3.24
121,Hancock,2011,326715373,11347700,338063073,96.64,3.36
121,Hancock,2012,300069657,11234600,311304257,96.39,3.61
121,Hancock,2013,295441693,8875800,304317493,97.08,2.92
121,Hancock,2014,293001749,8881500,301883249,97.06,2.94
121,Hancock,2015,294036078,8819800,302855878,97.09,2.91
121,Hancock,2016,298369678,9156700,307526378,97.02,2.98
122,Hanover,2003,1610731690,97935000,1708666690,94.27,5.73
122,Hanover,2004,1719197886,100227400,1819425286,94.49,5.51
122,Hanover,2005,2221985640,162298900,2384284540,93.19,6.81
122,Hanover,2006,2347356530,169841900,2517198430,93.25,6.75
122,Hanover,2007,2513557095,187285400,2700842495,93.07,6.93
122,Hanover,2008,2621704145,197038100,2818742245,93.01,6.99
122,Hanover,2009,2461624835,205000100,2666624935,92.31,7.69
122,Hanover,2010,2369061032,203567000,2572628032,92.09,7.91
122,Hanover,2011,2268327020,217384100,2485711120,91.25,8.75
122,Hanover,2012,2253595960,212227900,2465823860,91.39,8.61
122,Hanover,2013,2290567480,199383700,2489951180,91.99,8.01
122,Hanover,2014,2255444320,200145600,2455589920,91.85,8.15
122,Hanover,2015,2369713460,204170900,2573884360,92.07,7.93
122,Hanover,2016,2436970000,204349200,2641319200,92.26,7.74
123,Hanson,2003,834516100,55750900,890267000,93.74,6.26
123,Hanson,2004,1100080800,81727000,1181807800,93.08,6.92
123,Hanson,2005,1111741300,81973400,1193714700,93.13,6.87
123,Hanson,2006,1214969620,120955800,1335925420,90.95,9.05
123,Hanson,2007,1352108290,120883600,1472991890,91.79,8.21
123,Hanson,2008,1316717910,123124900,1439842810,91.45,8.55
123,Hanson,2009,1283744810,121541000,1405285810,91.35,8.65
123,Hanson,2010,1207853770,160768400,1368622170,88.25,11.75
123,Hanson,2011,1213993710,160320700,1374314410,88.33,11.67
123,Hanson,2012,1171521830,159841400,1331363230,87.99,12.01
123,Hanson,2013,1158070110,160504300,1318574410,87.83,12.17
123,Hanson,2014,1085216540,159989200,1245205740,87.15,12.85
123,Hanson,2015,1104989890,161924600,1266914490,87.22,12.78
123,Hanson,2016,1140843150,163248100,1304091250,87.48,12.52
124,Hardwick,2003,144370483,24163000,168533483,85.66,14.34
124,Hardwick,2004,146501587,24062000,170563587,85.89,14.11
124,Hardwick,2005,168945967,30351500,199297467,84.77,15.23
124,Hardwick,2006,236915900,44120900,281036800,84.3,15.7
124,Hardwick,2007,263380887,46455553,309836440,85.01,14.99
124,Hardwick,2008,275570644,47383795,322954439,85.33,14.67
124,Hardwick,2009,280934971,61676840,342611811,82,18
124,Hardwick,2010,259826470,62461407,322287877,80.62,19.38
124,Hardwick,2011,238146895,64994223,303141118,78.56,21.44
124,Hardwick,2012,234365290,67018905,301384195,77.76,22.24
124,Hardwick,2013,233182583,66910685,300093268,77.7,22.3
124,Hardwick,2014,213299832,67511232,280811064,75.96,24.04
124,Hardwick,2015,218327405,84245532,302572937,72.16,27.84
124,Hardwick,2016,226213700,90297279,316510979,71.47,28.53
125,Harvard,2003,883351200,473091600,1356442800,65.12,34.88
125,Harvard,2004,952031390,113413000,1065444390,89.36,10.64
125,Harvard,2005,1182427000,129937700,1312364700,90.1,9.9
125,Harvard,2006,1187770232,131972700,1319742932,90,10
125,Harvard,2007,1184542305,132314600,1316856905,89.95,10.05
125,Harvard,2008,1192556890,152045100,1344601990,88.69,11.31
125,Harvard,2009,1182225622,152092500,1334318122,88.6,11.4
125,Harvard,2010,1138995512,149785500,1288781012,88.38,11.62
125,Harvard,2011,1082829559,218835000,1301664559,83.19,16.81
125,Harvard,2012,1053042141,186397325,1239439466,84.96,15.04
125,Harvard,2013,1056647413,187144425,1243791838,84.95,15.05
125,Harvard,2014,1060081431,188029725,1248111156,84.93,15.07
125,Harvard,2015,1063093393,190911600,1254004993,84.78,15.22
125,Harvard,2016,1081403326,195590000,1276993326,84.68,15.32
126,Harwich,2003,3333770290,207806800,3541577090,94.13,5.87
126,Harwich,2004,4211374400,268801400,4480175800,94,6
126,Harwich,2005,4574368508,287534600,4861903108,94.09,5.91
126,Harwich,2006,5030349220,335201200,5365550420,93.75,6.25
126,Harwich,2007,5409032750,357615800,5766648550,93.8,6.2
126,Harwich,2008,5227242430,337185400,5564427830,93.94,6.06
126,Harwich,2009,5239317220,322053000,5561370220,94.21,5.79
126,Harwich,2010,4944911740,280676200,5225587940,94.63,5.37
126,Harwich,2011,4651829510,262305400,4914134910,94.66,5.34
126,Harwich,2012,4598355200,277264300,4875619500,94.31,5.69
126,Harwich,2013,4479844570,257748400,4737592970,94.56,5.44
126,Harwich,2014,4534923340,253536600,4788459940,94.71,5.29
126,Harwich,2015,4700113950,310655600,5010769550,93.8,6.2
126,Harwich,2016,4814009800,325809800,5139819600,93.66,6.34
127,Hatfield,2003,297692598,24692600,322385198,92.34,7.66
127,Hatfield,2004,362675783,30048400,392724183,92.35,7.65
127,Hatfield,2005,379883508,28554400,408437908,93.01,6.99
127,Hatfield,2006,396194304,28622500,424816804,93.26,6.74
127,Hatfield,2007,469503668,33994300,503497968,93.25,6.75
127,Hatfield,2008,478914284,33532000,512446284,93.46,6.54
127,Hatfield,2009,484266100,33781100,518047200,93.48,6.52
127,Hatfield,2010,478512013,33541700,512053713,93.45,6.55
127,Hatfield,2011,505068040,30215500,535283540,94.36,5.64
127,Hatfield,2012,515013780,30149600,545163380,94.47,5.53
127,Hatfield,2013,499933110,37427900,537361010,93.03,6.97
127,Hatfield,2014,495958860,37247600,533206460,93.01,6.99
127,Hatfield,2015,503422383,38413800,541836183,92.91,7.09
127,Hatfield,2016,523957693,40008300,563965993,92.91,7.09
128,Haverhill,2003,3803118150,384942100,4188060250,90.81,9.19
128,Haverhill,2004,4119791101,393595328,4513386429,91.28,8.72
128,Haverhill,2005,5280371699,438433742,5718805441,92.33,7.67
128,Haverhill,2006,5624066541,445112737,6069179278,92.67,7.33
128,Haverhill,2007,6026841852,455374464,6482216316,92.98,7.02
128,Haverhill,2008,6280798839,471974799,6752773638,93.01,6.99
128,Haverhill,2009,5957411257,463457493,6420868750,92.78,7.22
128,Haverhill,2010,5498523994,448474156,5946998150,92.46,7.54
128,Haverhill,2011,5216493197,437786295,5654279492,92.26,7.74
128,Haverhill,2012,5088002158,440118157,5528120315,92.04,7.96
128,Haverhill,2013,4913700356,430535464,5344235820,91.94,8.06
128,Haverhill,2014,4941156378,434291904,5375448282,91.92,8.08
128,Haverhill,2015,5303663181,432408477,5736071658,92.46,7.54
128,Haverhill,2016,5432039234,434900966,5866940200,92.59,7.41
129,Hawley,2003,23717266,4462900,28180166,84.16,15.84
129,Hawley,2004,24047900,4449900,28497800,84.39,15.61
129,Hawley,2005,24758460,4449700,29208160,84.77,15.23
129,Hawley,2006,30957448,4015200,34972648,88.52,11.48
129,Hawley,2007,30932477,4049100,34981577,88.43,11.57
129,Hawley,2008,39039169,4927500,43966669,88.79,11.21
129,Hawley,2009,47104273,5089800,52194073,90.25,9.75
129,Hawley,2010,47090641,5107100,52197741,90.22,9.78
129,Hawley,2011,47531462,5472600,53004062,89.68,10.32
129,Hawley,2012,46531286,7400600,53931886,86.28,13.72
129,Hawley,2013,47304361,7397700,54702061,86.48,13.52
129,Hawley,2014,47745270,7407000,55152270,86.57,13.43
129,Hawley,2015,51110659,6648800,57759459,88.49,11.51
129,Hawley,2016,51329324,6648800,57978124,88.53,11.47
130,Heath,2003,53134201,5478500,58612701,90.65,9.35
130,Heath,2004,53534697,5454100,58988797,90.75,9.25
130,Heath,2005,70859150,6345800,77204950,91.78,8.22
130,Heath,2006,79363601,6321100,85684701,92.62,7.38
130,Heath,2007,80956480,6348100,87304580,92.73,7.27
130,Heath,2008,92980484,6862900,99843384,93.13,6.87
130,Heath,2009,94741029,6862900,101603929,93.25,6.75
130,Heath,2010,94223444,6862900,101086344,93.21,6.79
130,Heath,2011,88453764,7037400,95491164,92.63,7.37
130,Heath,2012,87644392,7031900,94676292,92.57,7.43
130,Heath,2013,88758780,6649700,95408480,93.03,6.97
130,Heath,2014,90562957,6627100,97190057,93.18,6.82
130,Heath,2015,88815202,6742200,95557402,92.94,7.06
130,Heath,2016,90518950,6770200,97289150,93.04,6.96
131,Hingham,2003,3416302980,314993100,3731296080,91.56,8.44
131,Hingham,2004,3897620840,315970600,4213591440,92.5,7.5
131,Hingham,2005,4436551270,315475400,4752026670,93.36,6.64
131,Hingham,2006,5192463730,328824300,5521288030,94.04,5.96
131,Hingham,2007,5572597140,333520000,5906117140,94.35,5.65
131,Hingham,2008,5725353220,384268700,6109621920,93.71,6.29
131,Hingham,2009,5653800660,392792200,6046592860,93.5,6.5
131,Hingham,2010,5636105233,405694100,6041799333,93.29,6.71
131,Hingham,2011,5599519350,405665200,6005184550,93.24,6.76
131,Hingham,2012,5438188940,358700200,5796889140,93.81,6.19
131,Hingham,2013,5439457670,368419500,5807877170,93.66,6.34
131,Hingham,2014,5548991980,369281800,5918273780,93.76,6.24
131,Hingham,2015,5919438780,385921100,6305359880,93.88,6.12
131,Hingham,2016,6175354200,408537000,6583891200,93.79,6.21
132,Hinsdale,2003,136932722,28437500,165370222,82.8,17.2
132,Hinsdale,2004,152790057,28494500,181284557,84.28,15.72
132,Hinsdale,2005,167496825,29271100,196767925,85.12,14.88
132,Hinsdale,2006,220965016,31754600,252719616,87.43,12.57
132,Hinsdale,2007,236605134,32303900,268909034,87.99,12.01
132,Hinsdale,2008,253056763,33349400,286406163,88.36,11.64
132,Hinsdale,2009,269714626,38170700,307885326,87.6,12.4
132,Hinsdale,2010,276071052,38890200,314961252,87.65,12.35
132,Hinsdale,2011,278924224,41639700,320563924,87.01,12.99
132,Hinsdale,2012,272725589,41941800,314667389,86.67,13.33
132,Hinsdale,2013,294883629,31795400,326679029,90.27,9.73
132,Hinsdale,2014,293033181,31744700,324777881,90.23,9.77
132,Hinsdale,2015,300892188,31810800,332702988,90.44,9.56
132,Hinsdale,2016,295023940,31623400,326647340,90.32,9.68
133,Holbrook,2003,837347900,43265200,880613100,95.09,4.91
133,Holbrook,2004,999916065,45718200,1045634265,95.63,4.37
133,Holbrook,2005,1122389962,46168900,1168558862,96.05,3.95
133,Holbrook,2006,1242476361,54852100,1297328461,95.77,4.23
133,Holbrook,2007,1310191393,57653100,1367844493,95.79,4.21
133,Holbrook,2008,1261874616,55291300,1317165916,95.8,4.2
133,Holbrook,2009,1191750769,50274700,1242025469,95.95,4.05
133,Holbrook,2010,1095476045,61363500,1156839545,94.7,5.3
133,Holbrook,2011,1030949771,57277900,1088227671,94.74,5.26
133,Holbrook,2012,1007043445,55813700,1062857145,94.75,5.25
133,Holbrook,2013,1011879353,55562800,1067442153,94.79,5.21
133,Holbrook,2014,1012314088,55561600,1067875688,94.8,5.2
133,Holbrook,2015,1039388291,55612800,1095001091,94.92,5.08
133,Holbrook,2016,1087078754,57430500,1144509254,94.98,5.02
134,Holden,2003,1215315100,142044300,1357359400,89.54,10.46
134,Holden,2004,1489703400,156639400,1646342800,90.49,9.51
134,Holden,2005,1753391700,171241400,1924633100,91.1,8.9
134,Holden,2006,1930851700,235017600,2165869300,89.15,10.85
134,Holden,2007,2042613200,228936900,2271550100,89.92,10.08
134,Holden,2008,2019843400,228761800,2248605200,89.83,10.17
134,Holden,2009,1985104400,225171700,2210276100,89.81,10.19
134,Holden,2010,1883982600,207295100,2091277700,90.09,9.91
134,Holden,2011,1859330400,208954100,2068284500,89.9,10.1
134,Holden,2012,1838082600,208196200,2046278800,89.83,10.17
134,Holden,2013,1810899100,207125000,2018024100,89.74,10.26
134,Holden,2014,1856042600,222266900,2078309500,89.31,10.69
134,Holden,2015,1883118500,219119500,2102238000,89.58,10.42
134,Holden,2016,1976440200,221475700,2197915900,89.92,10.08
135,Holland,2003,171434700,9172900,180607600,94.92,5.08
135,Holland,2004,245751200,12965400,258716600,94.99,5.01
135,Holland,2005,273072136,14444410,287516546,94.98,5.02
135,Holland,2006,299246000,15030700,314276700,95.22,4.78
135,Holland,2007,379956793,18834300,398791093,95.28,4.72
135,Holland,2008,366764921,19554400,386319321,94.94,5.06
135,Holland,2009,360267225,19865300,380132525,94.77,5.23
135,Holland,2010,333725090,15615300,349340390,95.53,4.47
135,Holland,2011,307665665,14545300,322210965,95.49,4.51
135,Holland,2012,302014407,14004200,316018607,95.57,4.43
135,Holland,2013,301898726,13507800,315406526,95.72,4.28
135,Holland,2014,303512171,13795400,317307571,95.65,4.35
135,Holland,2015,304078400,13840700,317919100,95.65,4.35
135,Holland,2016,314119684,13359200,327478884,95.92,4.08
136,Holliston,2003,1484259559,159642900,1643902459,90.29,9.71
136,Holliston,2004,1732784445,223255100,1956039545,88.59,11.41
136,Holliston,2005,1832144215,271499000,2103643215,87.09,12.91
136,Holliston,2006,1971271653,271523300,2242794953,87.89,12.11
136,Holliston,2007,2199008748,282132800,2481141548,88.63,11.37
136,Holliston,2008,2120370599,282734900,2403105499,88.23,11.77
136,Holliston,2009,2070821863,252178300,2323000163,89.14,10.86
136,Holliston,2010,2061165463,132595700,2193761163,93.96,6.04
136,Holliston,2011,1983870700,132138900,2116009600,93.76,6.24
136,Holliston,2012,1998259000,139464500,2137723500,93.48,6.52
136,Holliston,2013,2033229010,98478500,2131707510,95.38,4.62
136,Holliston,2014,1970885610,85649000,2056534610,95.84,4.16
136,Holliston,2015,2093782535,88565600,2182348135,95.94,4.06
136,Holliston,2016,2275395000,99640500,2375035500,95.8,4.2
137,Holyoke,2003,1389458858,265399122,1654857980,83.96,16.04
137,Holyoke,2004,1644073785,277448784,1921522569,85.56,14.44
137,Holyoke,2005,1844966801,320262159,2165228960,85.21,14.79
137,Holyoke,2006,2011042345,325398099,2336440444,86.07,13.93
137,Holyoke,2007,2178920162,361525970,2540446132,85.77,14.23
137,Holyoke,2008,2198367100,376559344,2574926444,85.38,14.62
137,Holyoke,2009,2197306051,378872578,2576178629,85.29,14.71
137,Holyoke,2010,2166901252,425147547,2592048799,83.6,16.4
137,Holyoke,2011,2166903308,427929087,2594832395,83.51,16.49
137,Holyoke,2012,2136618640,483733011,2620351651,81.54,18.46
137,Holyoke,2013,2091388565,466217787,2557606352,81.77,18.23
137,Holyoke,2014,2053136422,477734670,2530871092,81.12,18.88
137,Holyoke,2015,2049447723,479837043,2529284766,81.03,18.97
137,Holyoke,2016,2056918444,473779869,2530698313,81.28,18.72
138,Hopedale,2003,536145525,33274400,569419925,94.16,5.84
138,Hopedale,2004,581102275,56802600,637904875,91.1,8.9
138,Hopedale,2005,644451273,58604900,703056173,91.66,8.34
138,Hopedale,2006,741396746,65522400,806919146,91.88,8.12
138,Hopedale,2007,768133131,68624200,836757331,91.8,8.2
138,Hopedale,2008,761474621,73435500,834910121,91.2,8.8
138,Hopedale,2009,745953172,68392500,814345672,91.6,8.4
138,Hopedale,2010,707054706,67817200,774871906,91.25,8.75
138,Hopedale,2011,657922253,65983800,723906053,90.89,9.11
138,Hopedale,2012,655709145,69030400,724739545,90.48,9.52
138,Hopedale,2013,641973698,70035800,712009498,90.16,9.84
138,Hopedale,2014,644990239,70035800,715026039,90.21,9.79
138,Hopedale,2015,648656057,70236900,718892957,90.23,9.77
138,Hopedale,2016,674669556,73205200,747874756,90.21,9.79
139,Hopkinton,2003,2087183631,125126818,2212310449,94.34,5.66
139,Hopkinton,2004,2443033059,152931718,2595964777,94.11,5.89
139,Hopkinton,2005,2678031256,183540440,2861571696,93.59,6.41
139,Hopkinton,2006,2862625286,193052410,3055677696,93.68,6.32
139,Hopkinton,2007,3080646448,218817430,3299463878,93.37,6.63
139,Hopkinton,2008,2943102188,212883515,3155985703,93.25,6.75
139,Hopkinton,2009,2888123685,214243415,3102367100,93.09,6.91
139,Hopkinton,2010,2814895029,204129785,3019024814,93.24,6.76
139,Hopkinton,2011,2726881399,183727285,2910608684,93.69,6.31
139,Hopkinton,2012,2758589837,167949105,2926538942,94.26,5.74
139,Hopkinton,2013,2809910656,169828965,2979739621,94.3,5.7
139,Hopkinton,2014,2886500690,171251420,3057752110,94.4,5.6
139,Hopkinton,2015,3002298330,172934020,3175232350,94.55,5.45
139,Hopkinton,2016,3249773804,183205115,3432978919,94.66,5.34
140,Hubbardston,2003,236743439,29606700,266350139,88.88,11.12
140,Hubbardston,2004,347185196,40579300,387764496,89.54,10.46
140,Hubbardston,2005,392189687,47645700,439835387,89.17,10.83
140,Hubbardston,2006,419989682,47657200,467646882,89.81,10.19
140,Hubbardston,2007,488635274,48085500,536720774,91.04,8.96
140,Hubbardston,2008,516100764,45466500,561567264,91.9,8.1
140,Hubbardston,2009,533370963,46487300,579858263,91.98,8.02
140,Hubbardston,2010,491506693,41545400,533052093,92.21,7.79
140,Hubbardston,2011,451873299,43757300,495630599,91.17,8.83
140,Hubbardston,2012,434075137,42458000,476533137,91.09,8.91
140,Hubbardston,2013,417479396,48366600,465845996,89.62,10.38
140,Hubbardston,2014,404105896,55162300,459268196,87.99,12.01
140,Hubbardston,2015,410425114,78152500,488577614,84,16
140,Hubbardston,2016,395563065,55381025,450944090,87.72,12.28
141,Hudson,2003,1717739100,109181400,1826920500,94.02,5.98
141,Hudson,2004,2038663100,151798800,2190461900,93.07,6.93
141,Hudson,2005,2141648000,153865200,2295513200,93.3,6.7
141,Hudson,2006,2384063200,154286700,2538349900,93.92,6.08
141,Hudson,2007,2646463700,183708100,2830171800,93.51,6.49
141,Hudson,2008,2578973500,185465800,2764439300,93.29,6.71
141,Hudson,2009,2520546000,184614100,2705160100,93.18,6.82
141,Hudson,2010,2330973000,173760200,2504733200,93.06,6.94
141,Hudson,2011,2235265000,170377800,2405642800,92.92,7.08
141,Hudson,2012,2149381200,163615600,2312996800,92.93,7.07
141,Hudson,2013,2117833200,160816000,2278649200,92.94,7.06
141,Hudson,2014,2075559100,158629100,2234188200,92.9,7.1
141,Hudson,2015,2165852000,184078500,2349930500,92.17,7.83
141,Hudson,2016,2287457300,194098600,2481555900,92.18,7.82
142,Hull,2003,1526953500,181402000,1708355500,89.38,10.62
142,Hull,2004,1740625378,146824844,1887450222,92.22,7.78
142,Hull,2005,1832481336,195920844,2028402180,90.34,9.66
142,Hull,2006,2075817316,243788144,2319605460,89.49,10.51
142,Hull,2007,2103463380,243269000,2346732380,89.63,10.37
142,Hull,2008,2138906870,231979000,2370885870,90.22,9.78
142,Hull,2009,2070302420,245254800,2315557220,89.41,10.59
142,Hull,2010,1950842140,206762400,2157604540,90.42,9.58
142,Hull,2011,1872928080,199819200,2072747280,90.36,9.64
142,Hull,2012,1825865410,197537800,2023403210,90.24,9.76
142,Hull,2013,1821960900,194422600,2016383500,90.36,9.64
142,Hull,2014,1821632790,194794400,2016427190,90.34,9.66
142,Hull,2015,1863793740,198082100,2061875840,90.39,9.61
142,Hull,2016,1983413510,205739600,2189153110,90.6,9.4
143,Huntington,2003,106557927,93012500,199570427,53.39,46.61
143,Huntington,2004,134281626,98062005,232343631,57.79,42.21
143,Huntington,2005,140622489,101976845,242599334,57.96,42.04
143,Huntington,2006,171799432,128999700,300799132,57.11,42.89
143,Huntington,2007,195041883,142637200,337679083,57.76,42.24
143,Huntington,2008,196676470,142514300,339190770,57.98,42.02
143,Huntington,2009,198964784,141368700,340333484,58.46,41.54
143,Huntington,2010,198595072,127974400,326569472,60.81,39.19
143,Huntington,2011,200255900,127267500,327523400,61.14,38.86
143,Huntington,2012,200929155,127401100,328330255,61.2,38.8
143,Huntington,2013,190062338,126058200,316120538,60.12,39.88
143,Huntington,2014,190348098,126074300,316422398,60.16,39.84
143,Huntington,2015,190749313,125883400,316632713,60.24,39.76
143,Huntington,2016,189746785,125991200,315737985,60.1,39.9
144,Ipswich,2003,1690325594,159315200,1849640794,91.39,8.61
144,Ipswich,2004,2110469355,239464500,2349933855,89.81,10.19
144,Ipswich,2005,2252254870,225059600,2477314470,90.92,9.08
144,Ipswich,2006,2466692773,222750300,2689443073,91.72,8.28
144,Ipswich,2007,2823627988,277081181,3100709169,91.06,8.94
144,Ipswich,2008,2694169183,563584734,3257753917,82.7,17.3
144,Ipswich,2009,2642734143,497643822,3140377965,84.15,15.85
144,Ipswich,2010,2446150549,237590844,2683741393,91.15,8.85
144,Ipswich,2011,2421357836,235033754,2656391590,91.15,8.85
144,Ipswich,2012,2363515059,231735554,2595250613,91.07,8.93
144,Ipswich,2013,2332992495,228149519,2561142014,91.09,8.91
144,Ipswich,2014,2388613418,259462768,2648076186,90.2,9.8
144,Ipswich,2015,2471918744,261701368,2733620112,90.43,9.57
144,Ipswich,2016,2519445906,262995868,2782441774,90.55,9.45
145,Kingston,2003,1067535284,97947800,1165483084,91.6,8.4
145,Kingston,2004,1513502659,128285900,1641788559,92.19,7.81
145,Kingston,2005,1612158638,159668200,1771826838,90.99,9.01
145,Kingston,2006,1877556881,192343100,2069899981,90.71,9.29
145,Kingston,2007,2013563264,233927600,2247490864,89.59,10.41
145,Kingston,2008,1952806367,243573600,2196379967,88.91,11.09
145,Kingston,2009,1907712887,246125500,2153838387,88.57,11.43
145,Kingston,2010,1811316084,247925580,2059241664,87.96,12.04
145,Kingston,2011,1740450557,247599680,1988050237,87.55,12.45
145,Kingston,2012,1692520778,247163138,1939683916,87.26,12.74
145,Kingston,2013,1669258819,244326638,1913585457,87.23,12.77
145,Kingston,2014,1636346824,265301558,1901648382,86.05,13.95
145,Kingston,2015,1654991624,266706858,1921698482,86.12,13.88
145,Kingston,2016,1686825615,267710358,1954535973,86.3,13.7
146,Lakeville,2003,905592230,106809800,1012402030,89.45,10.55
146,Lakeville,2004,934482985,100614800,1035097785,90.28,9.72
146,Lakeville,2005,1404080765,131609060,1535689825,91.43,8.57
146,Lakeville,2006,1618498703,148551300,1767050003,91.59,8.41
146,Lakeville,2007,1621883452,153338700,1775222152,91.36,8.64
146,Lakeville,2008,1677260201,152966900,1830227101,91.64,8.36
146,Lakeville,2009,1647333680,152518900,1799852580,91.53,8.47
146,Lakeville,2010,1549658450,148152000,1697810450,91.27,8.73
146,Lakeville,2011,1471384215,130683500,1602067715,91.84,8.16
146,Lakeville,2012,1432512255,130325400,1562837655,91.66,8.34
146,Lakeville,2013,1407249325,130636600,1537885925,91.51,8.49
146,Lakeville,2014,1371420471,130561300,1501981771,91.31,8.69
146,Lakeville,2015,1410558934,134973300,1545532234,91.27,8.73
146,Lakeville,2016,1479232984,134394000,1613626984,91.67,8.33
147,Lancaster,2003,535063400,187529300,722592700,74.05,25.95
147,Lancaster,2004,556031900,187928800,743960700,74.74,25.26
147,Lancaster,2005,702927000,191709300,894636300,78.57,21.43
147,Lancaster,2006,807118800,201653300,1008772100,80.01,19.99
147,Lancaster,2007,842710500,218823100,1061533600,79.39,20.61
147,Lancaster,2008,888905740,231334600,1120240340,79.35,20.65
147,Lancaster,2009,854133389,225842100,1079975489,79.09,20.91
147,Lancaster,2010,826026350,218121200,1044147550,79.11,20.89
147,Lancaster,2011,805411049,215262500,1020673549,78.91,21.09
147,Lancaster,2012,788609858,209665000,998274858,79,21
147,Lancaster,2013,754259180,196796600,951055780,79.31,20.69
147,Lancaster,2014,787856213,194384300,982240513,80.21,19.79
147,Lancaster,2015,828513035,195201500,1023714535,80.93,19.07
147,Lancaster,2016,841274963,194399800,1035674763,81.23,18.77
148,Lanesborough,2003,265556119,19178200,284734319,93.26,6.74
148,Lanesborough,2004,281191316,20612100,301803416,93.17,6.83
148,Lanesborough,2005,330640729,27871200,358511929,92.23,7.77
148,Lanesborough,2006,343998281,343784427,687782708,50.02,49.98
148,Lanesborough,2007,384895493,9897560,394793053,97.49,2.51
148,Lanesborough,2008,434440079,33939300,468379379,92.75,7.25
148,Lanesborough,2009,426645883,33713700,460359583,92.68,7.32
148,Lanesborough,2010,409212467,32334100,441546567,92.68,7.32
148,Lanesborough,2011,409978820,32428900,442407720,92.67,7.33
148,Lanesborough,2012,406216624,32810600,439027224,92.53,7.47
148,Lanesborough,2013,392989827,32587700,425577527,92.34,7.66
148,Lanesborough,2014,391138940,31821700,422960640,92.48,7.52
148,Lanesborough,2015,402791313,37420300,440211613,91.5,8.5
148,Lanesborough,2016,397346099,37815300,435161399,91.31,8.69
149,Lawrence,2003,2098640290,256481400,2355121690,89.11,10.89
149,Lawrence,2004,2116036620,256765700,2372802320,89.18,10.82
149,Lawrence,2005,2874348580,303517300,3177865880,90.45,9.55
149,Lawrence,2006,3385768450,449483600,3835252050,88.28,11.72
149,Lawrence,2007,3581359940,473103000,4054462940,88.33,11.67
149,Lawrence,2008,3653177420,483741000,4136918420,88.31,11.69
149,Lawrence,2009,3482154660,527115800,4009270460,86.85,13.15
149,Lawrence,2010,2979929390,512693800,3492623190,85.32,14.68
149,Lawrence,2011,2854221570,524493700,3378715270,84.48,15.52
149,Lawrence,2012,2841966060,625153500,3467119560,81.97,18.03
149,Lawrence,2013,2819353620,620886600,3440240220,81.95,18.05
149,Lawrence,2014,2915720930,618215600,3533936530,82.51,17.49
149,Lawrence,2015,3115348560,728420300,3843768860,81.05,18.95
149,Lawrence,2016,3191934330,723594800,3915529130,81.52,18.48
150,Lee,2003,546481523,77774300,624255823,87.54,12.46
150,Lee,2004,563518652,85518800,649037452,86.82,13.18
150,Lee,2005,649856713,81807100,731663813,88.82,11.18
150,Lee,2006,701348696,86005100,787353796,89.08,10.92
150,Lee,2007,789771487,93779500,883550987,89.39,10.61
150,Lee,2008,866500207,105728100,972228307,89.13,10.87
150,Lee,2009,888724940,106759200,995484140,89.28,10.72
150,Lee,2010,889111113,108111200,997222313,89.16,10.84
150,Lee,2011,895810340,113413700,1009224040,88.76,11.24
150,Lee,2012,879955247,113565900,993521147,88.57,11.43
150,Lee,2013,878593837,114259400,992853237,88.49,11.51
150,Lee,2014,881460258,112505300,993965558,88.68,11.32
150,Lee,2015,909239469,125624400,1034863869,87.86,12.14
150,Lee,2016,912378464,125690000,1038068464,87.89,12.11
151,Leicester,2003,537436751,54074900,591511651,90.86,9.14
151,Leicester,2004,600604949,53779800,654384749,91.78,8.22
151,Leicester,2005,833049425,71651800,904701225,92.08,7.92
151,Leicester,2006,957056188,81175200,1038231388,92.18,7.82
151,Leicester,2007,1079006618,87002200,1166008818,92.54,7.46
151,Leicester,2008,1124792481,116337800,1241130281,90.63,9.37
151,Leicester,2009,1058270553,109758700,1168029253,90.6,9.4
151,Leicester,2010,968345623,111419600,1079765223,89.68,10.32
151,Leicester,2011,939682010,105948700,1045630710,89.87,10.13
151,Leicester,2012,913026608,104314900,1017341508,89.75,10.25
151,Leicester,2013,911633271,104779300,1016412571,89.69,10.31
151,Leicester,2014,883409246,102421700,985830946,89.61,10.39
151,Leicester,2015,888179752,111001100,999180852,88.89,11.11
151,Leicester,2016,899572172,110596930,1010169102,89.05,10.95
152,Lenox,2003,709225240,122335843,831561083,85.29,14.71
152,Lenox,2004,854375420,148458200,1002833620,85.2,14.8
152,Lenox,2005,970735660,161211100,1131946760,85.76,14.24
152,Lenox,2006,1031926030,167247900,1199173930,86.05,13.95
152,Lenox,2007,1169227630,199127400,1368355030,85.45,14.55
152,Lenox,2008,1218206240,197065400,1415271640,86.08,13.92
152,Lenox,2009,1250315600,158906500,1409222100,88.72,11.28
152,Lenox,2010,1182747650,155118500,1337866150,88.41,11.59
152,Lenox,2011,1155440240,154388700,1309828940,88.21,11.79
152,Lenox,2012,1119789310,148422300,1268211610,88.3,11.7
152,Lenox,2013,1129531840,149285900,1278817740,88.33,11.67
152,Lenox,2014,1111076690,143932800,1255009490,88.53,11.47
152,Lenox,2015,1108051620,143809100,1251860720,88.51,11.49
152,Lenox,2016,1138874950,147864900,1286739850,88.51,11.49
153,Leominster,2003,2560947710,209305190,2770252900,92.44,7.56
153,Leominster,2004,2857837510,283776990,3141614500,90.97,9.03
153,Leominster,2005,3255748300,298401200,3554149500,91.6,8.4
153,Leominster,2006,3756035400,414357700,4170393100,90.06,9.94
153,Leominster,2007,3901180660,428334700,4329515360,90.11,9.89
153,Leominster,2008,3943877000,440986200,4384863200,89.94,10.06
153,Leominster,2009,3881011364,453677700,4334689064,89.53,10.47
153,Leominster,2010,3510329703,445005800,3955335503,88.75,11.25
153,Leominster,2011,3289494997,426218300,3715713297,88.53,11.47
153,Leominster,2012,3178987671,405001200,3583988871,88.7,11.3
153,Leominster,2013,3072545471,406358300,3478903771,88.32,11.68
153,Leominster,2014,3061564349,415662700,3477227049,88.05,11.95
153,Leominster,2015,3086743968,379886400,3466630368,89.04,10.96
153,Leominster,2016,3209547786,381264600,3590812386,89.38,10.62
154,Leverett,2003,164586201,10056900,174643101,94.24,5.76
154,Leverett,2004,167113190,10032700,177145890,94.34,5.66
154,Leverett,2005,201779164,17156700,218935864,92.16,7.84
154,Leverett,2006,245547548,20426700,265974248,92.32,7.68
154,Leverett,2007,249276696,20527600,269804296,92.39,7.61
154,Leverett,2008,252539482,20472700,273012182,92.5,7.5
154,Leverett,2009,258578089,20495500,279073589,92.66,7.34
154,Leverett,2010,260983979,20656900,281640879,92.67,7.33
154,Leverett,2011,262869325,20388300,283257625,92.8,7.2
154,Leverett,2012,250016571,19887000,269903571,92.63,7.37
154,Leverett,2013,251110699,19634800,270745499,92.75,7.25
154,Leverett,2014,251806382,19831400,271637782,92.7,7.3
154,Leverett,2015,250103806,21102700,271206506,92.22,7.78
154,Leverett,2016,251571490,20958300,272529790,92.31,7.69
155,Lexington,2003,6083572560,441220000,6524792560,93.24,6.76
155,Lexington,2004,6911176060,470087000,7381263060,93.63,6.37
155,Lexington,2005,7146167360,514997000,7661164360,93.28,6.72
155,Lexington,2006,7686268530,600328000,8286596530,92.76,7.24
155,Lexington,2007,8059234580,605272000,8664506580,93.01,6.99
155,Lexington,2008,7929164350,634918000,8564082350,92.59,7.41
155,Lexington,2009,8033608130,629563000,8663171130,92.73,7.27
155,Lexington,2010,7891590610,624359000,8515949610,92.67,7.33
155,Lexington,2011,7973719190,644050000,8617769190,92.53,7.47
155,Lexington,2012,8026687320,668424000,8695111320,92.31,7.69
155,Lexington,2013,8307956760,687634000,8995590760,92.36,7.64
155,Lexington,2014,8555595350,791239000,9346834350,91.53,8.47
155,Lexington,2015,9359615090,844187000,10203802090,91.73,8.27
155,Lexington,2016,10048547685,898679000,10947226685,91.79,8.21
156,Leyden,2003,50614980,4677700,55292680,91.54,8.46
156,Leyden,2004,51666180,4677700,56343880,91.7,8.3
156,Leyden,2005,67652304,4462900,72115204,93.81,6.19
156,Leyden,2006,68317349,5234400,73551749,92.88,7.12
156,Leyden,2007,76030924,5947900,81978824,92.74,7.26
156,Leyden,2008,81360587,6328500,87689087,92.78,7.22
156,Leyden,2009,83773082,7600600,91373682,91.68,8.32
156,Leyden,2010,84064720,7600600,91665320,91.71,8.29
156,Leyden,2011,85294441,8734700,94029141,90.71,9.29
156,Leyden,2012,86339014,8732500,95071514,90.81,9.19
156,Leyden,2013,87385024,8732500,96117524,90.91,9.09
156,Leyden,2014,83568921,8391800,91960721,90.87,9.13
156,Leyden,2015,83934754,8621700,92556454,90.68,9.32
156,Leyden,2016,83802549,8535900,92338449,90.76,9.24
157,Lincoln,2003,1671757420,388889500,2060646920,81.13,18.87
157,Lincoln,2004,1830623391,459859300,2290482691,79.92,20.08
157,Lincoln,2005,1916485207,556984415,2473469622,77.48,22.52
157,Lincoln,2006,2011048535,573944240,2584992775,77.8,22.2
157,Lincoln,2007,1971631934,552934621,2524566555,78.1,21.9
157,Lincoln,2008,1902769311,539012587,2441781898,77.93,22.07
157,Lincoln,2009,1919014675,520493287,2439507962,78.66,21.34
157,Lincoln,2010,1852936230,413397900,2266334130,81.76,18.24
157,Lincoln,2011,1863243065,410988504,2274231569,81.93,18.07
157,Lincoln,2012,1770128060,399539344,2169667404,81.59,18.41
157,Lincoln,2013,1718500251,387686792,2106187043,81.59,18.41
157,Lincoln,2014,1761621342,393836582,2155457924,81.73,18.27
157,Lincoln,2015,1862057226,411792878,2273850104,81.89,18.11
157,Lincoln,2016,1973333662,433404127,2406737789,81.99,18.01
158,Littleton,2003,1123177922,100065255,1223243177,91.82,8.18
158,Littleton,2004,1291268239,111310250,1402578489,92.06,7.94
158,Littleton,2005,1343639956,116004850,1459644806,92.05,7.95
158,Littleton,2006,1409696577,119377350,1529073927,92.19,7.81
158,Littleton,2007,1521493003,128355450,1649848453,92.22,7.78
158,Littleton,2008,1514995328,126861450,1641856778,92.27,7.73
158,Littleton,2009,1458818997,121426050,1580245047,92.32,7.68
158,Littleton,2010,1451398874,117760700,1569159574,92.5,7.5
158,Littleton,2011,1485262625,120199200,1605461825,92.51,7.49
158,Littleton,2012,1487301914,123399500,1610701414,92.34,7.66
158,Littleton,2013,1466079193,121708700,1587787893,92.33,7.67
158,Littleton,2014,1471471125,135279000,1606750125,91.58,8.42
158,Littleton,2015,1484561658,136062900,1620624558,91.6,8.4
158,Littleton,2016,1625366807,151616900,1776983707,91.47,8.53
159,Longmeadow,2003,1605626895,99412300,1705039195,94.17,5.83
159,Longmeadow,2004,1607035468,99734500,1706769968,94.16,5.84
159,Longmeadow,2005,1827211141,102963000,1930174141,94.67,5.33
159,Longmeadow,2006,2110961471,135095100,2246056571,93.99,6.01
159,Longmeadow,2007,2110540388,137567400,2248107788,93.88,6.12
159,Longmeadow,2008,2120069974,138031100,2258101074,93.89,6.11
159,Longmeadow,2009,2168530312,148019100,2316549412,93.61,6.39
159,Longmeadow,2010,2084466814,145719400,2230186214,93.47,6.53
159,Longmeadow,2011,2102065873,144092500,2246158373,93.58,6.42
159,Longmeadow,2012,2102557717,151115000,2253672717,93.29,6.71
159,Longmeadow,2013,2035717361,164460300,2200177661,92.53,7.47
159,Longmeadow,2014,1951621392,191728000,2143349392,91.05,8.95
159,Longmeadow,2015,1957667938,192883200,2150551138,91.03,8.97
159,Longmeadow,2016,1965330665,189567200,2154897865,91.2,8.8
160,Lowell,2003,3905096223,1048277100,4953373323,78.84,21.16
160,Lowell,2004,3922956457,1051695000,4974651457,78.86,21.14
160,Lowell,2005,6137309709,1182102100,7319411809,83.85,16.15
160,Lowell,2006,6799254570,1252310000,8051564570,84.45,15.55
160,Lowell,2007,7137984860,1333347500,8471332360,84.26,15.74
160,Lowell,2008,7476547936,1328309300,8804857236,84.91,15.09
160,Lowell,2009,7028422911,1331166700,8359589611,84.08,15.92
160,Lowell,2010,6390673111,1242035800,7632708911,83.73,16.27
160,Lowell,2011,6149861125,1207472300,7357333425,83.59,16.41
160,Lowell,2012,6095108518,1231031200,7326139718,83.2,16.8
160,Lowell,2013,6082517858,1219477400,7301995258,83.3,16.7
160,Lowell,2014,6085685748,1620222220,7705907968,78.97,21.03
160,Lowell,2015,6332311813,1633580920,7965892733,79.49,20.51
160,Lowell,2016,6683928991,1674415000,8358343991,79.97,20.03
161,Ludlow,2003,1118140290,74678720,1192819010,93.74,6.26
161,Ludlow,2004,1149106930,76511520,1225618450,93.76,6.24
161,Ludlow,2005,1447991550,85877620,1533869170,94.4,5.6
161,Ludlow,2006,1643294170,91260170,1734554340,94.74,5.26
161,Ludlow,2007,1781922550,94422670,1876345220,94.97,5.03
161,Ludlow,2008,1865119550,99564170,1964683720,94.93,5.07
161,Ludlow,2009,1876678680,99499070,1976177750,94.97,5.03
161,Ludlow,2010,1801425170,98380100,1899805270,94.82,5.18
161,Ludlow,2011,1792208050,983323000,2775531050,64.57,35.43
161,Ludlow,2012,1781756570,98539600,1880296170,94.76,5.24
161,Ludlow,2013,1778822800,99859200,1878682000,94.68,5.32
161,Ludlow,2014,1844564190,99444900,1944009090,94.88,5.12
161,Ludlow,2015,1923513490,101130200,2024643690,95.01,4.99
161,Ludlow,2016,1955729200,103437000,2059166200,94.98,5.02
162,Lunenburg,2003,924787500,31573700,956361200,96.7,3.3
162,Lunenburg,2004,996295300,32564200,1028859500,96.83,3.17
162,Lunenburg,2005,1104022400,47356700,1151379100,95.89,4.11
162,Lunenburg,2006,1270455200,62126800,1332582000,95.34,4.66
162,Lunenburg,2007,1285947900,62708100,1348656000,95.35,4.65
162,Lunenburg,2008,1322671840,62341200,1385013040,95.5,4.5
162,Lunenburg,2009,1297176664,68529700,1365706364,94.98,5.02
162,Lunenburg,2010,1227274404,66476600,1293751004,94.86,5.14
162,Lunenburg,2011,1114282889,66728100,1181010989,94.35,5.65
162,Lunenburg,2012,1120966561,61917500,1182884061,94.77,5.23
162,Lunenburg,2013,1131029744,60660800,1191690544,94.91,5.09
162,Lunenburg,2014,1127633052,59892000,1187525052,94.96,5.04
162,Lunenburg,2015,1146501536,57333100,1203834636,95.24,4.76
162,Lunenburg,2016,1199604323,60104200,1259708523,95.23,4.77
163,Lynn,2003,4656277295,455243815,5111521110,91.09,8.91
163,Lynn,2004,5508583433,489258987,5997842420,91.84,8.16
163,Lynn,2005,6249264920,624788830,6874053750,90.91,9.09
163,Lynn,2006,6774769631,632605319,7407374950,91.46,8.54
163,Lynn,2007,7030173447,673311333,7703484780,91.26,8.74
163,Lynn,2008,7042423768,669273102,7711696870,91.32,8.68
163,Lynn,2009,6208089401,636841889,6844931290,90.7,9.3
163,Lynn,2010,5246831500,589769860,5836601360,89.9,10.1
163,Lynn,2011,5261064310,564200320,5825264630,90.31,9.69
163,Lynn,2012,5388175382,596549188,5984724570,90.03,9.97
163,Lynn,2013,5285703328,610548672,5896252000,89.65,10.35
163,Lynn,2014,5431137085,612420285,6043557370,89.87,10.13
163,Lynn,2015,5837592724,614437486,6452030210,90.48,9.52
163,Lynn,2016,6396561177,639229113,7035790290,90.91,9.09
164,Lynnfield,2003,1630294716,96441500,1726736216,94.41,5.59
164,Lynnfield,2004,1735743720,98889100,1834632820,94.61,5.39
164,Lynnfield,2005,2225316231,135077900,2360394131,94.28,5.72
164,Lynnfield,2006,2341762692,146767000,2488529692,94.1,5.9
164,Lynnfield,2007,2522406108,159200200,2681606308,94.06,5.94
164,Lynnfield,2008,2501455125,158655200,2660110325,94.04,5.96
164,Lynnfield,2009,2469628685,158717500,2628346185,93.96,6.04
164,Lynnfield,2010,2373478630,153150378,2526629008,93.94,6.06
164,Lynnfield,2011,2323411458,149750055,2473161513,93.94,6.06
164,Lynnfield,2012,2282013467,148200655,2430214122,93.9,6.1
164,Lynnfield,2013,2275038740,146238255,2421276995,93.96,6.04
164,Lynnfield,2014,2386201666,150651706,2536853372,94.06,5.94
164,Lynnfield,2015,2623225815,151359606,2774585421,94.54,5.46
164,Lynnfield,2016,2738317688,162439806,2900757494,94.4,5.6
165,Malden,2003,2877015746,306187200,3183202946,90.38,9.62
165,Malden,2004,4770574776,459603100,5230177876,91.21,8.79
165,Malden,2005,5121968425,461022700,5582991125,91.74,8.26
165,Malden,2006,5697024108,570386900,6267411008,90.9,9.1
165,Malden,2007,5957633135,566181400,6523814535,91.32,8.68
165,Malden,2008,5907237811,578058500,6485296311,91.09,8.91
165,Malden,2009,5784608211,562465096,6347073307,91.14,8.86
165,Malden,2010,5099369821,533891104,5633260925,90.52,9.48
165,Malden,2011,4794940046,569182204,5364122250,89.39,10.61
165,Malden,2012,4736723206,571243804,5307967010,89.24,10.76
165,Malden,2013,4818404634,580767200,5399171834,89.24,10.76
165,Malden,2014,4969883000,578213600,5548096600,89.58,10.42
165,Malden,2015,5378201254,595547900,5973749154,90.03,9.97
165,Malden,2016,5831500580,623399700,6454900280,90.34,9.66
166,Manchester By The Sea,2003,1513518971,99352900,1612871871,93.84,6.16
166,Manchester By The Sea,2004,1835706530,132150600,1967857130,93.28,6.72
166,Manchester By The Sea,2005,1872432515,136883700,2009316215,93.19,6.81
166,Manchester By The Sea,2006,1968937865,135971500,2104909365,93.54,6.46
166,Manchester By The Sea,2007,2141300006,150038100,2291338106,93.45,6.55
166,Manchester By The Sea,2008,2153026613,150419100,2303445713,93.47,6.53
166,Manchester By The Sea,2009,2196846241,173501500,2370347741,92.68,7.32
166,Manchester By The Sea,2010,2306398423,182730200,2489128623,92.66,7.34
166,Manchester By The Sea,2011,2161307579,174035200,2335342779,92.55,7.45
166,Manchester By The Sea,2012,2088758831,168868100,2257626931,92.52,7.48
166,Manchester By The Sea,2013,2089614972,175472900,2265087872,92.25,7.75
166,Manchester By The Sea,2014,2161963375,169527200,2331490575,92.73,7.27
166,Manchester By The Sea,2015,2178395584,171207600,2349603184,92.71,7.29
166,Manchester By The Sea,2016,2245655594,174050500,2419706094,92.81,7.19
167,Mansfield,2003,2110996990,110780300,2221777290,95.01,4.99
167,Mansfield,2004,2159190300,113490900,2272681200,95.01,4.99
167,Mansfield,2005,3102811780,156739900,3259551680,95.19,4.81
167,Mansfield,2006,3360758640,174599500,3535358140,95.06,4.94
167,Mansfield,2007,3429902900,178284300,3608187200,95.06,4.94
167,Mansfield,2008,3575848830,220213400,3796062230,94.2,5.8
167,Mansfield,2009,3474969010,220205600,3695174610,94.04,5.96
167,Mansfield,2010,3274781510,217264400,3492045910,93.78,6.22
167,Mansfield,2011,3064088390,199563040,3263651430,93.89,6.11
167,Mansfield,2012,3079421780,197245200,3276666980,93.98,6.02
167,Mansfield,2013,3086873240,196654400,3283527640,94.01,5.99
167,Mansfield,2014,3038051132,191704900,3229756032,94.06,5.94
167,Mansfield,2015,3177933730,197129460,3375063190,94.16,5.84
167,Mansfield,2016,3328444390,202976100,3531420490,94.25,5.75
168,Marblehead,2003,4097066770,227280700,4324347470,94.74,5.26
168,Marblehead,2004,4465808984,244861900,4710670884,94.8,5.2
168,Marblehead,2005,4826921577,270179900,5097101477,94.7,5.3
168,Marblehead,2006,5243134887,304714800,5547849687,94.51,5.49
168,Marblehead,2007,5843778008,353681800,6197459808,94.29,5.71
168,Marblehead,2008,5608551644,351156700,5959708344,94.11,5.89
168,Marblehead,2009,5350150064,342693900,5692843964,93.98,6.02
168,Marblehead,2010,5249413281,319537600,5568950881,94.26,5.74
168,Marblehead,2011,5031961071,314188900,5346149971,94.12,5.88
168,Marblehead,2012,5099945846,322260500,5422206346,94.06,5.94
168,Marblehead,2013,5049335856,314694900,5364030756,94.13,5.87
168,Marblehead,2014,5118227956,326283600,5444511556,94.01,5.99
168,Marblehead,2015,5326282656,351680500,5677963156,93.81,6.19
168,Marblehead,2016,5525938716,359649800,5885588516,93.89,6.11
169,Marion,2003,1098602690,106250800,1204853490,91.18,8.82
169,Marion,2004,1221938921,116402800,1338341721,91.3,8.7
169,Marion,2005,1496262619,117700400,1613963019,92.71,7.29
169,Marion,2006,1737823955,167092600,1904916555,91.23,8.77
169,Marion,2007,1804526251,174896600,1979422851,91.16,8.84
169,Marion,2008,1770505331,172571200,1943076531,91.12,8.88
169,Marion,2009,1757928780,176403700,1934332480,90.88,9.12
169,Marion,2010,1652880796,168848600,1821729396,90.73,9.27
169,Marion,2011,1564156607,171138900,1735295507,90.14,9.86
169,Marion,2012,1558138678,163977900,1722116578,90.48,9.52
169,Marion,2013,1519186707,164753800,1683940507,90.22,9.78
169,Marion,2014,1522879193,164675700,1687554893,90.24,9.76
169,Marion,2015,1482860510,168094900,1650955410,89.82,10.18
169,Marion,2016,1505616050,169293100,1674909150,89.89,10.11
170,Marlborough,2003,4038668810,248013600,4286682410,94.21,5.79
170,Marlborough,2004,4152363058,253975358,4406338416,94.24,5.76
170,Marlborough,2005,4380607662,259382288,4639989950,94.41,5.59
170,Marlborough,2006,4882146935,256430400,5138577335,95.01,4.99
170,Marlborough,2007,5117372495,355193200,5472565695,93.51,6.49
170,Marlborough,2008,5125931380,355979200,5481910580,93.51,6.49
170,Marlborough,2009,5181354272,417435900,5598790172,92.54,7.46
170,Marlborough,2010,4716118822,416513100,5132631922,91.88,8.12
170,Marlborough,2011,4546913110,420580630,4967493740,91.53,8.47
170,Marlborough,2012,4434551899,448820330,4883372229,90.81,9.19
170,Marlborough,2013,4460028237,446544220,4906572457,90.9,9.1
170,Marlborough,2014,4368011133,445531520,4813542653,90.74,9.26
170,Marlborough,2015,4526130781,480454430,5006585211,90.4,9.6
170,Marlborough,2016,4870542929,524083880,5394626809,90.29,9.71
171,Marshfield,2003,2916811557,186295000,3103106557,94,6
171,Marshfield,2004,3534171843,209939600,3744111443,94.39,5.61
171,Marshfield,2005,4130539758,226817600,4357357358,94.79,5.21
171,Marshfield,2006,4501830768,254651600,4756482368,94.65,5.35
171,Marshfield,2007,4786134091,256011600,5042145691,94.92,5.08
171,Marshfield,2008,4899160538,332437700,5231598238,93.65,6.35
171,Marshfield,2009,4431701475,304523800,4736225275,93.57,6.43
171,Marshfield,2010,4288104785,298036700,4586141485,93.5,6.5
171,Marshfield,2011,4230486740,282662600,4513149340,93.74,6.26
171,Marshfield,2012,4206535266,287764700,4494299966,93.6,6.4
171,Marshfield,2013,4183811448,293216300,4477027748,93.45,6.55
171,Marshfield,2014,4181807739,290613300,4472421039,93.5,6.5
171,Marshfield,2015,4318870523,388179204,4707049727,91.75,8.25
171,Marshfield,2016,4379265179,391467504,4770732683,91.79,8.21
172,Mashpee,2003,2734873920,272794300,3007668220,90.93,9.07
172,Mashpee,2004,2817174780,276257800,3093432580,91.07,8.93
172,Mashpee,2005,4424965220,417381500,4842346720,91.38,8.62
172,Mashpee,2006,4723893170,444133900,5168027070,91.41,8.59
172,Mashpee,2007,5146835890,491236600,5638072490,91.29,8.71
172,Mashpee,2008,5082281670,341685900,5423967570,93.7,6.3
172,Mashpee,2009,4987946730,334207300,5322154030,93.72,6.28
172,Mashpee,2010,4676701290,316465900,4993167190,93.66,6.34
172,Mashpee,2011,4454671310,319173700,4773845010,93.31,6.69
172,Mashpee,2012,4450439240,317825400,4768264640,93.33,6.67
172,Mashpee,2013,4391365280,313016700,4704381980,93.35,6.65
172,Mashpee,2014,4400340630,280815100,4681155730,94,6
172,Mashpee,2015,4578284120,323077100,4901361220,93.41,6.59
172,Mashpee,2016,4765906450,322137000,5088043450,93.67,6.33
173,Mattapoisett,2003,990208086,65920800,1056128886,93.76,6.24
173,Mattapoisett,2004,1011225492,66320100,1077545592,93.85,6.15
173,Mattapoisett,2005,1388418830,104836500,1493255330,92.98,7.02
173,Mattapoisett,2006,1621168925,126944000,1748112925,92.74,7.26
173,Mattapoisett,2007,1660593429,127659600,1788253029,92.86,7.14
173,Mattapoisett,2008,1641148743,132075200,1773223943,92.55,7.45
173,Mattapoisett,2009,1780364033,152797765,1933161798,92.1,7.9
173,Mattapoisett,2010,1690184238,148508300,1838692538,91.92,8.08
173,Mattapoisett,2011,1595266098,146589900,1741855998,91.58,8.42
173,Mattapoisett,2012,1557063458,146948100,1704011558,91.38,8.62
173,Mattapoisett,2013,1547674122,148258900,1695933022,91.26,8.74
173,Mattapoisett,2014,1543593788,151114300,1694708088,91.08,8.92
173,Mattapoisett,2015,1553493870,158773900,1712267770,90.73,9.27
173,Mattapoisett,2016,1581500341,162141300,1743641641,90.7,9.3
174,Maynard,2003,797838011,144011476,941849487,84.71,15.29
174,Maynard,2004,1150489381,226281600,1376770981,83.56,16.44
174,Maynard,2005,1164490863,228478600,1392969463,83.6,16.4
174,Maynard,2006,1296864715,230177078,1527041793,84.93,15.07
174,Maynard,2007,1380611057,231912340,1612523397,85.62,14.38
174,Maynard,2008,1384295611,234062940,1618358551,85.54,14.46
174,Maynard,2009,1350084313,233181100,1583265413,85.27,14.73
174,Maynard,2010,1279843525,136834000,1416677525,90.34,9.66
174,Maynard,2011,1237413740,129801400,1367215140,90.51,9.49
174,Maynard,2012,1223329115,133575900,1356905015,90.16,9.84
174,Maynard,2013,1194932677,138030300,1332962977,89.64,10.36
174,Maynard,2014,1130045955,133920600,1263966555,89.4,10.6
174,Maynard,2015,1173568330,134013700,1307582030,89.75,10.25
174,Maynard,2016,1275469015,141372900,1416841915,90.02,9.98
175,Medfield,2003,1487729537,121738501,1609468038,92.44,7.56
175,Medfield,2004,2013521169,167126450,2180647619,92.34,7.66
175,Medfield,2005,2135040345,167255850,2302296195,92.74,7.26
175,Medfield,2006,2239074111,168866150,2407940261,92.99,7.01
175,Medfield,2007,2421032930,243739050,2664771980,90.85,9.15
175,Medfield,2008,2351153190,246133650,2597286840,90.52,9.48
175,Medfield,2009,2301882050,242049700,2543931750,90.49,9.51
175,Medfield,2010,2291894139,241358415,2533252554,90.47,9.53
175,Medfield,2011,2246109150,240976815,2487085965,90.31,9.69
175,Medfield,2012,2236128671,237299715,2473428386,90.41,9.59
175,Medfield,2013,2254253649,227313815,2481567464,90.84,9.16
175,Medfield,2014,2286202429,229052415,2515254844,90.89,9.11
175,Medfield,2015,2389049459,240215365,2629264824,90.86,9.14
175,Medfield,2016,2485214555,253890850,2739105405,90.73,9.27
176,Medford,2003,4031860688,463217600,4495078288,89.7,10.3
176,Medford,2004,5875092593,460776100,6335868693,92.73,7.27
176,Medford,2005,6199708466,495852200,6695560666,92.59,7.41
176,Medford,2006,6806923867,502726000,7309649867,93.12,6.88
176,Medford,2007,7328329020,544108800,7872437820,93.09,6.91
176,Medford,2008,7380471340,605850100,7986321440,92.41,7.59
176,Medford,2009,6915140680,592194000,7507334680,92.11,7.89
176,Medford,2010,6581472630,602187000,7183659630,91.62,8.38
176,Medford,2011,6424058120,657464800,7081522920,90.72,9.28
176,Medford,2012,6418755640,667080200,7085835840,90.59,9.41
176,Medford,2013,6453246130,672926900,7126173030,90.56,9.44
176,Medford,2014,6778239060,890433899,7668672959,88.39,11.61
176,Medford,2015,7412497530,963046000,8375543530,88.5,11.5
176,Medford,2016,8086569270,981701800,9068271070,89.17,10.83
177,Medway,2003,1372292600,69176700,1441469300,95.2,4.8
177,Medway,2004,1390131540,69473900,1459605440,95.24,4.76
177,Medway,2005,1543703319,76960400,1620663719,95.25,4.75
177,Medway,2006,1801457770,120226800,1921684570,93.74,6.26
177,Medway,2007,1823164260,120747900,1943912160,93.79,6.21
177,Medway,2008,1758278520,114965800,1873244320,93.86,6.14
177,Medway,2009,1713205920,109716100,1822922020,93.98,6.02
177,Medway,2010,1638646140,107956000,1746602140,93.82,6.18
177,Medway,2011,1606013320,111948600,1717961920,93.48,6.52
177,Medway,2012,1624862427,113539825,1738402252,93.47,6.53
177,Medway,2013,1594651065,116844125,1711495190,93.17,6.83
177,Medway,2014,1640912265,116405550,1757317815,93.38,6.62
177,Medway,2015,1729752926,117574996,1847327922,93.64,6.36
177,Medway,2016,1808117039,119838396,1927955435,93.78,6.22
178,Melrose,2003,2546340388,246719900,2793060288,91.17,8.83
178,Melrose,2004,2805339205,270492000,3075831205,91.21,8.79
178,Melrose,2005,3418663428,298694300,3717357728,91.96,8.04
178,Melrose,2006,3596720150,308392100,3905112250,92.1,7.9
178,Melrose,2007,3749012669,320040900,4069053569,92.13,7.87
178,Melrose,2008,3698508445,314735700,4013244145,92.16,7.84
178,Melrose,2009,3582636875,307333800,3889970675,92.1,7.9
178,Melrose,2010,3518831885,299490200,3818322085,92.16,7.84
178,Melrose,2011,3512225479,294934500,3807159979,92.25,7.75
178,Melrose,2012,3533935488,294160800,3828096288,92.32,7.68
178,Melrose,2013,3571667318,295291900,3866959218,92.36,7.64
178,Melrose,2014,3655100765,297048900,3952149665,92.48,7.52
178,Melrose,2015,3868286730,334050600,4202337330,92.05,7.95
178,Melrose,2016,4209169830,342403500,4551573330,92.48,7.52
179,Mendon,2003,604839410,22405900,627245310,96.43,3.57
179,Mendon,2004,698339040,23513900,721852940,96.74,3.26
179,Mendon,2005,792549524,30941900,823491424,96.24,3.76
179,Mendon,2006,880778830,34446200,915225030,96.24,3.76
179,Mendon,2007,917643370,36890000,954533370,96.14,3.86
179,Mendon,2008,902135960,35884400,938020360,96.17,3.83
179,Mendon,2009,875171180,35229700,910400880,96.13,3.87
179,Mendon,2010,829184500,33681800,862866300,96.1,3.9
179,Mendon,2011,803006750,32567600,835574350,96.1,3.9
179,Mendon,2012,797895640,33520500,831416140,95.97,4.03
179,Mendon,2013,784761770,32868700,817630470,95.98,4.02
179,Mendon,2014,768819520,30939400,799758920,96.13,3.87
179,Mendon,2015,804752250,32168800,836921050,96.16,3.84
179,Mendon,2016,843817300,34313200,878130500,96.09,3.91
180,Merrimac,2003,406242813,22333260,428576073,94.79,5.21
180,Merrimac,2004,608373706,31386735,639760441,95.09,4.91
180,Merrimac,2005,619909726,32495035,652404761,95.02,4.98
180,Merrimac,2006,729334998,32592335,761927333,95.72,4.28
180,Merrimac,2007,809259812,42700385,851960197,94.99,5.01
180,Merrimac,2008,790872094,42429010,833301104,94.91,5.09
180,Merrimac,2009,746865727,40448505,787314232,94.86,5.14
180,Merrimac,2010,720721568,40361280,761082848,94.7,5.3
180,Merrimac,2011,691809274,43821005,735630279,94.04,5.96
180,Merrimac,2012,654943662,42144545,697088207,93.95,6.05
180,Merrimac,2013,663274773,42142270,705417043,94.03,5.97
180,Merrimac,2014,666822432,43224670,710047102,93.91,6.09
180,Merrimac,2015,675631803,42988570,718620373,94.02,5.98
180,Merrimac,2016,709147045,45285555,754432600,94,6
181,Methuen,2003,3365851633,232225400,3598077033,93.55,6.45
181,Methuen,2004,3408508308,234960200,3643468508,93.55,6.45
181,Methuen,2005,4247455611,280761900,4528217511,93.8,6.2
181,Methuen,2006,4874712506,314228500,5188941006,93.94,6.06
181,Methuen,2007,4973951234,314066900,5288018134,94.06,5.94
181,Methuen,2008,5063722606,318797600,5382520206,94.08,5.92
181,Methuen,2009,4896533366,314584600,5211117966,93.96,6.04
181,Methuen,2010,4587190983,307149800,4894340783,93.72,6.28
181,Methuen,2011,4361461529,304823800,4666285329,93.47,6.53
181,Methuen,2012,4421621204,270903100,4692524304,94.23,5.77
181,Methuen,2013,4260656298,270093500,4530749798,94.04,5.96
181,Methuen,2014,4311448406,271391400,4582839806,94.08,5.92
181,Methuen,2015,4628973896,334643440,4963617336,93.26,6.74
181,Methuen,2016,4804659354,359230140,5163889494,93.04,6.96
182,Middleborough,2003,1332962506,130065890,1463028396,91.11,8.89
182,Middleborough,2004,1837536093,171945666,2009481759,91.44,8.56
182,Middleborough,2005,2091407391,174474744,2265882135,92.3,7.7
182,Middleborough,2006,2446382626,242878444,2689261070,90.97,9.03
182,Middleborough,2007,2733249836,235992644,2969242480,92.05,7.95
182,Middleborough,2008,2634585600,232783594,2867369194,91.88,8.12
182,Middleborough,2009,2573236456,234554300,2807790756,91.65,8.35
182,Middleborough,2010,2481105459,243868000,2724973459,91.05,8.95
182,Middleborough,2011,2335351162,241866300,2577217462,90.62,9.38
182,Middleborough,2012,2296872855,236902100,2533774955,90.65,9.35
182,Middleborough,2013,2199443642,237462200,2436905842,90.26,9.74
182,Middleborough,2014,2187071218,245592700,2432663918,89.9,10.1
182,Middleborough,2015,2239818773,246562700,2486381473,90.08,9.92
182,Middleborough,2016,2302033363,254938700,2556972063,90.03,9.97
183,Middlefield,2003,38079437,6026000,44105437,86.34,13.66
183,Middlefield,2004,38374269,6032000,44406269,86.42,13.58
183,Middlefield,2005,47236169,7146200,54382369,86.86,13.14
183,Middlefield,2006,52445844,7521400,59967244,87.46,12.54
183,Middlefield,2007,60767618,8941200,69708818,87.17,12.83
183,Middlefield,2008,61140170,9643500,70783670,86.38,13.62
183,Middlefield,2009,64122565,9267000,73389565,87.37,12.63
183,Middlefield,2010,64177382,9166300,73343682,87.5,12.5
183,Middlefield,2011,65785580,10227800,76013380,86.54,13.46
183,Middlefield,2012,65366361,9638500,75004861,87.15,12.85
183,Middlefield,2013,65350619,9759400,75110019,87.01,12.99
183,Middlefield,2014,65949334,10115200,76064534,86.7,13.3
183,Middlefield,2015,65485224,13374900,78860124,83.04,16.96
183,Middlefield,2016,65495063,15380500,80875563,80.98,19.02
184,Middleton,2003,1125865595,115890100,1241755695,90.67,9.33
184,Middleton,2004,1250842513,120575000,1371417513,91.21,8.79
184,Middleton,2005,1386392167,131250300,1517642467,91.35,8.65
184,Middleton,2006,1525996929,135493300,1661490229,91.85,8.15
184,Middleton,2007,1637184638,153349800,1790534438,91.44,8.56
184,Middleton,2008,1750419569,139258800,1889678369,92.63,7.37
184,Middleton,2009,1669197723,142072400,1811270123,92.16,7.84
184,Middleton,2010,1575444537,128834800,1704279337,92.44,7.56
184,Middleton,2011,1589878226,117211000,1707089226,93.13,6.87
184,Middleton,2012,1578377854,151017300,1729395154,91.27,8.73
184,Middleton,2013,1569384109,151064500,1720448609,91.22,8.78
184,Middleton,2014,1620675578,162113000,1782788578,90.91,9.09
184,Middleton,2015,1701647219,170302000,1871949219,90.9,9.1
184,Middleton,2016,1779572637,174841500,1954414137,91.05,8.95
185,Milford,2003,2198367699,151023700,2349391399,93.57,6.43
185,Milford,2004,2706311247,165346800,2871658047,94.24,5.76
185,Milford,2005,2864130572,168311500,3032442072,94.45,5.55
185,Milford,2006,3124161169,175776300,3299937469,94.67,5.33
185,Milford,2007,3472050370,198809600,3670859970,94.58,5.42
185,Milford,2008,3428258508,198527600,3626786108,94.53,5.47
185,Milford,2009,3325864671,199379100,3525243771,94.34,5.66
185,Milford,2010,3074937774,199875700,3274813474,93.9,6.1
185,Milford,2011,2908429512,196104000,3104533512,93.68,6.32
185,Milford,2012,2818193496,194110000,3012303496,93.56,6.44
185,Milford,2013,2777528854,191328000,2968856854,93.56,6.44
185,Milford,2014,2742732915,192444700,2935177615,93.44,6.56
185,Milford,2015,2872648718,201906645,3074555363,93.43,6.57
185,Milford,2016,3007636160,206820859,3214457019,93.57,6.43
186,Millbury,2003,846332975,99954700,946287675,89.44,10.56
186,Millbury,2004,860776218,100950800,961727018,89.5,10.5
186,Millbury,2005,1167484864,114984700,1282469564,91.03,8.97
186,Millbury,2006,1394742767,128871100,1523613867,91.54,8.46
186,Millbury,2007,1534375532,132570300,1666945832,92.05,7.95
186,Millbury,2008,1481596357,134911000,1616507357,91.65,8.35
186,Millbury,2009,1498761215,140175800,1638937015,91.45,8.55
186,Millbury,2010,1384923642,138659800,1523583442,90.9,9.1
186,Millbury,2011,1311635723,137506300,1449142023,90.51,9.49
186,Millbury,2012,1274360579,130480200,1404840779,90.71,9.29
186,Millbury,2013,1240728108,132887400,1373615508,90.33,9.67
186,Millbury,2014,1246458831,134337100,1380795931,90.27,9.73
186,Millbury,2015,1357047951,142567800,1499615751,90.49,9.51
186,Millbury,2016,1395657448,142140900,1537798348,90.76,9.24
187,Millis,2003,694450960,37160400,731611360,94.92,5.08
187,Millis,2004,700836130,37507700,738343830,94.92,5.08
187,Millis,2005,989149160,48683900,1037833060,95.31,4.69
187,Millis,2006,1022603410,52863600,1075467010,95.08,4.92
187,Millis,2007,1079205010,53698700,1132903710,95.26,4.74
187,Millis,2008,1130281080,61403000,1191684080,94.85,5.15
187,Millis,2009,1103294700,62279600,1165574300,94.66,5.34
187,Millis,2010,1066155430,60264300,1126419730,94.65,5.35
187,Millis,2011,995629980,64919400,1060549380,93.88,6.12
187,Millis,2012,995425000,65948000,1061373000,93.79,6.21
187,Millis,2013,999286250,64860300,1064146550,93.9,6.1
187,Millis,2014,1009031070,66434500,1075465570,93.82,6.18
187,Millis,2015,1049514290,73659900,1123174190,93.44,6.56
187,Millis,2016,1065964880,73346600,1139311480,93.56,6.44
188,Millville,2003,172388476,13241600,185630076,92.87,7.13
188,Millville,2004,195242516,14274800,209517316,93.19,6.81
188,Millville,2005,277475997,16677600,294153597,94.33,5.67
188,Millville,2006,280827720,16892200,297719920,94.33,5.67
188,Millville,2007,326355629,18168500,344524129,94.73,5.27
188,Millville,2008,335525124,19395900,354921024,94.54,5.46
188,Millville,2009,321007032,18243000,339250032,94.62,5.38
188,Millville,2010,320694823,18331500,339026323,94.59,5.41
188,Millville,2011,295737825,19524400,315262225,93.81,6.19
188,Millville,2012,292257300,18783100,311040400,93.96,6.04
188,Millville,2013,268524895,17944200,286469095,93.74,6.26
188,Millville,2014,244231653,16369500,260601153,93.72,6.28
188,Millville,2015,252290638,16424900,268715538,93.89,6.11
188,Millville,2016,269791233,16935300,286726533,94.09,5.91
189,Milton,2003,3361125391,313430150,3674555541,91.47,8.53
189,Milton,2004,3383837226,313486000,3697323226,91.52,8.48
189,Milton,2005,4044975101,326886700,4371861801,92.52,7.48
189,Milton,2006,4565959340,442280400,5008239740,91.17,8.83
189,Milton,2007,4616180467,519394100,5135574567,89.89,10.11
189,Milton,2008,4662892057,560059860,5222951917,89.28,10.72
189,Milton,2009,4497791088,557842360,5055633448,88.97,11.03
189,Milton,2010,4411820926,555230892,4967051818,88.82,11.18
189,Milton,2011,4299353433,548246292,4847599725,88.69,11.31
189,Milton,2012,4333363901,540386252,4873750153,88.91,11.09
189,Milton,2013,4323171659,575574392,4898746051,88.25,11.75
189,Milton,2014,4385385588,582299392,4967684980,88.28,11.72
189,Milton,2015,4774696769,621910240,5396607009,88.48,11.52
189,Milton,2016,5148564163,728257980,5876822143,87.61,12.39
190,Monroe,2003,14865777,2070940,16936717,87.77,12.23
190,Monroe,2004,14922469,2070940,16993409,87.81,12.19
190,Monroe,2005,15626062,2030600,17656662,88.5,11.5
190,Monroe,2006,17911310,2687964,20599274,86.95,13.05
190,Monroe,2007,19004549,2687964,21692513,87.61,12.39
190,Monroe,2008,19154764,2687964,21842728,87.69,12.31
190,Monroe,2009,23533707,2319234,25852941,91.03,8.97
190,Monroe,2010,21392581,2322934,23715515,90.21,9.79
190,Monroe,2011,21417203,2322934,23740137,90.22,9.78
190,Monroe,2012,22472074,2471830,24943904,90.09,9.91
190,Monroe,2013,22352142,2471830,24823972,90.04,9.96
190,Monroe,2014,22473806,2471830,24945636,90.09,9.91
190,Monroe,2015,25910011,2475130,28385141,91.28,8.72
190,Monroe,2016,25848017,2502930,28350947,91.17,8.83
191,Monson,2003,441123600,95981638,537105238,82.13,17.87
191,Monson,2004,523875450,88837898,612713348,85.5,14.5
191,Monson,2005,604814900,104055108,708870008,85.32,14.68
191,Monson,2006,658112650,105052488,763165138,86.23,13.77
191,Monson,2007,734702733,109728200,844430933,87.01,12.99
191,Monson,2008,787745192,91877100,879622292,89.55,10.45
191,Monson,2009,797207780,88263400,885471180,90.03,9.97
191,Monson,2010,771116435,85217400,856333835,90.05,9.95
191,Monson,2011,742770280,82890000,825660280,89.96,10.04
191,Monson,2012,729293150,81945600,811238750,89.9,10.1
191,Monson,2013,746707595,82859500,829567095,90.01,9.99
191,Monson,2014,721830276,80607100,802437376,89.95,10.05
191,Monson,2015,727236401,81043400,808279801,89.97,10.03
191,Monson,2016,733225391,76976600,810201991,90.5,9.5
192,Montague,2003,456297636,81084440,537382076,84.91,15.09
192,Montague,2004,520268096,95520505,615788601,84.49,15.51
192,Montague,2005,569717741,92622045,662339786,86.02,13.98
192,Montague,2006,605081324,94393485,699474809,86.51,13.49
192,Montague,2007,689914610,112329000,802243610,86,14
192,Montague,2008,701522786,113433843,814956629,86.08,13.92
192,Montague,2009,710859781,110275690,821135471,86.57,13.43
192,Montague,2010,744807996,125148994,869956990,85.61,14.39
192,Montague,2011,739686403,124908094,864594497,85.55,14.45
192,Montague,2012,731566784,125438454,857005238,85.36,14.64
192,Montague,2013,710033369,122717550,832750919,85.26,14.74
192,Montague,2014,760048413,130528881,890577294,85.34,14.66
192,Montague,2015,757183042,129041761,886224803,85.44,14.56
192,Montague,2016,756413618,124895157,881308775,85.83,14.17
193,Monterey,2003,243627546,33079900,276707446,88.05,11.95
193,Monterey,2004,245214863,35653700,280868563,87.31,12.69
193,Monterey,2005,310972829,37585400,348558229,89.22,10.78
193,Monterey,2006,428496924,46899700,475396624,90.13,9.87
193,Monterey,2007,429628874,46899700,476528574,90.16,9.84
193,Monterey,2008,467032526,51640200,518672726,90.04,9.96
193,Monterey,2009,486315962,57646500,543962462,89.4,10.6
193,Monterey,2010,492442255,58195200,550637455,89.43,10.57
193,Monterey,2011,494331333,59217600,553548933,89.3,10.7
193,Monterey,2012,500191828,56294700,556486528,89.88,10.12
193,Monterey,2013,501501762,55993800,557495562,89.96,10.04
193,Monterey,2014,502472639,56203300,558675939,89.94,10.06
193,Monterey,2015,502419840,56136700,558556540,89.95,10.05
193,Monterey,2016,504273397,56544900,560818297,89.92,10.08
194,Montgomery,2003,55078766,3010900,58089666,94.82,5.18
194,Montgomery,2004,68742151,4467105,73209256,93.9,6.1
194,Montgomery,2005,73804227,4558105,78362332,94.18,5.82
194,Montgomery,2006,91932694,5826600,97759294,94.04,5.96
194,Montgomery,2007,96131633,4753000,100884633,95.29,4.71
194,Montgomery,2008,97096397,4753000,101849397,95.33,4.67
194,Montgomery,2009,95953986,4868800,100822786,95.17,4.83
194,Montgomery,2010,97515955,4819000,102334955,95.29,4.71
194,Montgomery,2011,98897087,4819000,103716087,95.35,4.65
194,Montgomery,2012,98410742,4848700,103259442,95.3,4.7
194,Montgomery,2013,103740990,4872700,108613690,95.51,4.49
194,Montgomery,2014,105014969,4932900,109947869,95.51,4.49
194,Montgomery,2015,106186887,4930500,111117387,95.56,4.44
194,Montgomery,2016,105899992,4955300,110855292,95.53,4.47
195,Mount Washington,2003,52163357,26400700,78564057,66.4,33.6
195,Mount Washington,2004,58767824,32408500,91176324,64.46,35.54
195,Mount Washington,2005,60325454,31017300,91342754,66.04,33.96
195,Mount Washington,2006,65904813,34678700,100583513,65.52,34.48
195,Mount Washington,2007,75029624,36977400,112007024,66.99,33.01
195,Mount Washington,2008,76108970,37378800,113487770,67.06,32.94
195,Mount Washington,2009,76342880,37550900,113893780,67.03,32.97
195,Mount Washington,2010,67584570,32873900,100458470,67.28,32.72
195,Mount Washington,2011,83510118,36753400,120263518,69.44,30.56
195,Mount Washington,2012,83762298,37125100,120887398,69.29,30.71
195,Mount Washington,2013,84329128,37358600,121687728,69.3,30.7
195,Mount Washington,2014,83819178,37259300,121078478,69.23,30.77
195,Mount Washington,2015,84288303,37259300,121547603,69.35,30.65
195,Mount Washington,2016,83231659,36915500,120147159,69.27,30.73
196,Nahant,2003,568989052,56723500,625712552,90.93,9.07
196,Nahant,2004,634005385,62692400,696697785,91,9
196,Nahant,2005,710234525,66795900,777030425,91.4,8.6
196,Nahant,2006,791884770,74256400,866141170,91.43,8.57
196,Nahant,2007,845814255,78008400,923822655,91.56,8.44
196,Nahant,2008,866166675,84204200,950370875,91.14,8.86
196,Nahant,2009,845531239,81554500,927085739,91.2,8.8
196,Nahant,2010,778519185,75658900,854178085,91.14,8.86
196,Nahant,2011,750876240,73300000,824176240,91.11,8.89
196,Nahant,2012,731212558,71202300,802414858,91.13,8.87
196,Nahant,2013,735052978,71500100,806553078,91.14,8.86
196,Nahant,2014,734525168,74425300,808950468,90.8,9.2
196,Nahant,2015,758715768,74216400,832932168,91.09,8.91
196,Nahant,2016,809424570,74994000,884418570,91.52,8.48
197,Nantucket,2003,10807646647,1876587600,12684234247,85.21,14.79
197,Nantucket,2004,12800439935,2306762500,15107202435,84.73,15.27
197,Nantucket,2005,13047557670,2350426500,15397984170,84.74,15.26
197,Nantucket,2006,16474976197,4086651800,20561627997,80.12,19.88
197,Nantucket,2007,20383711813,5037509500,25421221313,80.18,19.82
197,Nantucket,2008,20623608960,5045186000,25668794960,80.35,19.65
197,Nantucket,2009,20819085012,5054350800,25873435812,80.47,19.53
197,Nantucket,2010,20063008015,3740515200,23803523215,84.29,15.71
197,Nantucket,2011,17208429905,3134384400,20342814305,84.59,15.41
197,Nantucket,2012,16844170191,3093784500,19937954691,84.48,15.52
197,Nantucket,2013,17101129679,3153871000,20255000679,84.43,15.57
197,Nantucket,2014,16939727455,3140035300,20079762755,84.36,15.64
197,Nantucket,2015,18181425169,3254053700,21435478869,84.82,15.18
197,Nantucket,2016,20544013596,3597048800,24141062396,85.1,14.9
198,Natick,2003,4394385885,437708900,4832094785,90.94,9.06
198,Natick,2004,5498901660,512454200,6011355860,91.48,8.52
198,Natick,2005,5551953330,539531360,6091484690,91.14,8.86
198,Natick,2006,6104716810,581741000,6686457810,91.3,8.7
198,Natick,2007,6559448230,505903000,7065351230,92.84,7.16
198,Natick,2008,6512153870,522967200,7035121070,92.57,7.43
198,Natick,2009,6585028440,523878950,7108907390,92.63,7.37
198,Natick,2010,6595636170,563234890,7158871060,92.13,7.87
198,Natick,2011,6321047327,552507131,6873554458,91.96,8.04
198,Natick,2012,6215335586,546990431,6762326017,91.91,8.09
198,Natick,2013,6228971060,525462931,6754433991,92.22,7.78
198,Natick,2014,6589327610,560049600,7149377210,92.17,7.83
198,Natick,2015,6984848900,608130300,7592979200,91.99,8.01
198,Natick,2016,7355714270,641107400,7996821670,91.98,8.02
199,Needham,2003,5457973540,351186900,5809160440,93.95,6.05
199,Needham,2004,5795628004,440411700,6236039704,92.94,7.06
199,Needham,2005,5990150560,462310600,6452461160,92.84,7.16
199,Needham,2006,7041870201,485717867,7527588068,93.55,6.45
199,Needham,2007,7120813393,506242767,7627056160,93.36,6.64
199,Needham,2008,7209038765,567445777,7776484542,92.7,7.3
199,Needham,2009,7331302203,584666047,7915968250,92.61,7.39
199,Needham,2010,7431763903,559356747,7991120650,93,7
199,Needham,2011,7576258088,584872462,8161130550,92.83,7.17
199,Needham,2012,7833149550,610967320,8444116870,92.76,7.24
199,Needham,2013,7923989930,620330520,8544320450,92.74,7.26
199,Needham,2014,8068732995,628641295,8697374290,92.77,7.23
199,Needham,2015,8838727746,672212595,9510940341,92.93,7.07
199,Needham,2016,9068188822,684071695,9752260517,92.99,7.01
200,New Ashford,2003,22437700,2502100,24939800,89.97,10.03
200,New Ashford,2004,23072700,2502100,25574800,90.22,9.78
200,New Ashford,2005,29242700,2735000,31977700,91.45,8.55
200,New Ashford,2006,30183000,1566500,31749500,95.07,4.93
200,New Ashford,2007,31473900,2786500,34260400,91.87,8.13
200,New Ashford,2008,31380700,2957700,34338400,91.39,8.61
200,New Ashford,2009,43207100,6168600,49375700,87.51,12.49
200,New Ashford,2010,45535300,12102300,57637600,79,21
200,New Ashford,2011,45435300,12202300,57637600,78.83,21.17
200,New Ashford,2012,39934900,8210700,48145600,82.95,17.05
200,New Ashford,2013,39912100,8210700,48122800,82.94,17.06
200,New Ashford,2014,39925600,8210700,48136300,82.94,17.06
200,New Ashford,2015,40798100,8210700,49008800,83.25,16.75
200,New Ashford,2016,40934800,8210700,49145500,83.29,16.71
201,New Bedford,2003,3604932440,866499200,4471431640,80.62,19.38
201,New Bedford,2004,4534708400,989850500,5524558900,82.08,17.92
201,New Bedford,2005,5180267390,1016120200,6196387590,83.6,16.4
201,New Bedford,2006,5833490830,1047595300,6881086130,84.78,15.22
201,New Bedford,2007,6677538560,1116400300,7793938860,85.68,14.32
201,New Bedford,2008,6726209860,1162771500,7888981360,85.26,14.74
201,New Bedford,2009,6594831510,1155990500,7750822010,85.09,14.91
201,New Bedford,2010,6484764550,1146308700,7631073250,84.98,15.02
201,New Bedford,2011,6007643530,1131160800,7138804330,84.15,15.85
201,New Bedford,2012,5675527230,1135960500,6811487730,83.32,16.68
201,New Bedford,2013,5479569620,1153530804,6633100424,82.61,17.39
201,New Bedford,2014,5226433760,1128056700,6354490460,82.25,17.75
201,New Bedford,2015,5237212490,1133039900,6370252390,82.21,17.79
201,New Bedford,2016,5334989630,1272834400,6607824030,80.74,19.26
202,New Braintree,2003,58820693,17158900,75979593,77.42,22.58
202,New Braintree,2004,83983174,19434600,103417774,81.21,18.79
202,New Braintree,2005,86103723,21109700,107213423,80.31,19.69
202,New Braintree,2006,97045085,22178400,119223485,81.4,18.6
202,New Braintree,2007,113029238,23803000,136832238,82.6,17.4
202,New Braintree,2008,115289704,25642100,140931804,81.81,18.19
202,New Braintree,2009,117445625,26503900,143949525,81.59,18.41
202,New Braintree,2010,113918130,28973400,142891530,79.72,20.28
202,New Braintree,2011,107094945,26262300,133357245,80.31,19.69
202,New Braintree,2012,104652557,25540800,130193357,80.38,19.62
202,New Braintree,2013,110568026,28819900,139387926,79.32,20.68
202,New Braintree,2014,110292928,28823200,139116128,79.28,20.72
202,New Braintree,2015,110734543,29497300,140231843,78.97,21.03
202,New Braintree,2016,105051471,27058600,132110071,79.52,20.48
203,New Marlborough,2003,209782669,9379300,219161969,95.72,4.28
203,New Marlborough,2004,354830960,21595400,376426360,94.26,5.74
203,New Marlborough,2005,360013000,21514500,381527500,94.36,5.64
203,New Marlborough,2006,422301780,23921900,446223680,94.64,5.36
203,New Marlborough,2007,508522570,20610700,529133270,96.1,3.9
203,New Marlborough,2008,496376060,19990200,516366260,96.13,3.87
203,New Marlborough,2009,496614680,20506300,517120980,96.03,3.97
203,New Marlborough,2010,483703640,20165400,503869040,96,4
203,New Marlborough,2011,453958790,19754900,473713690,95.83,4.17
203,New Marlborough,2012,455984600,20107800,476092400,95.78,4.22
203,New Marlborough,2013,471279140,21162400,492441540,95.7,4.3
203,New Marlborough,2014,477310290,22337800,499648090,95.53,4.47
203,New Marlborough,2015,476848240,21913000,498761240,95.61,4.39
203,New Marlborough,2016,485264620,22292800,507557420,95.61,4.39
204,New Salem,2003,74176400,9085700,83262100,89.09,10.91
204,New Salem,2004,76314621,9190300,85504921,89.25,10.75
204,New Salem,2005,84023618,25276649,109300267,76.87,23.13
204,New Salem,2006,104764431,45463600,150228031,69.74,30.26
204,New Salem,2007,107459898,28683722,136143620,78.93,21.07
204,New Salem,2008,108322289,28939322,137261611,78.92,21.08
204,New Salem,2009,119140009,40817899,159957908,74.48,25.52
204,New Salem,2010,119678521,40756699,160435220,74.6,25.4
204,New Salem,2011,116794003,40080499,156874502,74.45,25.55
204,New Salem,2012,118709970,42821499,161531469,73.49,26.51
204,New Salem,2013,106886415,44108593,150995008,70.79,29.21
204,New Salem,2014,107742486,43967942,151710428,71.02,28.98
204,New Salem,2015,107964663,44229817,152194480,70.94,29.06
204,New Salem,2016,105213647,43358017,148571664,70.82,29.18
205,Newbury,2003,900378919,111332100,1011711019,89,11
205,Newbury,2004,1094238893,127200200,1221439093,89.59,10.41
205,Newbury,2005,1170748684,130349500,1301098184,89.98,10.02
205,Newbury,2006,1272083955,145218300,1417302255,89.75,10.25
205,Newbury,2007,1437975207,186317300,1624292507,88.53,11.47
205,Newbury,2008,1417441946,189233400,1606675346,88.22,11.78
205,Newbury,2009,1358656887,190378900,1549035787,87.71,12.29
205,Newbury,2010,1367542555,183959000,1551501555,88.14,11.86
205,Newbury,2011,1288765831,181319300,1470085131,87.67,12.33
205,Newbury,2012,1203306449,178939800,1382246249,87.05,12.95
205,Newbury,2013,1198015670,175561600,1373577270,87.22,12.78
205,Newbury,2014,1233975798,184475100,1418450898,86.99,13.01
205,Newbury,2015,1254369345,183581300,1437950645,87.23,12.77
205,Newbury,2016,1315963077,187800800,1503763877,87.51,12.49
206,Newburyport,2003,2110030865,224927000,2334957865,90.37,9.63
206,Newburyport,2004,2141369796,223711500,2365081296,90.54,9.46
206,Newburyport,2005,3065377025,282135800,3347512825,91.57,8.43
206,Newburyport,2006,3282762337,284153900,3566916237,92.03,7.97
206,Newburyport,2007,3510329680,294624800,3804954480,92.26,7.74
206,Newburyport,2008,3624203332,293399600,3917602932,92.51,7.49
206,Newburyport,2009,3477448681,283290300,3760738981,92.47,7.53
206,Newburyport,2010,3369691485,278903500,3648594985,92.36,7.64
206,Newburyport,2011,3361665168,263374500,3625039668,92.73,7.27
206,Newburyport,2012,3289609559,282282000,3571891559,92.1,7.9
206,Newburyport,2013,3254839872,280133500,3534973372,92.08,7.92
206,Newburyport,2014,3292217611,333243100,3625460711,90.81,9.19
206,Newburyport,2015,3608068142,369976600,3978044742,90.7,9.3
206,Newburyport,2016,3765130445,377377600,4142508045,90.89,9.11
207,Newton,2003,15017075200,1438661600,16455736800,91.26,8.74
207,Newton,2004,16825041600,1442531500,18267573100,92.1,7.9
207,Newton,2005,18854982400,1949126300,20804108700,90.63,9.37
207,Newton,2006,19866823700,2310710700,22177534400,89.58,10.42
207,Newton,2007,20667221900,2245600200,22912822100,90.2,9.8
207,Newton,2008,20457629500,2194850700,22652480200,90.31,9.69
207,Newton,2009,20714549200,2398440400,23112989600,89.62,10.38
207,Newton,2010,20487831700,2881861000,23369692700,87.67,12.33
207,Newton,2011,20232810000,2882861200,23115671200,87.53,12.47
207,Newton,2012,20463999400,3322897700,23786897100,86.03,13.97
207,Newton,2013,20645306200,3272069000,23917375200,86.32,13.68
207,Newton,2014,20962189800,3350242400,24312432200,86.22,13.78
207,Newton,2015,22665105200,3507987000,26173092200,86.6,13.4
207,Newton,2016,24321818000,3661899100,27983717100,86.91,13.09
208,Norfolk,2003,1046235082,70687800,1116922882,93.67,6.33
208,Norfolk,2004,1201670905,92932300,1294603205,92.82,7.18
208,Norfolk,2005,1239305940,98971400,1338277340,92.6,7.4
208,Norfolk,2006,1430985027,107159300,1538144327,93.03,6.97
208,Norfolk,2007,1553492859,95228250,1648721109,94.22,5.78
208,Norfolk,2008,1512449163,88420650,1600869813,94.48,5.52
208,Norfolk,2009,1467942722,87668950,1555611672,94.36,5.64
208,Norfolk,2010,1501202458,95060925,1596263383,94.04,5.96
208,Norfolk,2011,1448598429,94577925,1543176354,93.87,6.13
208,Norfolk,2012,1455660228,95423825,1551084053,93.85,6.15
208,Norfolk,2013,1465419800,93848700,1559268500,93.98,6.02
208,Norfolk,2014,1490683450,93097600,1583781050,94.12,5.88
208,Norfolk,2015,1537948480,92777000,1630725480,94.31,5.69
208,Norfolk,2016,1590992453,137933000,1728925453,92.02,7.98
209,North Adams,2003,445769750,119890300,565660050,78.81,21.19
209,North Adams,2004,507115772,129332800,636448572,79.68,20.32
209,North Adams,2005,553363255,133470400,686833655,80.57,19.43
209,North Adams,2006,598703101,136571800,735274901,81.43,18.57
209,North Adams,2007,659151904,176728150,835880054,78.86,21.14
209,North Adams,2008,722842694,176988350,899831044,80.33,19.67
209,North Adams,2009,731941734,179638150,911579884,80.29,19.71
209,North Adams,2010,727183465,183092800,910276265,79.89,20.11
209,North Adams,2011,714355943,180661750,895017693,79.81,20.19
209,North Adams,2012,705835314,185318950,891154264,79.2,20.8
209,North Adams,2013,710245944,186556550,896802494,79.2,20.8
209,North Adams,2014,714340528,186724350,901064878,79.28,20.72
209,North Adams,2015,712068051,196750450,908818501,78.35,21.65
209,North Adams,2016,709233263,203219800,912453063,77.73,22.27
210,North Andover,2003,3068249244,155259100,3223508344,95.18,4.82
210,North Andover,2004,3726771550,192225600,3918997150,95.1,4.9
210,North Andover,2005,3931306809,195635200,4126942009,95.26,4.74
210,North Andover,2006,4240774030,338185900,4578959930,92.61,7.39
210,North Andover,2007,4651633109,384614400,5036247509,92.36,7.64
210,North Andover,2008,4534465467,387412300,4921877767,92.13,7.87
210,North Andover,2009,4455123530,391958100,4847081630,91.91,8.09
210,North Andover,2010,4233059057,422961000,4656020057,90.92,9.08
210,North Andover,2011,4121551610,416386500,4537938110,90.82,9.18
210,North Andover,2012,4145028195,416922600,4561950795,90.86,9.14
210,North Andover,2013,4269634302,419518600,4689152902,91.05,8.95
210,North Andover,2014,4208289380,425433000,4633722380,90.82,9.18
210,North Andover,2015,4294276090,426874700,4721150790,90.96,9.04
210,North Andover,2016,4459036465,429172800,4888209265,91.22,8.78
211,North Attleborough,2003,2290697517,115839100,2406536617,95.19,4.81
211,North Attleborough,2004,2361297354,116495700,2477793054,95.3,4.7
211,North Attleborough,2005,3413482090,190643300,3604125390,94.71,5.29
211,North Attleborough,2006,3701017030,204067500,3905084530,94.77,5.23
211,North Attleborough,2007,4131853820,218075300,4349929120,94.99,5.01
211,North Attleborough,2008,4065770580,228037500,4293808080,94.69,5.31
211,North Attleborough,2009,3878405640,226422700,4104828340,94.48,5.52
211,North Attleborough,2010,3749081100,229543100,3978624200,94.23,5.77
211,North Attleborough,2011,3447059590,213088600,3660148190,94.18,5.82
211,North Attleborough,2012,3377129350,210649000,3587778350,94.13,5.87
211,North Attleborough,2013,3355237890,215198000,3570435890,93.97,6.03
211,North Attleborough,2014,3344985160,234369100,3579354260,93.45,6.55
211,North Attleborough,2015,3486909730,236825700,3723735430,93.64,6.36
211,North Attleborough,2016,3575099940,238980000,3814079940,93.73,6.27
212,North Brookfield,2003,224337315,29102686,253440001,88.52,11.48
212,North Brookfield,2004,325151926,39489494,364641420,89.17,10.83
212,North Brookfield,2005,331797365,39417494,371214859,89.38,10.62
212,North Brookfield,2006,384286300,55537530,439823830,87.37,12.63
212,North Brookfield,2007,441009485,52711656,493721141,89.32,10.68
212,North Brookfield,2008,447940123,52599524,500539647,89.49,10.51
212,North Brookfield,2009,441148873,54037324,495186197,89.09,10.91
212,North Brookfield,2010,393045412,50414226,443459638,88.63,11.37
212,North Brookfield,2011,394051021,50663600,444714621,88.61,11.39
212,North Brookfield,2012,393895875,51124300,445020175,88.51,11.49
212,North Brookfield,2013,379287101,50362800,429649901,88.28,11.72
212,North Brookfield,2014,378662601,50325100,428987701,88.27,11.73
212,North Brookfield,2015,381991427,50629400,432620827,88.3,11.7
212,North Brookfield,2016,379845736,50310900,430156636,88.3,11.7
213,North Reading,2003,1844112300,129801700,1973914000,93.42,6.58
213,North Reading,2004,1987040180,135799400,2122839580,93.6,6.4
213,North Reading,2005,2322009625,153758800,2475768425,93.79,6.21
213,North Reading,2006,2531891796,171810900,2703702696,93.65,6.35
213,North Reading,2007,2697393714,204859100,2902252814,92.94,7.06
213,North Reading,2008,2682545958,202756200,2885302158,92.97,7.03
213,North Reading,2009,2692926342,201646100,2894572442,93.03,6.97
213,North Reading,2010,2504171881,192595300,2696767181,92.86,7.14
213,North Reading,2011,2492221503,183620200,2675841703,93.14,6.86
213,North Reading,2012,2506423743,184133600,2690557343,93.16,6.84
213,North Reading,2013,2522395996,183516400,2705912396,93.22,6.78
213,North Reading,2014,2545050909,206744000,2751794909,92.49,7.51
213,North Reading,2015,2670407016,279640500,2950047516,90.52,9.48
213,North Reading,2016,2792045352,337903000,3129948352,89.2,10.8
214,Northampton,2003,1769407280,727353220,2496760500,70.87,29.13
214,Northampton,2004,2280558792,745113551,3025672343,75.37,24.63
214,Northampton,2005,2472900492,745409510,3218310002,76.84,23.16
214,Northampton,2006,2782907866,751565950,3534473816,78.74,21.26
214,Northampton,2007,3160088517,807597263,3967685780,79.65,20.35
214,Northampton,2008,3193586550,817438300,4011024850,79.62,20.38
214,Northampton,2009,3240189100,830582230,4070771330,79.6,20.4
214,Northampton,2010,3193555130,939324420,4132879550,77.27,22.73
214,Northampton,2011,3212731690,940056740,4152788430,77.36,22.64
214,Northampton,2012,3237899790,935743800,4173643590,77.58,22.42
214,Northampton,2013,3182919482,952816547,4135736029,76.96,23.04
214,Northampton,2014,3214023380,942893870,4156917250,77.32,22.68
214,Northampton,2015,3259044078,939342100,4198386178,77.63,22.37
214,Northampton,2016,3288386760,926885287,4215272047,78.01,21.99
215,Northborough,2003,1504004730,68354600,1572359330,95.65,4.35
215,Northborough,2004,1973677990,84605000,2058282990,95.89,4.11
215,Northborough,2005,2070312410,94254700,2164567110,95.65,4.35
215,Northborough,2006,2339091220,97107900,2436199120,96.01,3.99
215,Northborough,2007,2481010960,129891300,2610902260,95.03,4.97
215,Northborough,2008,2454835590,130236400,2585071990,94.96,5.04
215,Northborough,2009,2488343970,136280500,2624624470,94.81,5.19
215,Northborough,2010,2478455470,134374600,2612830070,94.86,5.14
215,Northborough,2011,2428566150,131568800,2560134950,94.86,5.14
215,Northborough,2012,2479195500,135828200,2615023700,94.81,5.19
215,Northborough,2013,2491837878,146216467,2638054345,94.46,5.54
215,Northborough,2014,2491498419,149319600,2640818019,94.35,5.65
215,Northborough,2015,2568865746,195205500,2764071246,92.94,7.06
215,Northborough,2016,2624863105,190144900,2815008005,93.25,6.75
216,Northbridge,2003,864758878,45050700,909809578,95.05,4.95
216,Northbridge,2004,896839255,45630800,942470055,95.16,4.84
216,Northbridge,2005,1383429595,84384900,1467814495,94.25,5.75
216,Northbridge,2006,1562768157,91295700,1654063857,94.48,5.52
216,Northbridge,2007,1636710426,91643600,1728354026,94.7,5.3
216,Northbridge,2008,1716974557,154512100,1871486657,91.74,8.26
216,Northbridge,2009,1615415401,155498100,1770913501,91.22,8.78
216,Northbridge,2010,1535937499,153543700,1689481199,90.91,9.09
216,Northbridge,2011,1420932164,146402000,1567334164,90.66,9.34
216,Northbridge,2012,1401738620,147040500,1548779120,90.51,9.49
216,Northbridge,2013,1405028550,146685000,1551713550,90.55,9.45
216,Northbridge,2014,1410998190,144839600,1555837790,90.69,9.31
216,Northbridge,2015,1424744520,144621800,1569366320,90.78,9.22
216,Northbridge,2016,1448080087,145134700,1593214787,90.89,9.11
217,Northfield,2003,255619615,52616400,308236015,82.93,17.07
217,Northfield,2004,289986871,67069000,357055871,81.22,18.78
217,Northfield,2005,311453557,68465000,379918557,81.98,18.02
217,Northfield,2006,349151608,80816300,429967908,81.2,18.8
217,Northfield,2007,364129387,82642900,446772287,81.5,18.5
217,Northfield,2008,385205320,87241400,472446720,81.53,18.47
217,Northfield,2009,394626414,74621200,469247614,84.1,15.9
217,Northfield,2010,394118313,76330600,470448913,83.77,16.23
217,Northfield,2011,425078438,48296500,473374938,89.8,10.2
217,Northfield,2012,424800243,48475600,473275843,89.76,10.24
217,Northfield,2013,408107656,47628100,455735756,89.55,10.45
217,Northfield,2014,409229674,47593400,456823074,89.58,10.42
217,Northfield,2015,408847724,47747900,456595624,89.54,10.46
217,Northfield,2016,454269875,47876300,502146175,90.47,9.53
218,Norton,2003,1570154550,279314900,1849469450,84.9,15.1
218,Norton,2004,1619865960,283605000,1903470960,85.1,14.9
218,Norton,2005,1899622680,293503400,2193126080,86.62,13.38
218,Norton,2006,2250414090,348325600,2598739690,86.6,13.4
218,Norton,2007,2299353010,350331000,2649684010,86.78,13.22
218,Norton,2008,2340271900,352536900,2692808800,86.91,13.09
218,Norton,2009,2245701070,399435500,2645136570,84.9,15.1
218,Norton,2010,2207532780,360511300,2568044080,85.96,14.04
218,Norton,2011,2093673010,349243100,2442916110,85.7,14.3
218,Norton,2012,2027439820,353818500,2381258320,85.14,14.86
218,Norton,2013,1947302820,356795400,2304098220,84.51,15.49
218,Norton,2014,1945738860,357239500,2302978360,84.49,15.51
218,Norton,2015,2029791340,367553100,2397344440,84.67,15.33
218,Norton,2016,2085583620,365136100,2450719720,85.1,14.9
219,Norwell,2003,1721671500,134023600,1855695100,92.78,7.22
219,Norwell,2004,1753233060,133823500,1887056560,92.91,7.09
219,Norwell,2005,2152320360,156220700,2308541060,93.23,6.77
219,Norwell,2006,2337320090,170834900,2508154990,93.19,6.81
219,Norwell,2007,2502459880,176881600,2679341480,93.4,6.6
219,Norwell,2008,2506442599,182570600,2689013199,93.21,6.79
219,Norwell,2009,2496327447,201340900,2697668347,92.54,7.46
219,Norwell,2010,2370357847,195818600,2566176447,92.37,7.63
219,Norwell,2011,2237971858,181842900,2419814758,92.49,7.51
219,Norwell,2012,2243843430,174299700,2418143130,92.79,7.21
219,Norwell,2013,2220753335,175189400,2395942735,92.69,7.31
219,Norwell,2014,2246653035,171298200,2417951235,92.92,7.08
219,Norwell,2015,2348572637,173438800,2522011437,93.12,6.88
219,Norwell,2016,2434057591,173542900,2607600491,93.34,6.66
220,Norwood,2003,3389619800,203248600,3592868400,94.34,5.66
220,Norwood,2004,3378006320,186949700,3564956020,94.76,5.24
220,Norwood,2005,3931760850,200460300,4132221150,95.15,4.85
220,Norwood,2006,4335072110,204055300,4539127410,95.5,4.5
220,Norwood,2007,4384742810,203887600,4588630410,95.56,4.44
220,Norwood,2008,4438793050,221440400,4660233450,95.25,4.75
220,Norwood,2009,4540126220,295348100,4835474320,93.89,6.11
220,Norwood,2010,4368997490,293438600,4662436090,93.71,6.29
220,Norwood,2011,4261458120,291781300,4553239420,93.59,6.41
220,Norwood,2012,4249302900,224208700,4473511600,94.99,5.01
220,Norwood,2013,4245656320,227712340,4473368660,94.91,5.09
220,Norwood,2014,4215048740,226981640,4442030380,94.89,5.11
220,Norwood,2015,4358017600,228923940,4586941540,95.01,4.99
220,Norwood,2016,4716133522,261616600,4977750122,94.74,5.26
221,Oak Bluffs,2003,1732300886,151664100,1883964986,91.95,8.05
221,Oak Bluffs,2004,2046869602,164718900,2211588502,92.55,7.45
221,Oak Bluffs,2005,2372234985,196273800,2568508785,92.36,7.64
221,Oak Bluffs,2006,2639483639,216166500,2855650139,92.43,7.57
221,Oak Bluffs,2007,2816473295,236471700,3052944995,92.25,7.75
221,Oak Bluffs,2008,2899259238,247885800,3147145038,92.12,7.88
221,Oak Bluffs,2009,2917645889,249911000,3167556889,92.11,7.89
221,Oak Bluffs,2010,2873709066,251951800,3125660866,91.94,8.06
221,Oak Bluffs,2011,2647611904,256679400,2904291304,91.16,8.84
221,Oak Bluffs,2012,2581134119,273889840,2855023959,90.41,9.59
221,Oak Bluffs,2013,2512650457,273902540,2786552997,90.17,9.83
221,Oak Bluffs,2014,2522434290,281027340,2803461630,89.98,10.02
221,Oak Bluffs,2015,2550305440,292611300,2842916740,89.71,10.29
221,Oak Bluffs,2016,2671835130,307098200,2978933330,89.69,10.31
222,Oakham,2003,117112172,12620600,129732772,90.27,9.73
222,Oakham,2004,120891598,12620600,133512198,90.55,9.45
222,Oakham,2005,171116758,14578600,185695358,92.15,7.85
222,Oakham,2006,185579493,14843600,200423093,92.59,7.41
222,Oakham,2007,213378581,15392800,228771381,93.27,6.73
222,Oakham,2008,217855682,26154800,244010482,89.28,10.72
222,Oakham,2009,220677862,26100000,246777862,89.42,10.58
222,Oakham,2010,203372895,25463400,228836295,88.87,11.13
222,Oakham,2011,199665641,24153000,223818641,89.21,10.79
222,Oakham,2012,200329901,24157000,224486901,89.24,10.76
222,Oakham,2013,194960984,24184800,219145784,88.96,11.04
222,Oakham,2014,190516976,25578400,216095376,88.16,11.84
222,Oakham,2015,190596917,26136300,216733217,87.94,12.06
222,Oakham,2016,190647859,26093600,216741459,87.96,12.04
223,Orange,2003,302925742,38850606,341776348,88.63,11.37
223,Orange,2004,330142039,43591215,373733254,88.34,11.66
223,Orange,2005,426015123,50496558,476511681,89.4,10.6
223,Orange,2006,450187147,49271930,499459077,90.13,9.87
223,Orange,2007,461777505,49567930,511345435,90.31,9.69
223,Orange,2008,555879411,55162144,611041555,90.97,9.03
223,Orange,2009,562848286,55090344,617938630,91.08,8.92
223,Orange,2010,530615533,55837544,586453077,90.48,9.52
223,Orange,2011,510465881,53114675,563580556,90.58,9.42
223,Orange,2012,493398690,53146236,546544926,90.28,9.72
223,Orange,2013,478232407,52829546,531061953,90.05,9.95
223,Orange,2014,476028321,53572619,529600940,89.88,10.12
223,Orange,2015,475479370,54459445,529938815,89.72,10.28
223,Orange,2016,473091024,48158820,521249844,90.76,9.24
224,Orleans,2003,2512449131,266695600,2779144731,90.4,9.6
224,Orleans,2004,3128390680,299706600,3428097280,91.26,8.74
224,Orleans,2005,3336135215,311969900,3648105115,91.45,8.55
224,Orleans,2006,3815209270,312506300,4127715570,92.43,7.57
224,Orleans,2007,3847189360,320539700,4167729060,92.31,7.69
224,Orleans,2008,3927447430,329058500,4256505930,92.27,7.73
224,Orleans,2009,3887216150,336544300,4223760450,92.03,7.97
224,Orleans,2010,3783860990,270997600,4054858590,93.32,6.68
224,Orleans,2011,3606895340,239197600,3846092940,93.78,6.22
224,Orleans,2012,3600380540,238946600,3839327140,93.78,6.22
224,Orleans,2013,3551020140,241077500,3792097640,93.64,6.36
224,Orleans,2014,3592510500,225967200,3818477700,94.08,5.92
224,Orleans,2015,3614838220,230760100,3845598320,94,6
224,Orleans,2016,3727103110,236510900,3963614010,94.03,5.97
225,Otis,2003,272475788,15308700,287784488,94.68,5.32
225,Otis,2004,379344699,21106400,400451099,94.73,5.27
225,Otis,2005,385669663,21616100,407285763,94.69,5.31
225,Otis,2006,522922581,26623700,549546281,95.16,4.84
225,Otis,2007,535922165,32366800,568288965,94.3,5.7
225,Otis,2008,544970383,32366800,577337183,94.39,5.61
225,Otis,2009,599788996,32195700,631984696,94.91,5.09
225,Otis,2010,606048721,33955200,640003921,94.69,5.31
225,Otis,2011,617815241,32950300,650765541,94.94,5.06
225,Otis,2012,621529881,33356100,654885981,94.91,5.09
225,Otis,2013,604205990,31376800,635582790,95.06,4.94
225,Otis,2014,606011575,33598500,639610075,94.75,5.25
225,Otis,2015,611854055,33890100,645744155,94.75,5.25
225,Otis,2016,608324038,32896300,641220338,94.87,5.13
226,Oxford,2003,765019700,59913900,824933600,92.74,7.26
226,Oxford,2004,859587295,65510414,925097709,92.92,7.08
226,Oxford,2005,1136262805,103863556,1240126361,91.62,8.38
226,Oxford,2006,1239175997,102370301,1341546298,92.37,7.63
226,Oxford,2007,1354080993,96340901,1450421894,93.36,6.64
226,Oxford,2008,1425111710,94657923,1519769633,93.77,6.23
226,Oxford,2009,1457936910,94645823,1552582733,93.9,6.1
226,Oxford,2010,1344836010,93444223,1438280233,93.5,6.5
226,Oxford,2011,1311854490,116384943,1428239433,91.85,8.15
226,Oxford,2012,1279510710,115677323,1395188033,91.71,8.29
226,Oxford,2013,1269981585,115619223,1385600808,91.66,8.34
226,Oxford,2014,1283501235,116648823,1400150058,91.67,8.33
226,Oxford,2015,1265007135,100873605,1365880740,92.61,7.39
226,Oxford,2016,1273705685,100972105,1374677790,92.65,7.35
227,Palmer,2003,596864957,90959900,687824857,86.78,13.22
227,Palmer,2004,721332062,98008600,819340662,88.04,11.96
227,Palmer,2005,818640683,106959434,925600117,88.44,11.56
227,Palmer,2006,901212742,112040840,1013253582,88.94,11.06
227,Palmer,2007,999680194,117654840,1117335034,89.47,10.53
227,Palmer,2008,1041655651,129007605,1170663256,88.98,11.02
227,Palmer,2009,1012035013,129111700,1141146713,88.69,11.31
227,Palmer,2010,974776965,129250995,1104027960,88.29,11.71
227,Palmer,2011,952305331,137581830,1089887161,87.38,12.62
227,Palmer,2012,952383423,138909330,1091292753,87.27,12.73
227,Palmer,2013,920606916,140991650,1061598566,86.72,13.28
227,Palmer,2014,880072824,135450525,1015523349,86.66,13.34
227,Palmer,2015,884864559,139053925,1023918484,86.42,13.58
227,Palmer,2016,886063743,138583525,1024647268,86.48,13.52
228,Paxton,2003,302676875,31491200,334168075,90.58,9.42
228,Paxton,2004,451993034,39430000,491423034,91.98,8.02
228,Paxton,2005,486550573,36447300,522997873,93.03,6.97
228,Paxton,2006,520195554,36851500,557047054,93.38,6.62
228,Paxton,2007,578747860,61244300,639992160,90.43,9.57
228,Paxton,2008,582459247,62651900,645111147,90.29,9.71
228,Paxton,2009,539663779,61809100,601472879,89.72,10.28
228,Paxton,2010,502477792,66130800,568608592,88.37,11.63
228,Paxton,2011,478147257,64676300,542823557,88.09,11.91
228,Paxton,2012,461697906,73573300,535271206,86.25,13.75
228,Paxton,2013,450155265,74457300,524612565,85.81,14.19
228,Paxton,2014,430501964,70073000,500574964,86,14
228,Paxton,2015,440916367,69091811,510008178,86.45,13.55
228,Paxton,2016,458470103,69160011,527630114,86.89,13.11
229,Peabody,2003,5048202250,490935100,5539137350,91.14,8.86
229,Peabody,2004,6314428610,625973700,6940402310,90.98,9.02
229,Peabody,2005,6375586460,643969900,7019556360,90.83,9.17
229,Peabody,2006,7245123250,718600400,7963723650,90.98,9.02
229,Peabody,2007,7549423760,738925300,8288349060,91.08,8.92
229,Peabody,2008,7136426760,766102800,7902529560,90.31,9.69
229,Peabody,2009,6984819650,788847100,7773666750,89.85,10.15
229,Peabody,2010,6391562930,694025800,7085588730,90.21,9.79
229,Peabody,2011,6074417320,640741200,6715158520,90.46,9.54
229,Peabody,2012,6061106938,649515992,6710622930,90.32,9.68
229,Peabody,2013,6169929127,671651883,6841581010,90.18,9.82
229,Peabody,2014,6111744857,686829083,6798573940,89.9,10.1
229,Peabody,2015,6405331408,674781082,7080112490,90.47,9.53
229,Peabody,2016,6750057897,671496833,7421554730,90.95,9.05
230,Pelham,2003,103607700,10587900,114195600,90.73,9.27
230,Pelham,2004,112372600,10884300,123256900,91.17,8.83
230,Pelham,2005,136382800,16485100,152867900,89.22,10.78
230,Pelham,2006,138323900,16565900,154889800,89.3,10.7
230,Pelham,2007,154370900,16515300,170886200,90.34,9.66
230,Pelham,2008,166436500,29083200,195519700,85.13,14.87
230,Pelham,2009,175691400,29487200,205178600,85.63,14.37
230,Pelham,2010,177889700,37955300,215845000,82.42,17.58
230,Pelham,2011,178063400,37626200,215689600,82.56,17.44
230,Pelham,2012,169852600,33254200,203106800,83.63,16.37
230,Pelham,2013,169475900,29127100,198603000,85.33,14.67
230,Pelham,2014,169603580,29134400,198737980,85.34,14.66
230,Pelham,2015,171729100,28549000,200278100,85.75,14.25
230,Pelham,2016,172092900,28615400,200708300,85.74,14.26
231,Pembroke,2003,1716609961,145608100,1862218061,92.18,7.82
231,Pembroke,2004,1926114049,163763880,2089877929,92.16,7.84
231,Pembroke,2005,2307147444,175569800,2482717244,92.93,7.07
231,Pembroke,2006,2447162516,171051900,2618214416,93.47,6.53
231,Pembroke,2007,2625262960,181616340,2806879300,93.53,6.47
231,Pembroke,2008,2602902617,198292820,2801195437,92.92,7.08
231,Pembroke,2009,2522324846,200048300,2722373146,92.65,7.35
231,Pembroke,2010,2344020669,192521240,2536541909,92.41,7.59
231,Pembroke,2011,2309513567,180242140,2489755707,92.76,7.24
231,Pembroke,2012,2302688995,179886700,2482575695,92.75,7.25
231,Pembroke,2013,2295433196,184892780,2480325976,92.55,7.45
231,Pembroke,2014,2292580802,182698700,2475279502,92.62,7.38
231,Pembroke,2015,2372469282,184526840,2556996122,92.78,7.22
231,Pembroke,2016,2451943308,191214360,2643157668,92.77,7.23
232,Pepperell,2003,828108931,38093900,866202831,95.6,4.4
232,Pepperell,2004,841153994,54242200,895396194,93.94,6.06
232,Pepperell,2005,1151003077,66717400,1217720477,94.52,5.48
232,Pepperell,2006,1170550361,70152900,1240703261,94.35,5.65
232,Pepperell,2007,1273622914,73547300,1347170214,94.54,5.46
232,Pepperell,2008,1317106594,79981100,1397087694,94.28,5.72
232,Pepperell,2009,1259157382,79797600,1338954982,94.04,5.96
232,Pepperell,2010,1177137008,79709400,1256846408,93.66,6.34
232,Pepperell,2011,1160408435,78026500,1238434935,93.7,6.3
232,Pepperell,2012,1155108333,77356900,1232465233,93.72,6.28
232,Pepperell,2013,1113211013,76536900,1189747913,93.57,6.43
232,Pepperell,2014,1075504228,83593800,1159098028,92.79,7.21
232,Pepperell,2015,1101391636,84088300,1185479936,92.91,7.09
232,Pepperell,2016,1112450298,82335600,1194785898,93.11,6.89
233,Peru,2003,46878900,5293900,52172800,89.85,10.15
233,Peru,2004,48504739,5298400,53803139,90.15,9.85
233,Peru,2005,58777129,7555000,66332129,88.61,11.39
233,Peru,2006,64691141,7694800,72385941,89.37,10.63
233,Peru,2007,69156841,10386900,79543741,86.94,13.06
233,Peru,2008,87612827,9091500,96704327,90.6,9.4
233,Peru,2009,86813963,9255400,96069363,90.37,9.63
233,Peru,2010,85669458,9550100,95219558,89.97,10.03
233,Peru,2011,92318732,10200900,102519632,90.05,9.95
233,Peru,2012,89087687,10318000,99405687,89.62,10.38
233,Peru,2013,88424179,10275900,98700079,89.59,10.41
233,Peru,2014,88779074,11716400,100495474,88.34,11.66
233,Peru,2015,85794796,10630400,96425196,88.98,11.02
233,Peru,2016,86345909,10642000,96987909,89.03,10.97
234,Petersham,2003,91433200,31135800,122569000,74.6,25.4
234,Petersham,2004,128350980,37822900,166173880,77.24,22.76
234,Petersham,2005,130299040,46712600,177011640,73.61,26.39
234,Petersham,2006,140968710,49648000,190616710,73.95,26.05
234,Petersham,2007,164758098,58567670,223325768,73.77,26.23
234,Petersham,2008,159758914,54648870,214407784,74.51,25.49
234,Petersham,2009,156439387,55693870,212133257,73.75,26.25
234,Petersham,2010,154027076,51832800,205859876,74.82,25.18
234,Petersham,2011,150058296,51789200,201847496,74.34,25.66
234,Petersham,2012,144324621,47124000,191448621,75.39,24.61
234,Petersham,2013,145612278,53983000,199595278,72.95,27.05
234,Petersham,2014,146446980,54628700,201075680,72.83,27.17
234,Petersham,2015,147820467,54884300,202704767,72.92,27.08
234,Petersham,2016,148656542,57279200,205935742,72.19,27.81
235,Phillipston,2003,94140553,7348700,101489253,92.76,7.24
235,Phillipston,2004,138665355,9892800,148558155,93.34,6.66
235,Phillipston,2005,160449111,10244600,170693711,94,6
235,Phillipston,2006,195524970,11542300,207067270,94.43,5.57
235,Phillipston,2007,215602077,13468400,229070477,94.12,5.88
235,Phillipston,2008,211244119,13069500,224313619,94.17,5.83
235,Phillipston,2009,214174977,13648000,227822977,94.01,5.99
235,Phillipston,2010,206810893,13130800,219941693,94.03,5.97
235,Phillipston,2011,198546486,13445500,211991986,93.66,6.34
235,Phillipston,2012,187506055,13328300,200834355,93.36,6.64
235,Phillipston,2013,184485525,13844300,198329825,93.02,6.98
235,Phillipston,2014,184520599,14851400,199371999,92.55,7.45
235,Phillipston,2015,185345625,15004700,200350325,92.51,7.49
235,Phillipston,2016,182080026,13323900,195403926,93.18,6.82
236,Pittsfield,2003,2085947159,455514407,2541461566,82.08,17.92
236,Pittsfield,2004,2103598224,468260138,2571858362,81.79,18.21
236,Pittsfield,2005,2767583665,574841746,3342425411,82.8,17.2
236,Pittsfield,2006,2817739288,575151556,3392890844,83.05,16.95
236,Pittsfield,2007,3116793990,568901926,3685695916,84.56,15.44
236,Pittsfield,2008,3434227450,595523146,4029750596,85.22,14.78
236,Pittsfield,2009,3454552912,607921986,4062474898,85.04,14.96
236,Pittsfield,2010,3472586080,619780140,4092366220,84.86,15.14
236,Pittsfield,2011,3441486470,727966130,4169452600,82.54,17.46
236,Pittsfield,2012,3364529748,706144731,4070674479,82.65,17.35
236,Pittsfield,2013,3341803760,691425341,4033229101,82.86,17.14
236,Pittsfield,2014,3344485910,702821990,4047307900,82.63,17.37
236,Pittsfield,2015,3331646372,703459301,4035105673,82.57,17.43
236,Pittsfield,2016,3343164997,704176631,4047341628,82.6,17.4
237,Plainfield,2003,54507135,5478800,59985935,90.87,9.13
237,Plainfield,2004,54724542,5470700,60195242,90.91,9.09
237,Plainfield,2005,70003229,6385700,76388929,91.64,8.36
237,Plainfield,2006,80298877,9154400,89453277,89.77,10.23
237,Plainfield,2007,80416694,8631500,89048194,90.31,9.69
237,Plainfield,2008,79633284,9220800,88854084,89.62,10.38
237,Plainfield,2009,86356743,10259000,96615743,89.38,10.62
237,Plainfield,2010,84464941,10626500,95091441,88.82,11.18
237,Plainfield,2011,87173812,10124400,97298212,89.59,10.41
237,Plainfield,2012,75877867,10131400,86009267,88.22,11.78
237,Plainfield,2013,73755636,10503300,84258936,87.53,12.47
237,Plainfield,2014,80224176,11027600,91251776,87.92,12.08
237,Plainfield,2015,83001051,10978400,93979451,88.32,11.68
237,Plainfield,2016,85072947,10383800,95456747,89.12,10.88
238,Plainville,2003,718827200,39229900,758057100,94.82,5.18
238,Plainville,2004,733862280,39406300,773268580,94.9,5.1
238,Plainville,2005,873380460,44109300,917489760,95.19,4.81
238,Plainville,2006,1109123730,61671600,1170795330,94.73,5.27
238,Plainville,2007,1172208160,62707900,1234916060,94.92,5.08
238,Plainville,2008,1191071010,64679500,1255750510,94.85,5.15
238,Plainville,2009,1206628902,79236400,1285865302,93.84,6.16
238,Plainville,2010,1178214572,78698600,1256913172,93.74,6.26
238,Plainville,2011,1124849472,76530000,1201379472,93.63,6.37
238,Plainville,2012,1131470972,76536100,1208007072,93.66,6.34
238,Plainville,2013,1137158342,74802300,1211960642,93.83,6.17
238,Plainville,2014,1162787772,74802300,1237590072,93.96,6.04
238,Plainville,2015,1176304872,75280800,1251585672,93.99,6.01
238,Plainville,2016,1298251972,81994300,1380246272,94.06,5.94
239,Plymouth,2003,6398626890,588789400,6987416290,91.57,8.43
239,Plymouth,2004,7331685422,624292985,7955978407,92.15,7.85
239,Plymouth,2005,8391775064,658684110,9050459174,92.72,7.28
239,Plymouth,2006,9460476381,768399810,10228876191,92.49,7.51
239,Plymouth,2007,9952893947,792264410,10745158357,92.63,7.37
239,Plymouth,2008,9767007525,798709810,10565717335,92.44,7.56
239,Plymouth,2009,9619059316,780924910,10399984226,92.49,7.51
239,Plymouth,2010,8987624130,761123384,9748747514,92.19,7.81
239,Plymouth,2011,8829548161,759901784,9589449945,92.08,7.92
239,Plymouth,2012,8826060115,777698384,9603758499,91.9,8.1
239,Plymouth,2013,8612224368,809403184,9421627552,91.41,8.59
239,Plymouth,2014,8602771227,790640884,9393412111,91.58,8.42
239,Plymouth,2015,8908873083,789468964,9698342047,91.86,8.14
239,Plymouth,2016,9128500223,802438784,9930939007,91.92,8.08
240,Plympton,2003,269756868,6723000,276479868,97.57,2.43
240,Plympton,2004,273472033,6973600,280445633,97.51,2.49
240,Plympton,2005,367943654,16241500,384185154,95.77,4.23
240,Plympton,2006,394785739,16278300,411064039,96.04,3.96
240,Plympton,2007,406925119,16278300,423203419,96.15,3.85
240,Plympton,2008,449811384,17726800,467538184,96.21,3.79
240,Plympton,2009,430449624,16356300,446805924,96.34,3.66
240,Plympton,2010,379236180,13449700,392685880,96.57,3.43
240,Plympton,2011,366820880,13277300,380098180,96.51,3.49
240,Plympton,2012,367812130,13214400,381026530,96.53,3.47
240,Plympton,2013,400497330,13588600,414085930,96.72,3.28
240,Plympton,2014,479861916,17883100,497745016,96.41,3.59
240,Plympton,2015,477978188,17285700,495263888,96.51,3.49
240,Plympton,2016,480775399,17462200,498237599,96.5,3.5
241,Princeton,2003,366541926,35513600,402055526,91.17,8.83
241,Princeton,2004,407429370,43723400,451152770,90.31,9.69
241,Princeton,2005,446591452,71050500,517641952,86.27,13.73
241,Princeton,2006,490764577,46608000,537372577,91.33,8.67
241,Princeton,2007,517603774,47600100,565203874,91.58,8.42
241,Princeton,2008,522109391,47039700,569149091,91.74,8.26
241,Princeton,2009,506215857,63669900,569885757,88.83,11.17
241,Princeton,2010,472906740,61119300,534026040,88.55,11.45
241,Princeton,2011,437948219,57334800,495283019,88.42,11.58
241,Princeton,2012,435891323,59057900,494949223,88.07,11.93
241,Princeton,2013,437841570,59057900,496899470,88.11,11.89
241,Princeton,2014,438769329,58871600,497640929,88.17,11.83
241,Princeton,2015,438770837,59322000,498092837,88.09,11.91
241,Princeton,2016,447855714,60288100,508143814,88.14,11.86
242,Provincetown,2003,1721956925,177309000,1899265925,90.66,9.34
242,Provincetown,2004,1961131300,199296600,2160427900,90.78,9.22
242,Provincetown,2005,2079275560,222765400,2302040960,90.32,9.68
242,Provincetown,2006,2453048130,270310600,2723358730,90.07,9.93
242,Provincetown,2007,2597487070,277487500,2874974570,90.35,9.65
242,Provincetown,2008,2608614820,279106200,2887721020,90.33,9.67
242,Provincetown,2009,2551519000,220213900,2771732900,92.06,7.94
242,Provincetown,2010,2424304410,212423600,2636728010,91.94,8.06
242,Provincetown,2011,2262080810,197338400,2459419210,91.98,8.02
242,Provincetown,2012,2267431100,195486500,2462917600,92.06,7.94
242,Provincetown,2013,2296161150,193127000,2489288150,92.24,7.76
242,Provincetown,2014,2418213860,201846700,2620060560,92.3,7.7
242,Provincetown,2015,2460042340,210437600,2670479940,92.12,7.88
242,Provincetown,2016,2587438370,213828400,2801266770,92.37,7.63
243,Quincy,2003,7472782550,1475851800,8948634350,83.51,16.49
243,Quincy,2004,8761808480,1478660800,10240469280,85.56,14.44
243,Quincy,2005,10552438420,1874607300,12427045720,84.92,15.08
243,Quincy,2006,11308447140,1970083100,13278530240,85.16,14.84
243,Quincy,2007,11950933540,2037118200,13988051740,85.44,14.56
243,Quincy,2008,11740774030,1643339850,13384113880,87.72,12.28
243,Quincy,2009,11415923299,1659348300,13075271599,87.31,12.69
243,Quincy,2010,10850166720,1604275900,12454442620,87.12,12.88
243,Quincy,2011,10616310980,1509599400,12125910380,87.55,12.45
243,Quincy,2012,10608833560,1553998600,12162832160,87.22,12.78
243,Quincy,2013,10621950550,1497406200,12119356750,87.64,12.36
243,Quincy,2014,10679688930,1493092000,12172780930,87.73,12.27
243,Quincy,2015,11420498860,1571564100,12992062960,87.9,12.1
243,Quincy,2016,12019197110,1611201700,13630398810,88.18,11.82
244,Randolph,2003,2224337665,182980960,2407318625,92.4,7.6
244,Randolph,2004,2701327259,183235140,2884562399,93.65,6.35
244,Randolph,2005,3115323513,199101430,3314424943,93.99,6.01
244,Randolph,2006,3210307894,205497290,3415805184,93.98,6.02
244,Randolph,2007,3539606888,242472677,3782079565,93.59,6.41
244,Randolph,2008,3531872360,254706050,3786578410,93.27,6.73
244,Randolph,2009,3218079748,257132142,3475211890,92.6,7.4
244,Randolph,2010,3010194972,254715303,3264910275,92.2,7.8
244,Randolph,2011,2795144993,229917066,3025062059,92.4,7.6
244,Randolph,2012,2776852303,227679466,3004531769,92.42,7.58
244,Randolph,2013,2656219643,245496527,2901716170,91.54,8.46
244,Randolph,2014,2624204705,216278285,2840482990,92.39,7.61
244,Randolph,2015,2704238645,217726513,2921965158,92.55,7.45
244,Randolph,2016,2889883245,221717288,3111600533,92.87,7.13
245,Raynham,2003,1020528400,47521500,1068049900,95.55,4.45
245,Raynham,2004,1463116000,79424900,1542540900,94.85,5.15
245,Raynham,2005,1580755200,82106800,1662862000,95.06,4.94
245,Raynham,2006,1839005400,88636700,1927642100,95.4,4.6
245,Raynham,2007,2143159950,100799600,2243959550,95.51,4.49
245,Raynham,2008,2069265900,99665900,2168931800,95.4,4.6
245,Raynham,2009,1978898550,98318300,2077216850,95.27,4.73
245,Raynham,2010,1876908930,104526800,1981435730,94.72,5.28
245,Raynham,2011,1786169450,101134000,1887303450,94.64,5.36
245,Raynham,2012,1753579660,102773300,1856352960,94.46,5.54
245,Raynham,2013,1727263190,108473800,1835736990,94.09,5.91
245,Raynham,2014,1734652690,121212700,1855865390,93.47,6.53
245,Raynham,2015,1876363640,129417800,2005781440,93.55,6.45
245,Raynham,2016,1945571977,133451000,2079022977,93.58,6.42
246,Reading,2003,2837919090,157425000,2995344090,94.74,5.26
246,Reading,2004,3119970010,165633200,3285603210,94.96,5.04
246,Reading,2005,3362233820,173306200,3535540020,95.1,4.9
246,Reading,2006,3632720580,182704289,3815424869,95.21,4.79
246,Reading,2007,3785159436,231071427,4016230863,94.25,5.75
246,Reading,2008,3765110743,264214477,4029325220,93.44,6.56
246,Reading,2009,3719847937,271654721,3991502658,93.19,6.81
246,Reading,2010,3645760801,278340433,3924101234,92.91,7.09
246,Reading,2011,3747545877,268749000,4016294877,93.31,6.69
246,Reading,2012,3764013606,282194600,4046208206,93.03,6.97
246,Reading,2013,3686637528,282739300,3969376828,92.88,7.12
246,Reading,2014,3829312775,273937800,4103250575,93.32,6.68
246,Reading,2015,3999637753,280091200,4279728953,93.46,6.54
246,Reading,2016,4309708047,296484600,4606192647,93.56,6.44
247,Rehoboth,2003,875101500,35476300,910577800,96.1,3.9
247,Rehoboth,2004,1263963566,50191300,1314154866,96.18,3.82
247,Rehoboth,2005,1450321485,51173400,1501494885,96.59,3.41
247,Rehoboth,2006,1661476293,53138300,1714614593,96.9,3.1
247,Rehoboth,2007,1918922518,65479500,1984402018,96.7,3.3
247,Rehoboth,2008,1910870941,65011800,1975882741,96.71,3.29
247,Rehoboth,2009,1801754877,63313200,1865068077,96.61,3.39
247,Rehoboth,2010,1785749697,68019900,1853769597,96.33,3.67
247,Rehoboth,2011,1701555703,67077200,1768632903,96.21,3.79
247,Rehoboth,2012,1621995491,65987000,1687982491,96.09,3.91
247,Rehoboth,2013,1561566662,63898600,1625465262,96.07,3.93
247,Rehoboth,2014,1518823566,64911500,1583735066,95.9,4.1
247,Rehoboth,2015,1588106846,65334300,1653441146,96.05,3.95
247,Rehoboth,2016,1669652368,74289900,1743942268,95.74,4.26
248,Revere,2003,2700030951,232540500,2932571451,92.07,7.93
248,Revere,2004,2738429844,230738400,2969168244,92.23,7.77
248,Revere,2005,4185581651,260690760,4446272411,94.14,5.86
248,Revere,2006,4515704851,265195700,4780900551,94.45,5.55
248,Revere,2007,4781995565,278828000,5060823565,94.49,5.51
248,Revere,2008,5099571860,357581700,5457153560,93.45,6.55
248,Revere,2009,4746838255,357372200,5104210455,93,7
248,Revere,2010,4036076629,356921600,4392998229,91.88,8.12
248,Revere,2011,3812519660,355816500,4168336160,91.46,8.54
248,Revere,2012,3781124856,343714350,4124839206,91.67,8.33
248,Revere,2013,3769805531,347349750,4117155281,91.56,8.44
248,Revere,2014,3897467818,358820200,4256288018,91.57,8.43
248,Revere,2015,4265005981,389326550,4654332531,91.64,8.36
248,Revere,2016,4606033831,387044250,4993078081,92.25,7.75
249,Richmond,2003,251324440,15524000,266848440,94.18,5.82
249,Richmond,2004,260009162,15528894,275538056,94.36,5.64
249,Richmond,2005,311045724,20672000,331717724,93.77,6.23
249,Richmond,2006,359857179,24088000,383945179,93.73,6.27
249,Richmond,2007,435335207,29293900,464629107,93.7,6.3
249,Richmond,2008,436206032,22092800,458298832,95.18,4.82
249,Richmond,2009,435494792,23854600,459349392,94.81,5.19
249,Richmond,2010,438395389,23854600,462249989,94.84,5.16
249,Richmond,2011,440193324,24126900,464320224,94.8,5.2
249,Richmond,2012,414015015,22679600,436694615,94.81,5.19
249,Richmond,2013,418905222,23012100,441917322,94.79,5.21
249,Richmond,2014,421249215,23970300,445219515,94.62,5.38
249,Richmond,2015,407324412,31464400,438788812,92.83,7.17
249,Richmond,2016,409000588,31612000,440612588,92.83,7.17
250,Rochester,2003,426819508,50187000,477006508,89.48,10.52
250,Rochester,2004,437245340,51275300,488520640,89.5,10.5
250,Rochester,2005,737233060,77046100,814279160,90.54,9.46
250,Rochester,2006,758200158,79588900,837789058,90.5,9.5
250,Rochester,2007,877401100,88547400,965948500,90.83,9.17
250,Rochester,2008,896505794,92686500,989192294,90.63,9.37
250,Rochester,2009,870955978,97327200,968283178,89.95,10.05
250,Rochester,2010,823739500,84405100,908144600,90.71,9.29
250,Rochester,2011,825599680,83721300,909320980,90.79,9.21
250,Rochester,2012,800603700,85188400,885792100,90.38,9.62
250,Rochester,2013,792146200,90364900,882511100,89.76,10.24
250,Rochester,2014,794835600,91807500,886643100,89.65,10.35
250,Rochester,2015,813572400,98812200,912384600,89.17,10.83
250,Rochester,2016,847447100,102148700,949595800,89.24,10.76
251,Rockland,2003,1388618320,121989400,1510607720,91.92,8.08
251,Rockland,2004,1397284235,122626000,1519910235,91.93,8.07
251,Rockland,2005,1633830235,124597600,1758427835,92.91,7.09
251,Rockland,2006,1994644570,152950700,2147595270,92.88,7.12
251,Rockland,2007,2022054870,153216300,2175271170,92.96,7.04
251,Rockland,2008,1932914110,152730900,2085645010,92.68,7.32
251,Rockland,2009,1921933690,161503100,2083436790,92.25,7.75
251,Rockland,2010,1697533230,148818700,1846351930,91.94,8.06
251,Rockland,2011,1712888050,155924300,1868812350,91.66,8.34
251,Rockland,2012,1712324050,160599800,1872923850,91.43,8.57
251,Rockland,2013,1653073250,185491300,1838564550,89.91,10.09
251,Rockland,2014,1649056400,184336200,1833392600,89.95,10.05
251,Rockland,2015,1688185060,188333400,1876518460,89.96,10.04
251,Rockland,2016,1823561580,171151300,1994712880,91.42,8.58
252,Rockport,2003,1071475302,69291200,1140766502,93.93,6.07
252,Rockport,2004,1587964840,98695700,1686660540,94.15,5.85
252,Rockport,2005,1741207550,105095800,1846303350,94.31,5.69
252,Rockport,2006,1831360920,114050100,1945411020,94.14,5.86
252,Rockport,2007,1956112760,131866100,2087978860,93.68,6.32
252,Rockport,2008,1940569690,131522000,2072091690,93.65,6.35
252,Rockport,2009,1932970173,129659500,2062629673,93.71,6.29
252,Rockport,2010,1861619639,124635600,1986255239,93.73,6.27
252,Rockport,2011,1844441600,128514300,1972955900,93.49,6.51
252,Rockport,2012,1792315900,130846700,1923162600,93.2,6.8
252,Rockport,2013,1697509550,122142400,1819651950,93.29,6.71
252,Rockport,2014,1710744420,120099400,1830843820,93.44,6.56
252,Rockport,2015,1803730360,125284800,1929015160,93.51,6.49
252,Rockport,2016,1829077180,126230600,1955307780,93.54,6.46
253,Rowe,2003,421575303,5780200,427355503,98.65,1.35
253,Rowe,2004,422051703,5887700,427939403,98.62,1.38
253,Rowe,2005,425476101,6222300,431698401,98.56,1.44
253,Rowe,2006,303872277,8433000,312305277,97.3,2.7
253,Rowe,2007,310801199,8965300,319766499,97.2,2.8
253,Rowe,2008,310861669,9167900,320029569,97.14,2.86
253,Rowe,2009,316138956,9688400,325827356,97.03,2.97
253,Rowe,2010,283502093,9692700,293194793,96.69,3.31
253,Rowe,2011,286231262,9976300,296207562,96.63,3.37
253,Rowe,2012,304532689,10037700,314570389,96.81,3.19
253,Rowe,2013,276443139,10014000,286457139,96.5,3.5
253,Rowe,2014,272646938,7770100,280417038,97.23,2.77
253,Rowe,2015,290155485,11975700,302131185,96.04,3.96
253,Rowe,2016,294751591,13880400,308631991,95.5,4.5
254,Rowley,2003,626893339,35265660,662158999,94.67,5.33
254,Rowley,2004,687021980,23475600,710497580,96.7,3.3
254,Rowley,2005,818411439,37292100,855703539,95.64,4.36
254,Rowley,2006,897981678,38997400,936979078,95.84,4.16
254,Rowley,2007,932186202,40670900,972857102,95.82,4.18
254,Rowley,2008,962069241,38064600,1000133841,96.19,3.81
254,Rowley,2009,925936264,39259500,965195764,95.93,4.07
254,Rowley,2010,878114050,35998500,914112550,96.06,3.94
254,Rowley,2011,856791908,34462700,891254608,96.13,3.87
254,Rowley,2012,840392200,34293000,874685200,96.08,3.92
254,Rowley,2013,831083177,34842400,865925577,95.98,4.02
254,Rowley,2014,843937966,39635300,883573266,95.51,4.49
254,Rowley,2015,915870989,40796900,956667889,95.74,4.26
254,Rowley,2016,952274558,38821100,991095658,96.08,3.92
255,Royalston,2003,75179035,9218600,84397635,89.08,10.92
255,Royalston,2004,76501141,9556200,86057341,88.9,11.1
255,Royalston,2005,130457693,21734400,152192093,85.72,14.28
255,Royalston,2006,133552055,21886700,155438755,85.92,14.08
255,Royalston,2007,141169111,23676800,164845911,85.64,14.36
255,Royalston,2008,146595466,26374900,172970366,84.75,15.25
255,Royalston,2009,149254732,26374900,175629632,84.98,15.02
255,Royalston,2010,149523906,26352300,175876206,85.02,14.98
255,Royalston,2011,144033610,24982900,169016510,85.22,14.78
255,Royalston,2012,144430801,24836700,169267501,85.33,14.67
255,Royalston,2013,145198588,24858000,170056588,85.38,14.62
255,Royalston,2014,118960562,22100000,141060562,84.33,15.67
255,Royalston,2015,119772455,21879400,141651855,84.55,15.45
255,Royalston,2016,119521579,21885700,141407279,84.52,15.48
256,Russell,2003,84482377,9324000,93806377,90.06,9.94
256,Russell,2004,100420934,10831200,111252134,90.26,9.74
256,Russell,2005,108383202,9822700,118205902,91.69,8.31
256,Russell,2006,109214348,9539900,118754248,91.97,8.03
256,Russell,2007,133607406,10395900,144003306,92.78,7.22
256,Russell,2008,135066649,10467700,145534349,92.81,7.19
256,Russell,2009,140484124,10539600,151023724,93.02,6.98
256,Russell,2010,138190975,12526600,150717575,91.69,8.31
256,Russell,2011,139215094,12791600,152006694,91.58,8.42
256,Russell,2012,136756044,12791600,149547644,91.45,8.55
256,Russell,2013,131333028,11571900,142904928,91.9,8.1
256,Russell,2014,132041881,11571900,143613781,91.94,8.06
256,Russell,2015,132746616,11702700,144449316,91.9,8.1
256,Russell,2016,130146427,11338700,141485127,91.99,8.01
257,Rutland,2003,404846095,53883600,458729695,88.25,11.75
257,Rutland,2004,534134295,67256700,601390995,88.82,11.18
257,Rutland,2005,651398000,102863000,754261000,86.36,13.64
257,Rutland,2006,701395100,103233900,804629000,87.17,12.83
257,Rutland,2007,792525300,119687500,912212800,86.88,13.12
257,Rutland,2008,824785200,126925800,951711000,86.66,13.34
257,Rutland,2009,810115400,126458400,936573800,86.5,13.5
257,Rutland,2010,788047200,122975800,911023000,86.5,13.5
257,Rutland,2011,753504300,96017200,849521500,88.7,11.3
257,Rutland,2012,734741500,92410100,827151600,88.83,11.17
257,Rutland,2013,711823900,92304700,804128600,88.52,11.48
257,Rutland,2014,721018300,101233500,822251800,87.69,12.31
257,Rutland,2015,732960000,101794000,834754000,87.81,12.19
257,Rutland,2016,783666600,101540200,885206800,88.53,11.47
258,Salem,2003,3306641552,307397920,3614039472,91.49,8.51
258,Salem,2004,3971301437,461663210,4432964647,89.59,10.41
258,Salem,2005,4296541287,461663210,4758204497,90.3,9.7
258,Salem,2006,4586174179,493350590,5079524769,90.29,9.71
258,Salem,2007,4978320086,477859930,5456180016,91.24,8.76
258,Salem,2008,4805481341,637801234,5443282575,88.28,11.72
258,Salem,2009,4511658886,633462034,5145120920,87.69,12.31
258,Salem,2010,4294563427,638566934,4933130361,87.06,12.94
258,Salem,2011,4115970775,646860830,4762831605,86.42,13.58
258,Salem,2012,3973785748,652595178,4626380926,85.89,14.11
258,Salem,2013,3927232741,657489630,4584722371,85.66,14.34
258,Salem,2014,3962936296,658389300,4621325596,85.75,14.25
258,Salem,2015,4208675856,678344900,4887020756,86.12,13.88
258,Salem,2016,4534079631,764669900,5298749531,85.57,14.43
259,Salisbury,2003,927434180,72745800,1000179980,92.73,7.27
259,Salisbury,2004,1026641951,77509900,1104151851,92.98,7.02
259,Salisbury,2005,1132938579,92796600,1225735179,92.43,7.57
259,Salisbury,2006,1440057331,103028700,1543086031,93.32,6.68
259,Salisbury,2007,1543062579,109750600,1652813179,93.36,6.64
259,Salisbury,2008,1584023400,115479800,1699503200,93.21,6.79
259,Salisbury,2009,1543751075,84550400,1628301475,94.81,5.19
259,Salisbury,2010,1501760433,83993500,1585753933,94.7,5.3
259,Salisbury,2011,1459902566,83528800,1543431366,94.59,5.41
259,Salisbury,2012,1453325525,91577400,1544902925,94.07,5.93
259,Salisbury,2013,1425667947,90379800,1516047747,94.04,5.96
259,Salisbury,2014,1433913908,90892700,1524806608,94.04,5.96
259,Salisbury,2015,1482424746,90905500,1573330246,94.22,5.78
259,Salisbury,2016,1558127788,84304653,1642432441,94.87,5.13
260,Sandisfield,2003,136617859,10662100,147279959,92.76,7.24
260,Sandisfield,2004,156920293,7765700,164685993,95.28,4.72
260,Sandisfield,2005,171010190,8555100,179565290,95.24,4.76
260,Sandisfield,2006,197186063,9966300,207152363,95.19,4.81
260,Sandisfield,2007,225752558,11823000,237575558,95.02,4.98
260,Sandisfield,2008,229637041,12816000,242453041,94.71,5.29
260,Sandisfield,2009,239289284,14661300,253950584,94.23,5.77
260,Sandisfield,2010,242030621,14833000,256863621,94.23,5.77
260,Sandisfield,2011,243314266,16589600,259903866,93.62,6.38
260,Sandisfield,2012,235380544,16699700,252080244,93.38,6.62
260,Sandisfield,2013,207201738,14466400,221668138,93.47,6.53
260,Sandisfield,2014,214298995,14419800,228718795,93.7,6.3
260,Sandisfield,2015,216133236,14420300,230553536,93.75,6.25
260,Sandisfield,2016,216332965,14001500,230334465,93.92,6.08
261,Sandwich,2003,2821387800,306043100,3127430900,90.21,9.79
261,Sandwich,2004,3371219900,355621000,3726840900,90.46,9.54
261,Sandwich,2005,3877389600,460374100,4337763700,89.39,10.61
261,Sandwich,2006,4331718800,511631400,4843350200,89.44,10.56
261,Sandwich,2007,4520832800,550388800,5071221600,89.15,10.85
261,Sandwich,2008,4534391200,525996300,5060387500,89.61,10.39
261,Sandwich,2009,4347466600,512978900,4860445500,89.45,10.55
261,Sandwich,2010,4030844600,472428800,4503273400,89.51,10.49
261,Sandwich,2011,3829306800,431698700,4261005500,89.87,10.13
261,Sandwich,2012,3768502800,439140800,4207643600,89.56,10.44
261,Sandwich,2013,3650467600,414216100,4064683700,89.81,10.19
261,Sandwich,2014,3629697600,397216700,4026914300,90.14,9.86
261,Sandwich,2015,3683717900,392042800,4075760700,90.38,9.62
261,Sandwich,2016,3823133300,438967000,4262100300,89.7,10.3
262,Saugus,2003,2906662966,108505900,3015168866,96.4,3.6
262,Saugus,2004,3266535682,145521400,3412057082,95.74,4.26
262,Saugus,2005,3690874978,164899600,3855774578,95.72,4.28
262,Saugus,2006,3920659063,170247900,4090906963,95.84,4.16
262,Saugus,2007,4240020682,255098100,4495118782,94.32,5.68
262,Saugus,2008,4216127358,212566000,4428693358,95.2,4.8
262,Saugus,2009,4108417100,207242500,4315659600,95.2,4.8
262,Saugus,2010,3962136947,206767780,4168904727,95.04,4.96
262,Saugus,2011,3718658731,223211900,3941870631,94.34,5.66
262,Saugus,2012,3708538050,272301500,3980839550,93.16,6.84
262,Saugus,2013,3733020360,297403200,4030423560,92.62,7.38
262,Saugus,2014,3741157140,314244100,4055401240,92.25,7.75
262,Saugus,2015,3810652540,302967000,4113619540,92.64,7.36
262,Saugus,2016,3923689310,311947000,4235636310,92.64,7.36
263,Savoy,2003,39366273,5873600,45239873,87.02,12.98
263,Savoy,2004,45383397,9411400,54794797,82.82,17.18
263,Savoy,2005,51748481,11213500,62961981,82.19,17.81
263,Savoy,2006,55261020,11289800,66550820,83.04,16.96
263,Savoy,2007,68623157,11830900,80454057,85.29,14.71
263,Savoy,2008,70325912,12575400,82901312,84.83,15.17
263,Savoy,2009,69641461,12865900,82507361,84.41,15.59
263,Savoy,2010,65284499,12056700,77341199,84.41,15.59
263,Savoy,2011,65364739,12056700,77421439,84.43,15.57
263,Savoy,2012,62858714,10727000,73585714,85.42,14.58
263,Savoy,2013,61425180,9679900,71105080,86.39,13.61
263,Savoy,2014,61946019,9676800,71622819,86.49,13.51
263,Savoy,2015,63658359,9678900,73337259,86.8,13.2
263,Savoy,2016,67162428,15561600,82724028,81.19,18.81
264,Scituate,2003,3063878000,159597500,3223475500,95.05,4.95
264,Scituate,2004,3093272200,169023400,3262295600,94.82,5.18
264,Scituate,2005,3350279840,181270800,3531550640,94.87,5.13
264,Scituate,2006,4047660220,238416100,4286076320,94.44,5.56
264,Scituate,2007,4216790550,240725200,4457515750,94.6,5.4
264,Scituate,2008,4243304810,244547800,4487852610,94.55,5.45
264,Scituate,2009,4214905410,260058100,4474963510,94.19,5.81
264,Scituate,2010,3982377590,251649800,4234027390,94.06,5.94
264,Scituate,2011,3851701910,253247800,4104949710,93.83,6.17
264,Scituate,2012,3782198290,247295700,4029493990,93.86,6.14
264,Scituate,2013,3780043710,248529600,4028573310,93.83,6.17
264,Scituate,2014,3826611390,248592800,4075204190,93.9,6.1
264,Scituate,2015,3942097250,252147600,4194244850,93.99,6.01
264,Scituate,2016,4082256130,254588200,4336844330,94.13,5.87
265,Seekonk,2003,1332216896,73061200,1405278096,94.8,5.2
265,Seekonk,2004,1370604780,80341100,1450945880,94.46,5.54
265,Seekonk,2005,1801463679,83749200,1885212879,95.56,4.44
265,Seekonk,2006,2062189285,104084100,2166273385,95.2,4.8
265,Seekonk,2007,2299936354,108338500,2408274854,95.5,4.5
265,Seekonk,2008,2347261383,108261800,2455523183,95.59,4.41
265,Seekonk,2009,2326626900,114877700,2441504600,95.29,4.71
265,Seekonk,2010,2200512840,112171100,2312683940,95.15,4.85
265,Seekonk,2011,2134214692,110303700,2244518392,95.09,4.91
265,Seekonk,2012,2057572480,107696400,2165268880,95.03,4.97
265,Seekonk,2013,2033956400,104834800,2138791200,95.1,4.9
265,Seekonk,2014,2011751668,102584900,2114336568,95.15,4.85
265,Seekonk,2015,2081894700,102574400,2184469100,95.3,4.7
265,Seekonk,2016,2168831320,107052000,2275883320,95.3,4.7
266,Sharon,2003,1879110300,147225800,2026336100,92.73,7.27
266,Sharon,2004,2395281100,204581200,2599862300,92.13,7.87
266,Sharon,2005,2567220000,209022200,2776242200,92.47,7.53
266,Sharon,2006,2728944900,210182300,2939127200,92.85,7.15
266,Sharon,2007,2998857200,268951000,3267808200,91.77,8.23
266,Sharon,2008,2788470800,262155700,3050626500,91.41,8.59
266,Sharon,2009,2770398600,265604200,3036002800,91.25,8.75
266,Sharon,2010,2702944900,268406000,2971350900,90.97,9.03
266,Sharon,2011,2600675400,268014800,2868690200,90.66,9.34
266,Sharon,2012,2608165100,263880100,2872045200,90.81,9.19
266,Sharon,2013,2647526400,264171600,2911698000,90.93,9.07
266,Sharon,2014,2727401300,284319700,3011721000,90.56,9.44
266,Sharon,2015,2958430000,289900300,3248330300,91.08,8.92
266,Sharon,2016,3131671100,296674300,3428345400,91.35,8.65
267,Sheffield,2003,372898104,86515164,459413268,81.17,18.83
267,Sheffield,2004,441173299,99317200,540490499,81.62,18.38
267,Sheffield,2005,456468827,99771300,556240127,82.06,17.94
267,Sheffield,2006,528779399,109502400,638281799,82.84,17.16
267,Sheffield,2007,558107625,132625300,690732925,80.8,19.2
267,Sheffield,2008,563883846,127117500,691001346,81.6,18.4
267,Sheffield,2009,591160309,131851600,723011909,81.76,18.24
267,Sheffield,2010,620937076,145321500,766258576,81.03,18.97
267,Sheffield,2011,619450865,147573900,767024765,80.76,19.24
267,Sheffield,2012,623170495,148068100,771238595,80.8,19.2
267,Sheffield,2013,613740420,130963100,744703520,82.41,17.59
267,Sheffield,2014,606403257,139768400,746171657,81.27,18.73
267,Sheffield,2015,605659358,143824100,749483458,80.81,19.19
267,Sheffield,2016,608085291,146237900,754323191,80.61,19.39
268,Shelburne,2003,145409798,16650800,162060598,89.73,10.27
268,Shelburne,2004,150958549,16649800,167608349,90.07,9.93
268,Shelburne,2005,176906528,18363500,195270028,90.6,9.4
268,Shelburne,2006,207077367,23920600,230997967,89.64,10.36
268,Shelburne,2007,212199928,23822400,236022328,89.91,10.09
268,Shelburne,2008,216768781,25298300,242067081,89.55,10.45
268,Shelburne,2009,222707150,24763500,247470650,89.99,10.01
268,Shelburne,2010,224428815,24719500,249148315,90.08,9.92
268,Shelburne,2011,226129949,24053200,250183149,90.39,9.61
268,Shelburne,2012,228451277,24031500,252482777,90.48,9.52
268,Shelburne,2013,229720459,29667000,259387459,88.56,11.44
268,Shelburne,2014,225451354,29119600,254570954,88.56,11.44
268,Shelburne,2015,229981685,29235600,259217285,88.72,11.28
268,Shelburne,2016,234246585,29235600,263482185,88.9,11.1
269,Sherborn,2003,928377478,64622500,992999978,93.49,6.51
269,Sherborn,2004,956194445,67612900,1023807345,93.4,6.6
269,Sherborn,2005,1008149994,75958300,1084108294,92.99,7.01
269,Sherborn,2006,1176653269,87862600,1264515869,93.05,6.95
269,Sherborn,2007,1199099492,90808300,1289907792,92.96,7.04
269,Sherborn,2008,1174814693,89542800,1264357493,92.92,7.08
269,Sherborn,2009,1156810672,86993800,1243804472,93.01,6.99
269,Sherborn,2010,1114417642,87297400,1201715042,92.74,7.26
269,Sherborn,2011,1140645651,109589400,1250235051,91.23,8.77
269,Sherborn,2012,1141632087,105924300,1247556387,91.51,8.49
269,Sherborn,2013,1085743601,100690100,1186433701,91.51,8.49
269,Sherborn,2014,1089642945,100441600,1190084545,91.56,8.44
269,Sherborn,2015,1122299173,102159700,1224458873,91.66,8.34
269,Sherborn,2016,1138906685,102779300,1241685985,91.72,8.28
270,Shirley,2003,386080527,91397800,477478327,80.86,19.14
270,Shirley,2004,477307759,111007200,588314959,81.13,18.87
270,Shirley,2005,537200991,111747100,648948091,82.78,17.22
270,Shirley,2006,600305111,115478400,715783511,83.87,16.13
270,Shirley,2007,696639085,122421800,819060885,85.05,14.95
270,Shirley,2008,692396434,121238600,813635034,85.1,14.9
270,Shirley,2009,651991474,120033100,772024574,84.45,15.55
270,Shirley,2010,626018758,120815000,746833758,83.82,16.18
270,Shirley,2011,585511911,116650400,702162311,83.39,16.61
270,Shirley,2012,579352862,115678400,695031262,83.36,16.64
270,Shirley,2013,570480985,115439000,685919985,83.17,16.83
270,Shirley,2014,545528793,110847700,656376493,83.11,16.89
270,Shirley,2015,569549658,111730300,681279958,83.6,16.4
270,Shirley,2016,605712883,111331800,717044683,84.47,15.53
271,Shrewsbury,2003,3493141773,358901000,3852042773,90.68,9.32
271,Shrewsbury,2004,3986807862,422078300,4408886162,90.43,9.57
271,Shrewsbury,2005,4250437722,437904300,4688342022,90.66,9.34
271,Shrewsbury,2006,4676895485,479624893,5156520378,90.7,9.3
271,Shrewsbury,2007,5155279506,479138400,5634417906,91.5,8.5
271,Shrewsbury,2008,5017998457,458306300,5476304757,91.63,8.37
271,Shrewsbury,2009,4964954110,464732100,5429686210,91.44,8.56
271,Shrewsbury,2010,4762631162,343715550,5106346712,93.27,6.73
271,Shrewsbury,2011,4693387850,346762350,5040150200,93.12,6.88
271,Shrewsbury,2012,4771285789,342891650,5114177439,93.3,6.7
271,Shrewsbury,2013,4783093602,352810514,5135904116,93.13,6.87
271,Shrewsbury,2014,4768924733,451648295,5220573028,91.35,8.65
271,Shrewsbury,2015,4946815287,443547063,5390362350,91.77,8.23
271,Shrewsbury,2016,5196075499,452958611,5649034110,91.98,8.02
272,Shutesbury,2003,137317580,8901600,146219180,93.91,6.09
272,Shutesbury,2004,139513500,8901400,148414900,94,6
272,Shutesbury,2005,172081600,14106500,186188100,92.42,7.58
272,Shutesbury,2006,191815200,14713000,206528200,92.88,7.12
272,Shutesbury,2007,193544600,14649400,208194000,92.96,7.04
272,Shutesbury,2008,225419800,15099100,240518900,93.72,6.28
272,Shutesbury,2009,225939400,15099100,241038500,93.74,6.26
272,Shutesbury,2010,212939100,14983100,227922200,93.43,6.57
272,Shutesbury,2011,212879100,15683300,228562400,93.14,6.86
272,Shutesbury,2012,215350400,19135300,234485700,91.84,8.16
272,Shutesbury,2013,215318500,19136100,234454600,91.84,8.16
272,Shutesbury,2014,212753400,19061900,231815300,91.78,8.22
272,Shutesbury,2015,211670140,20993400,232663540,90.98,9.02
272,Shutesbury,2016,212263400,20736700,233000100,91.1,8.9
273,Somerset,2003,1779447800,104814100,1884261900,94.44,5.56
273,Somerset,2004,2061968700,108868300,2170837000,94.98,5.02
273,Somerset,2005,2399603200,123894700,2523497900,95.09,4.91
273,Somerset,2006,2713953332,177618900,2891572232,93.86,6.14
273,Somerset,2007,2870045480,201791800,3071837280,93.43,6.57
273,Somerset,2008,2779333510,229957000,3009290510,92.36,7.64
273,Somerset,2009,2692490120,231937000,2924427120,92.07,7.93
273,Somerset,2010,2568079057,208820600,2776899657,92.48,7.52
273,Somerset,2011,2422775510,215597500,2638373010,91.83,8.17
273,Somerset,2012,2548121870,213082700,2761204570,92.28,7.72
273,Somerset,2013,2296454910,222252300,2518707210,91.18,8.82
273,Somerset,2014,2096091290,220000900,2316092190,90.5,9.5
273,Somerset,2015,2030198090,211111900,2241309990,90.58,9.42
273,Somerset,2016,2070407630,204425400,2274833030,91.01,8.99
274,Somerville,2003,5674138800,599036400,6273175200,90.45,9.55
274,Somerville,2004,6613854900,668216200,7282071100,90.82,9.18
274,Somerville,2005,7255884000,763171100,8019055100,90.48,9.52
274,Somerville,2006,7894898300,783708800,8678607100,90.97,9.03
274,Somerville,2007,8752075700,1029152000,9781227700,89.48,10.52
274,Somerville,2008,8592330090,1074827600,9667157690,88.88,11.12
274,Somerville,2009,8409194220,1184980600,9594174820,87.65,12.35
274,Somerville,2010,8261279820,1175676400,9436956220,87.54,12.46
274,Somerville,2011,8297876320,1189290700,9487167020,87.46,12.54
274,Somerville,2012,8390572190,1208699200,9599271390,87.41,12.59
274,Somerville,2013,8595335050,1189749000,9785084050,87.84,12.16
274,Somerville,2014,9445672400,1272271900,10717944300,88.13,11.87
274,Somerville,2015,10492225280,1303502600,11795727880,88.95,11.05
274,Somerville,2016,11198774270,1429039000,12627813270,88.68,11.32
275,South Hadley,2003,898928315,129722100,1028650415,87.39,12.61
275,South Hadley,2004,1129869598,150788100,1280657698,88.23,11.77
275,South Hadley,2005,1149689429,151493500,1301182929,88.36,11.64
275,South Hadley,2006,1382008599,177219700,1559228299,88.63,11.37
275,South Hadley,2007,1540552148,169733200,1710285348,90.08,9.92
275,South Hadley,2008,1560981272,166397500,1727378772,90.37,9.63
275,South Hadley,2009,1583416154,187429500,1770845654,89.42,10.58
275,South Hadley,2010,1463159363,169631700,1632791063,89.61,10.39
275,South Hadley,2011,1469226239,170179600,1639405839,89.62,10.38
275,South Hadley,2012,1477331320,171135100,1648466420,89.62,10.38
275,South Hadley,2013,1486285877,170920990,1657206867,89.69,10.31
275,South Hadley,2014,1410740640,150797225,1561537865,90.34,9.66
275,South Hadley,2015,1409572930,160975125,1570548055,89.75,10.25
275,South Hadley,2016,1452428625,163872400,1616301025,89.86,10.14
276,Southampton,2003,337095024,27950100,365045124,92.34,7.66
276,Southampton,2004,402094286,31679700,433773986,92.7,7.3
276,Southampton,2005,454961597,29437700,484399297,93.92,6.08
276,Southampton,2006,525609566,32171100,557780666,94.23,5.77
276,Southampton,2007,601878618,32405100,634283718,94.89,5.11
276,Southampton,2008,623663374,32506200,656169574,95.05,4.95
276,Southampton,2009,644647561,32622300,677269861,95.18,4.82
276,Southampton,2010,660442418,32746900,693189318,95.28,4.72
276,Southampton,2011,674044048,35768900,709812948,94.96,5.04
276,Southampton,2012,649646585,35213900,684860485,94.86,5.14
276,Southampton,2013,660143297,35255700,695398997,94.93,5.07
276,Southampton,2014,642881801,33579000,676460801,95.04,4.96
276,Southampton,2015,654497236,34021900,688519136,95.06,4.94
276,Southampton,2016,663467433,34083600,697551033,95.11,4.89
277,Southborough,2003,1681473170,48127000,1729600170,97.22,2.78
277,Southborough,2004,1925641015,196447500,2122088515,90.74,9.26
277,Southborough,2005,2022247550,198843190,2221090740,91.05,8.95
277,Southborough,2006,2154812160,220597280,2375409440,90.71,9.29
277,Southborough,2007,2261191700,218362200,2479553900,91.19,8.81
277,Southborough,2008,2266408300,202947700,2469356000,91.78,8.22
277,Southborough,2009,2204010215,243144300,2447154515,90.06,9.94
277,Southborough,2010,2200552897,225948000,2426500897,90.69,9.31
277,Southborough,2011,2074295114,232144600,2306439714,89.93,10.07
277,Southborough,2012,2058537537,248543600,2307081137,89.23,10.77
277,Southborough,2013,2068284363,229834000,2298118363,90,10
277,Southborough,2014,2150167568,232235900,2382403468,90.25,9.75
277,Southborough,2015,2245083429,244315900,2489399329,90.19,9.81
277,Southborough,2016,2341768267,269198300,2610966567,89.69,10.31
278,Southbridge,2003,588358095,119046400,707404495,83.17,16.83
278,Southbridge,2004,831442330,137970400,969412730,85.77,14.23
278,Southbridge,2005,921689280,147163006,1068852286,86.23,13.77
278,Southbridge,2006,1039490618,148833300,1188323918,87.48,12.52
278,Southbridge,2007,1152609608,168858400,1321468008,87.22,12.78
278,Southbridge,2008,1127265246,174376500,1301641746,86.6,13.4
278,Southbridge,2009,1110651075,173129800,1283780875,86.51,13.49
278,Southbridge,2010,975430512,166435600,1141866112,85.42,14.58
278,Southbridge,2011,910443882,166117400,1076561282,84.57,15.43
278,Southbridge,2012,907741051,183974100,1091715151,83.15,16.85
278,Southbridge,2013,915288516,211779300,1127067816,81.21,18.79
278,Southbridge,2014,898164471,210749100,1108913571,80.99,19.01
278,Southbridge,2015,904791332,206170400,1110961732,81.44,18.56
278,Southbridge,2016,915440195,205357800,1120797995,81.68,18.32
279,Southwick,2003,557981698,52316300,610297998,91.43,8.57
279,Southwick,2004,710565729,55479000,766044729,92.76,7.24
279,Southwick,2005,728463969,57262500,785726469,92.71,7.29
279,Southwick,2006,888623652,58487700,947111352,93.82,6.18
279,Southwick,2007,1006484634,61932200,1068416834,94.2,5.8
279,Southwick,2008,1019722238,62032100,1081754338,94.27,5.73
279,Southwick,2009,1035237297,62038100,1097275397,94.35,5.65
279,Southwick,2010,1005864517,61274200,1067138717,94.26,5.74
279,Southwick,2011,1010636693,62778300,1073414993,94.15,5.85
279,Southwick,2012,1018499595,63570900,1082070495,94.13,5.87
279,Southwick,2013,968847898,62296100,1031143998,93.96,6.04
279,Southwick,2014,971611457,62478800,1034090257,93.96,6.04
279,Southwick,2015,982511589,62478800,1044990389,94.02,5.98
279,Southwick,2016,1001012928,62765900,1063778828,94.1,5.9
280,Spencer,2003,587755609,42418100,630173709,93.27,6.73
280,Spencer,2004,857044712,72245100,929289812,92.23,7.77
280,Spencer,2005,922797875,77043400,999841275,92.29,7.71
280,Spencer,2006,1051232899,83795000,1135027899,92.62,7.38
280,Spencer,2007,1144765096,99366200,1244131296,92.01,7.99
280,Spencer,2008,1161289649,99029500,1260319149,92.14,7.86
280,Spencer,2009,1154274275,97839700,1252113975,92.19,7.81
280,Spencer,2010,1051403083,85208800,1136611883,92.5,7.5
280,Spencer,2011,981793657,90888400,1072682057,91.53,8.47
280,Spencer,2012,922015095,90367850,1012382945,91.07,8.93
280,Spencer,2013,922861111,90367850,1013228961,91.08,8.92
280,Spencer,2014,934126462,112121275,1046247737,89.28,10.72
280,Spencer,2015,922468972,112603075,1035072047,89.12,10.88
280,Spencer,2016,912711201,112046825,1024758026,89.07,10.93
281,Springfield,2003,4960024660,1054593850,6014618510,82.47,17.53
281,Springfield,2004,5443977810,1321312750,6765290560,80.47,19.53
281,Springfield,2005,6077499390,1526444790,7603944180,79.93,20.07
281,Springfield,2006,6627400650,1516704390,8144105040,81.38,18.62
281,Springfield,2007,7433650520,1678796900,9112447420,81.58,18.42
281,Springfield,2008,7807142500,1691564800,9498707300,82.19,17.81
281,Springfield,2009,7241274580,1552653900,8793928480,82.34,17.66
281,Springfield,2010,6994818900,1480619400,8475438300,82.53,17.47
281,Springfield,2011,6849328730,1459924600,8309253330,82.43,17.57
281,Springfield,2012,6776007950,1324607500,8100615450,83.65,16.35
281,Springfield,2013,6696353300,1292984800,7989338100,83.82,16.18
281,Springfield,2014,6918393170,1280482300,8198875470,84.38,15.62
281,Springfield,2015,7044928510,1337664600,8382593110,84.04,15.96
281,Springfield,2016,7276422130,1303208300,8579630430,84.81,15.19
282,Sterling,2003,801886052,52138700,854024752,93.89,6.11
282,Sterling,2004,860678532,56332100,917010632,93.86,6.14
282,Sterling,2005,903276897,60659400,963936297,93.71,6.29
282,Sterling,2006,1108872477,105063300,1213935777,91.35,8.65
282,Sterling,2007,1129399846,129037100,1258436946,89.75,10.25
282,Sterling,2008,1095254623,129342800,1224597423,89.44,10.56
282,Sterling,2009,1097287455,128019300,1225306755,89.55,10.45
282,Sterling,2010,1017236101,112931000,1130167101,90.01,9.99
282,Sterling,2011,980949938,138891700,1119841638,87.6,12.4
282,Sterling,2012,953862740,135123300,1088986040,87.59,12.41
282,Sterling,2013,929121078,132131100,1061252178,87.55,12.45
282,Sterling,2014,927916388,130902100,1058818488,87.64,12.36
282,Sterling,2015,942550134,131338500,1073888634,87.77,12.23
282,Sterling,2016,955209193,134486100,1089695293,87.66,12.34
283,Stockbridge,2003,430786888,81352000,512138888,84.12,15.88
283,Stockbridge,2004,435560836,82054800,517615636,84.15,15.85
283,Stockbridge,2005,714159424,111312700,825472124,86.52,13.48
283,Stockbridge,2006,745063184,106500600,851563784,87.49,12.51
283,Stockbridge,2007,812618577,107667900,920286477,88.3,11.7
283,Stockbridge,2008,875650437,101371700,977022137,89.62,10.38
283,Stockbridge,2009,875386085,111461300,986847385,88.71,11.29
283,Stockbridge,2010,862756391,116161000,978917391,88.13,11.87
283,Stockbridge,2011,833285027,114737300,948022327,87.9,12.1
283,Stockbridge,2012,823941547,109068700,933010247,88.31,11.69
283,Stockbridge,2013,803896432,108520800,912417232,88.11,11.89
283,Stockbridge,2014,786676120,105867400,892543520,88.14,11.86
283,Stockbridge,2015,849949471,115846100,965795571,88.01,11.99
283,Stockbridge,2016,849885678,117718100,967603778,87.83,12.17
284,Stoneham,2003,2405187402,220017900,2625205302,91.62,8.38
284,Stoneham,2004,2420339422,220383500,2640722922,91.65,8.35
284,Stoneham,2005,2875472652,232047100,3107519752,92.53,7.47
284,Stoneham,2006,3183270515,274586900,3457857415,92.06,7.94
284,Stoneham,2007,3255331985,277077200,3532409185,92.16,7.84
284,Stoneham,2008,3209938891,280367300,3490306191,91.97,8.03
284,Stoneham,2009,3147420861,301682000,3449102861,91.25,8.75
284,Stoneham,2010,3067844785,303811352,3371656137,90.99,9.01
284,Stoneham,2011,2958127029,301576952,3259703981,90.75,9.25
284,Stoneham,2012,2951475123,308323962,3259799085,90.54,9.46
284,Stoneham,2013,2919245745,307319662,3226565407,90.48,9.52
284,Stoneham,2014,2989674327,305421639,3295095966,90.73,9.27
284,Stoneham,2015,3194789862,308890668,3503680530,91.18,8.82
284,Stoneham,2016,3344702394,397015322,3741717716,89.39,10.61
285,Stoughton,2003,2333641990,196998700,2530640690,92.22,7.78
285,Stoughton,2004,2498171760,200269200,2698440960,92.58,7.42
285,Stoughton,2005,3073118396,226470900,3299589296,93.14,6.86
285,Stoughton,2006,3354772199,231120200,3585892399,93.55,6.45
285,Stoughton,2007,3579711948,234673400,3814385348,93.85,6.15
285,Stoughton,2008,3749590583,249650996,3999241579,93.76,6.24
285,Stoughton,2009,3520510450,245516396,3766026846,93.48,6.52
285,Stoughton,2010,3280858847,238372396,3519231243,93.23,6.77
285,Stoughton,2011,3093558451,229845096,3323403547,93.08,6.92
285,Stoughton,2012,2992811251,225451796,3218263047,92.99,7.01
285,Stoughton,2013,2982849498,226491296,3209340794,92.94,7.06
285,Stoughton,2014,3024384946,217610096,3241995042,93.29,6.71
285,Stoughton,2015,3252459915,245915496,3498375411,92.97,7.03
285,Stoughton,2016,3419417064,210259900,3629676964,94.21,5.79
286,Stow,2003,860908800,64190900,925099700,93.06,6.94
286,Stow,2004,943161800,75519800,1018681600,92.59,7.41
286,Stow,2005,1026876500,76051800,1102928300,93.1,6.9
286,Stow,2006,1133335400,79877100,1213212500,93.42,6.58
286,Stow,2007,1218117280,83803200,1301920480,93.56,6.44
286,Stow,2008,1206889170,82775300,1289664470,93.58,6.42
286,Stow,2009,1209002390,82399300,1291401690,93.62,6.38
286,Stow,2010,1170108445,88304600,1258413045,92.98,7.02
286,Stow,2011,1138479670,88330100,1226809770,92.8,7.2
286,Stow,2012,1144424530,87919200,1232343730,92.87,7.13
286,Stow,2013,1135631550,85512800,1221144350,93,7
286,Stow,2014,1144576220,85584200,1230160420,93.04,6.96
286,Stow,2015,1156910550,92076900,1248987450,92.63,7.37
286,Stow,2016,1199502990,92175300,1291678290,92.86,7.14
287,Sturbridge,2003,693923900,66145400,760069300,91.3,8.7
287,Sturbridge,2004,731094500,70918400,802012900,91.16,8.84
287,Sturbridge,2005,1062759700,96849300,1159609000,91.65,8.35
287,Sturbridge,2006,1183565549,109409600,1292975149,91.54,8.46
287,Sturbridge,2007,1288873341,116493400,1405366741,91.71,8.29
287,Sturbridge,2008,1353051500,127894700,1480946200,91.36,8.64
287,Sturbridge,2009,1314037600,126739400,1440777000,91.2,8.8
287,Sturbridge,2010,1205578619,115581800,1321160419,91.25,8.75
287,Sturbridge,2011,1161808500,104678100,1266486600,91.73,8.27
287,Sturbridge,2012,1124879241,105046700,1229925941,91.46,8.54
287,Sturbridge,2013,1107961245,104631800,1212593045,91.37,8.63
287,Sturbridge,2014,1062980401,141921200,1204901601,88.22,11.78
287,Sturbridge,2015,1112375798,142360300,1254736098,88.65,11.35
287,Sturbridge,2016,1135803129,147457100,1283260229,88.51,11.49
288,Sudbury,2003,2839782978,107687300,2947470278,96.35,3.65
288,Sudbury,2004,3545996135,215662300,3761658435,94.27,5.73
288,Sudbury,2005,3600973272,216452190,3817425462,94.33,5.67
288,Sudbury,2006,3956930561,231947945,4188878506,94.46,5.54
288,Sudbury,2007,4231531337,247989510,4479520847,94.46,5.54
288,Sudbury,2008,4162959799,276306310,4439266109,93.78,6.22
288,Sudbury,2009,4064434979,281043410,4345478389,93.53,6.47
288,Sudbury,2010,4003661467,271287200,4274948667,93.65,6.35
288,Sudbury,2011,3874281828,263719000,4138000828,93.63,6.37
288,Sudbury,2012,3838335540,258966880,4097302420,93.68,6.32
288,Sudbury,2013,3864083107,259512400,4123595507,93.71,6.29
288,Sudbury,2014,3960584137,261538040,4222122177,93.81,6.19
288,Sudbury,2015,4088915905,263966560,4352882465,93.94,6.06
288,Sudbury,2016,4230884307,290387460,4521271767,93.58,6.42
289,Sunderland,2003,222630684,15688000,238318684,93.42,6.58
289,Sunderland,2004,225326310,16005400,241331710,93.37,6.63
289,Sunderland,2005,278458176,29194100,307652276,90.51,9.49
289,Sunderland,2006,306347645,30872100,337219745,90.85,9.15
289,Sunderland,2007,344911181,34669300,379580481,90.87,9.13
289,Sunderland,2008,349980482,34449800,384430282,91.04,8.96
289,Sunderland,2009,351987818,34547000,386534818,91.06,8.94
289,Sunderland,2010,341610453,33491600,375102053,91.07,8.93
289,Sunderland,2011,342451380,35875000,378326380,90.52,9.48
289,Sunderland,2012,347237491,36023400,383260891,90.6,9.4
289,Sunderland,2013,345107072,36266600,381373672,90.49,9.51
289,Sunderland,2014,341918036,33429900,375347936,91.09,8.91
289,Sunderland,2015,338075414,33448900,371524314,91,9
289,Sunderland,2016,339315351,33155300,372470651,91.1,8.9
290,Sutton,2003,833990706,48152100,882142806,94.54,5.46
290,Sutton,2004,863078978,48800400,911879378,94.65,5.35
290,Sutton,2005,1081039396,52370000,1133409396,95.38,4.62
290,Sutton,2006,1228288422,63797300,1292085722,95.06,4.94
290,Sutton,2007,1311745253,64229200,1375974453,95.33,4.67
290,Sutton,2008,1269811507,65013800,1334825307,95.13,4.87
290,Sutton,2009,1299028266,69387600,1368415866,94.93,5.07
290,Sutton,2010,1268737786,68856300,1337594086,94.85,5.15
290,Sutton,2011,1219914778,69551600,1289466378,94.61,5.39
290,Sutton,2012,1187857764,67388200,1255245964,94.63,5.37
290,Sutton,2013,1181042868,64389600,1245432468,94.83,5.17
290,Sutton,2014,1160418598,66535500,1226954098,94.58,5.42
290,Sutton,2015,1206958210,65985530,1272943740,94.82,5.18
290,Sutton,2016,1251329952,66752200,1318082152,94.94,5.06
291,Swampscott,2003,1892843508,142050500,2034894008,93.02,6.98
291,Swampscott,2004,2187977886,157945500,2345923386,93.27,6.73
291,Swampscott,2005,2431281053,166600500,2597881553,93.59,6.41
291,Swampscott,2006,2539060583,166498500,2705559083,93.85,6.15
291,Swampscott,2007,2609458933,168058000,2777516933,93.95,6.05
291,Swampscott,2008,2580170006,168900300,2749070306,93.86,6.14
291,Swampscott,2009,2544363929,165419500,2709783429,93.9,6.1
291,Swampscott,2010,2298779232,148223500,2447002732,93.94,6.06
291,Swampscott,2011,2277779318,132899300,2410678618,94.49,5.51
291,Swampscott,2012,2212313215,130523800,2342837015,94.43,5.57
291,Swampscott,2013,2168072045,130176000,2298248045,94.34,5.66
291,Swampscott,2014,2222788745,123767400,2346556145,94.73,5.27
291,Swampscott,2015,2516591516,128610650,2645202166,95.14,4.86
291,Swampscott,2016,2560670126,128894900,2689565026,95.21,4.79
292,Swansea,2003,1144967810,18503200,1163471010,98.41,1.59
292,Swansea,2004,1173836994,18692600,1192529594,98.43,1.57
292,Swansea,2005,1942136129,113033000,2055169129,94.5,5.5
292,Swansea,2006,2149707685,115733800,2265441485,94.89,5.11
292,Swansea,2007,2252378420,117156300,2369534720,95.06,4.94
292,Swansea,2008,2265104278,129555500,2394659778,94.59,5.41
292,Swansea,2009,2200509939,129536800,2330046739,94.44,5.56
292,Swansea,2010,2076942527,129924700,2206867227,94.11,5.89
292,Swansea,2011,1987456480,156124600,2143581080,92.72,7.28
292,Swansea,2012,1939749020,126434400,2066183420,93.88,6.12
292,Swansea,2013,1901251054,127656600,2028907654,93.71,6.29
292,Swansea,2014,1885262847,125416500,2010679347,93.76,6.24
292,Swansea,2015,1910179029,128173500,2038352529,93.71,6.29
292,Swansea,2016,1979989908,128667300,2108657208,93.9,6.1
293,Taunton,2003,2850319272,60849800,2911169072,97.91,2.09
293,Taunton,2004,4276630676,240973600,4517604276,94.67,5.33
293,Taunton,2005,4922011720,343322900,5265334620,93.48,6.52
293,Taunton,2006,5720826088,706166300,6426992388,89.01,10.99
293,Taunton,2007,6007437074,658355500,6665792574,90.12,9.88
293,Taunton,2008,5898090203,642468000,6540558203,90.18,9.82
293,Taunton,2009,5646112804,642442700,6288555504,89.78,10.22
293,Taunton,2010,5121510501,664481100,5785991601,88.52,11.48
293,Taunton,2011,4705033928,655102700,5360136628,87.78,12.22
293,Taunton,2012,4610179378,784195500,5394374878,85.46,14.54
293,Taunton,2013,4430740980,710612200,5141353180,86.18,13.82
293,Taunton,2014,4422983044,689844500,5112827544,86.51,13.49
293,Taunton,2015,4452689437,712481200,5165170637,86.21,13.79
293,Taunton,2016,4514347120,722364200,5236711320,86.21,13.79
294,Templeton,2003,332893273,42302400,375195673,88.73,11.27
294,Templeton,2004,446029338,57334800,503364138,88.61,11.39
294,Templeton,2005,516137102,59291600,575428702,89.7,10.3
294,Templeton,2006,597583673,59593800,657177473,90.93,9.07
294,Templeton,2007,719608512,71160900,790769412,91,9
294,Templeton,2008,746124192,71947500,818071692,91.21,8.79
294,Templeton,2009,695654470,71340900,766995370,90.7,9.3
294,Templeton,2010,616456474,65141900,681598374,90.44,9.56
294,Templeton,2011,601165838,65677100,666842938,90.15,9.85
294,Templeton,2012,581356554,66004600,647361154,89.8,10.2
294,Templeton,2013,542840725,68989150,611829875,88.72,11.28
294,Templeton,2014,540623505,71120750,611744255,88.37,11.63
294,Templeton,2015,552836694,71121550,623958244,88.6,11.4
294,Templeton,2016,556659447,71832150,628491597,88.57,11.43
295,Tewksbury,2003,2588269930,179653300,2767923230,93.51,6.49
295,Tewksbury,2004,3495477340,187194800,3682672140,94.92,5.08
295,Tewksbury,2005,3790698130,189447700,3980145830,95.24,4.76
295,Tewksbury,2006,4010864490,201860200,4212724690,95.21,4.79
295,Tewksbury,2007,4230680780,204096900,4434777680,95.4,4.6
295,Tewksbury,2008,4178102720,203379400,4381482120,95.36,4.64
295,Tewksbury,2009,4033912840,206907100,4240819940,95.12,4.88
295,Tewksbury,2010,3851700060,207152400,4058852460,94.9,5.1
295,Tewksbury,2011,3742540430,204499100,3947039530,94.82,5.18
295,Tewksbury,2012,3789527540,203363000,3992890540,94.91,5.09
295,Tewksbury,2013,3803267620,229720200,4032987820,94.3,5.7
295,Tewksbury,2014,3781574640,229912500,4011487140,94.27,5.73
295,Tewksbury,2015,3879626310,244383000,4124009310,94.07,5.93
295,Tewksbury,2016,4097616270,245160000,4342776270,94.35,5.65
296,Tisbury,2003,1568966246,102584600,1671550846,93.86,6.14
296,Tisbury,2004,1588796942,103298800,1692095742,93.9,6.1
296,Tisbury,2005,2191706513,144784700,2336491213,93.8,6.2
296,Tisbury,2006,2572863316,174803400,2747666716,93.64,6.36
296,Tisbury,2007,2660592281,178607900,2839200181,93.71,6.29
296,Tisbury,2008,2906618049,184122600,3090740649,94.04,5.96
296,Tisbury,2009,2824635763,179973500,3004609263,94.01,5.99
296,Tisbury,2010,2717459531,180120300,2897579831,93.78,6.22
296,Tisbury,2011,2558966837,170879100,2729845937,93.74,6.26
296,Tisbury,2012,2559241145,177676300,2736917445,93.51,6.49
296,Tisbury,2013,2472061469,177831400,2649892869,93.29,6.71
296,Tisbury,2014,2506632233,180703900,2687336133,93.28,6.72
296,Tisbury,2015,2589018991,200272300,2789291291,92.82,7.18
296,Tisbury,2016,2585118517,199616900,2784735417,92.83,7.17
297,Tolland,2003,110720148,10317900,121038048,91.48,8.52
297,Tolland,2004,114781052,10393500,125174552,91.7,8.3
297,Tolland,2005,116099149,10393600,126492749,91.78,8.22
297,Tolland,2006,161194150,13161600,174355750,92.45,7.55
297,Tolland,2007,178864880,19917000,198781880,89.98,10.02
297,Tolland,2008,181981592,19730000,201711592,90.22,9.78
297,Tolland,2009,193680360,19728300,213408660,90.76,9.24
297,Tolland,2010,194845562,19788500,214634062,90.78,9.22
297,Tolland,2011,193305592,19194300,212499892,90.97,9.03
297,Tolland,2012,182388887,21081086,203469973,89.64,10.36
297,Tolland,2013,178624099,22601800,201225899,88.77,11.23
297,Tolland,2014,177302270,22808300,200110570,88.6,11.4
297,Tolland,2015,184690700,24947400,209638100,88.1,11.9
297,Tolland,2016,193898648,23581900,217480548,89.16,10.84
298,Topsfield,2003,957191878,50401000,1007592878,95,5
298,Topsfield,2004,1063512597,62244500,1125757097,94.47,5.53
298,Topsfield,2005,1149877339,65191500,1215068839,94.63,5.37
298,Topsfield,2006,1197519716,68906300,1266426016,94.56,5.44
298,Topsfield,2007,1278395170,71265100,1349660270,94.72,5.28
298,Topsfield,2008,1289199574,73675900,1362875474,94.59,5.41
298,Topsfield,2009,1251666371,72771200,1324437571,94.51,5.49
298,Topsfield,2010,1199414915,70760600,1270175515,94.43,5.57
298,Topsfield,2011,1162962400,70021000,1232983400,94.32,5.68
298,Topsfield,2012,1152261489,69217900,1221479389,94.33,5.67
298,Topsfield,2013,1149229840,70329600,1219559440,94.23,5.77
298,Topsfield,2014,1163234670,68338400,1231573070,94.45,5.55
298,Topsfield,2015,1215213580,68316200,1283529780,94.68,5.32
298,Topsfield,2016,1266545220,71419000,1337964220,94.66,5.34
299,Townsend,2003,687851857,110881200,798733057,86.12,13.88
299,Townsend,2004,704378257,112522100,816900357,86.23,13.77
299,Townsend,2005,792508637,116325700,908834337,87.2,12.8
299,Townsend,2006,897676676,118227800,1015904476,88.36,11.64
299,Townsend,2007,914136694,118519700,1032656394,88.52,11.48
299,Townsend,2008,926166205,119401300,1045567505,88.58,11.42
299,Townsend,2009,948561960,125759000,1074320960,88.29,11.71
299,Townsend,2010,863440319,123746400,987186719,87.46,12.54
299,Townsend,2011,856296203,130388700,986684903,86.79,13.21
299,Townsend,2012,812279312,130549500,942828812,86.15,13.85
299,Townsend,2013,770021972,130636400,900658372,85.5,14.5
299,Townsend,2014,742085736,128870500,870956236,85.2,14.8
299,Townsend,2015,783223186,119350600,902573786,86.78,13.22
299,Townsend,2016,782649577,118391500,901041077,86.86,13.14
300,Truro,2003,1306572120,67610200,1374182320,95.08,4.92
300,Truro,2004,1332323600,71055400,1403379000,94.94,5.06
300,Truro,2005,1777268400,122403000,1899671400,93.56,6.44
300,Truro,2006,2072624990,139650500,2212275490,93.69,6.31
300,Truro,2007,2243728330,149344600,2393072930,93.76,6.24
300,Truro,2008,2250494350,163582900,2414077250,93.22,6.78
300,Truro,2009,2239613910,162302100,2401916010,93.24,6.76
300,Truro,2010,2144817310,158892200,2303709510,93.1,6.9
300,Truro,2011,2004333510,174184000,2178517510,92,8
300,Truro,2012,1990317560,169676600,2159994160,92.14,7.86
300,Truro,2013,2009972420,170623600,2180596020,92.18,7.82
300,Truro,2014,1983770030,165914700,2149684730,92.28,7.72
300,Truro,2015,2028118100,174501600,2202619700,92.08,7.92
300,Truro,2016,2084200430,210332200,2294532630,90.83,9.17
301,Tyngsborough,2003,920125181,100576600,1020701781,90.15,9.85
301,Tyngsborough,2004,1222731984,115856000,1338587984,91.34,8.66
301,Tyngsborough,2005,1339342472,135749100,1475091572,90.8,9.2
301,Tyngsborough,2006,1441113080,149147600,1590260680,90.62,9.38
301,Tyngsborough,2007,1542444687,144579100,1687023787,91.43,8.57
301,Tyngsborough,2008,1531874311,145668300,1677542611,91.32,8.68
301,Tyngsborough,2009,1488122237,143125800,1631248037,91.23,8.77
301,Tyngsborough,2010,1387380323,126782700,1514163023,91.63,8.37
301,Tyngsborough,2011,1379506104,127260300,1506766404,91.55,8.45
301,Tyngsborough,2012,1381854780,127143500,1508998280,91.57,8.43
301,Tyngsborough,2013,1363854741,125674570,1489529311,91.56,8.44
301,Tyngsborough,2014,1354762224,124128205,1478890429,91.61,8.39
301,Tyngsborough,2015,1386228060,126978000,1513206060,91.61,8.39
301,Tyngsborough,2016,1424602785,129024300,1553627085,91.7,8.3
302,Tyringham,2003,88733737,13156500,101890237,87.09,12.91
302,Tyringham,2004,90579444,13156500,103735944,87.32,12.68
302,Tyringham,2005,136623160,18894400,155517560,87.85,12.15
302,Tyringham,2006,145540640,20079100,165619740,87.88,12.12
302,Tyringham,2007,146789520,20227300,167016820,87.89,12.11
302,Tyringham,2008,183803610,23898700,207702310,88.49,11.51
302,Tyringham,2009,185759430,23898200,209657630,88.6,11.4
302,Tyringham,2010,186519790,23898200,210417990,88.64,11.36
302,Tyringham,2011,183248820,23521600,206770420,88.62,11.38
302,Tyringham,2012,184402780,23521600,207924380,88.69,11.31
302,Tyringham,2013,188499040,23294100,211793140,89,11
302,Tyringham,2014,190960430,23567600,214528030,89.01,10.99
302,Tyringham,2015,189952150,23281100,213233250,89.08,10.92
302,Tyringham,2016,192834550,23893200,216727750,88.98,11.02
303,Upton,2003,654351200,72123900,726475100,90.07,9.93
303,Upton,2004,665512100,73930600,739442700,90,10
303,Upton,2005,1023780700,94677000,1118457700,91.54,8.46
303,Upton,2006,1042009700,108594300,1150604000,90.56,9.44
303,Upton,2007,1058360300,108160000,1166520300,90.73,9.27
303,Upton,2008,1170055800,116569400,1286625200,90.94,9.06
303,Upton,2009,1044111800,117062800,1161174600,89.92,10.08
303,Upton,2010,1053358370,117296700,1170655070,89.98,10.02
303,Upton,2011,1000578048,108741000,1109319048,90.2,9.8
303,Upton,2012,1006192347,113647700,1119840047,89.85,10.15
303,Upton,2013,938472721,110180300,1048653021,89.49,10.51
303,Upton,2014,957458016,109244700,1066702716,89.76,10.24
303,Upton,2015,985635976,109828700,1095464676,89.97,10.03
303,Upton,2016,1003499218,111007500,1114506718,90.04,9.96
304,Uxbridge,2003,786790895,45721300,832512195,94.51,5.49
304,Uxbridge,2004,1179160531,65022300,1244182831,94.77,5.23
304,Uxbridge,2005,1335209480,72737700,1407947180,94.83,5.17
304,Uxbridge,2006,1523273127,84331600,1607604727,94.75,5.25
304,Uxbridge,2007,1663767403,89800600,1753568003,94.88,5.12
304,Uxbridge,2008,1713978100,98402700,1812380800,94.57,5.43
304,Uxbridge,2009,1665143912,97586900,1762730812,94.46,5.54
304,Uxbridge,2010,1589056020,80874600,1669930620,95.16,4.84
304,Uxbridge,2011,1506383398,77292100,1583675498,95.12,4.88
304,Uxbridge,2012,1509128556,79768700,1588897256,94.98,5.02
304,Uxbridge,2013,1445011462,76768700,1521780162,94.96,5.04
304,Uxbridge,2014,1403132741,102318600,1505451341,93.2,6.8
304,Uxbridge,2015,1443810596,101082600,1544893196,93.46,6.54
304,Uxbridge,2016,1493468746,103619600,1597088346,93.51,6.49
305,Wakefield,2003,2690880253,290510800,2981391053,90.26,9.74
305,Wakefield,2004,2724937742,304162300,3029100042,89.96,10.04
305,Wakefield,2005,3605637471,340412200,3946049671,91.37,8.63
305,Wakefield,2006,3767142079,343676400,4110818479,91.64,8.36
305,Wakefield,2007,3876235749,346594600,4222830349,91.79,8.21
305,Wakefield,2008,3984137104,359194200,4343331304,91.73,8.27
305,Wakefield,2009,3801443211,351036200,4152479411,91.55,8.45
305,Wakefield,2010,3785082150,334075500,4119157650,91.89,8.11
305,Wakefield,2011,3827149422,333979400,4161128822,91.97,8.03
305,Wakefield,2012,3837880740,326412300,4164293040,92.16,7.84
305,Wakefield,2013,3833762128,327103800,4160865928,92.14,7.86
305,Wakefield,2014,3898925842,317669400,4216595242,92.47,7.53
305,Wakefield,2015,4011832988,319633400,4331466388,92.62,7.38
305,Wakefield,2016,4206445431,348971800,4555417231,92.34,7.66
306,Wales,2003,99411045,15249200,114660245,86.7,13.3
306,Wales,2004,101197724,15325000,116522724,86.85,13.15
306,Wales,2005,129928594,18652300,148580894,87.45,12.55
306,Wales,2006,147007882,21024500,168032382,87.49,12.51
306,Wales,2007,162445987,20565780,183011767,88.76,11.24
306,Wales,2008,172035849,20077880,192113729,89.55,10.45
306,Wales,2009,174892419,24273780,199166199,87.81,12.19
306,Wales,2010,169360618,23757600,193118218,87.7,12.3
306,Wales,2011,171598097,30125200,201723297,85.07,14.93
306,Wales,2012,164613799,29701200,194314999,84.71,15.29
306,Wales,2013,159506347,28930300,188436647,84.65,15.35
306,Wales,2014,157064196,28631300,185695496,84.58,15.42
306,Wales,2015,157760940,28706900,186467840,84.6,15.4
306,Wales,2016,156700386,28957300,185657686,84.4,15.6
307,Walpole,2003,2423655690,232731200,2656386890,91.24,8.76
307,Walpole,2004,2514178830,233816500,2747995330,91.49,8.51
307,Walpole,2005,3419632580,286605000,3706237580,92.27,7.73
307,Walpole,2006,3660508290,298712700,3959220990,92.46,7.54
307,Walpole,2007,3922255300,319824300,4242079600,92.46,7.54
307,Walpole,2008,3981929170,313771000,4295700170,92.7,7.3
307,Walpole,2009,3840587890,312020200,4152608090,92.49,7.51
307,Walpole,2010,3679198820,308753100,3987951920,92.26,7.74
307,Walpole,2011,3568004710,308970600,3876975310,92.03,7.97
307,Walpole,2012,3573149990,316782300,3889932290,91.86,8.14
307,Walpole,2013,3589184240,315697900,3904882140,91.92,8.08
307,Walpole,2014,3612217340,358086800,3970304140,90.98,9.02
307,Walpole,2015,3788155240,365255100,4153410340,91.21,8.79
307,Walpole,2016,3984460440,380697500,4365157940,91.28,8.72
308,Waltham,2003,7521650788,1618920212,9140571000,82.29,17.71
308,Waltham,2004,7875441330,1582834744,9458276074,83.27,16.73
308,Waltham,2005,7810723666,1549032044,9359755710,83.45,16.55
308,Waltham,2006,8316274892,1582110508,9898385400,84.02,15.98
308,Waltham,2007,9043253110,1658424410,10701677520,84.5,15.5
308,Waltham,2008,9009724190,1649647190,10659371380,84.52,15.48
308,Waltham,2009,8921116476,1648210608,10569327084,84.41,15.59
308,Waltham,2010,8542640122,1459677438,10002317560,85.41,14.59
308,Waltham,2011,8392975774,1435448066,9828423840,85.39,14.61
308,Waltham,2012,8442780234,1436624066,9879404300,85.46,14.54
308,Waltham,2013,8532290474,1461154966,9993445440,85.38,14.62
308,Waltham,2014,8698186074,1469503076,10167689150,85.55,14.45
308,Waltham,2015,8972309630,1478151960,10450461590,85.86,14.14
308,Waltham,2016,9946294086,1612832694,11559126780,86.05,13.95
309,Ware,2003,469919161,66630632,536549793,87.58,12.42
309,Ware,2004,483577091,67654540,551231631,87.73,12.27
309,Ware,2005,579781356,86538328,666319684,87.01,12.99
309,Ware,2006,682640181,82409104,765049285,89.23,10.77
309,Ware,2007,752322908,83932893,836255801,89.96,10.04
309,Ware,2008,789945844,86648512,876594356,90.12,9.88
309,Ware,2009,803131931,89955842,893087773,89.93,10.07
309,Ware,2010,781320211,89294142,870614353,89.74,10.26
309,Ware,2011,781714791,90083620,871798411,89.67,10.33
309,Ware,2012,751468783,90891727,842360510,89.21,10.79
309,Ware,2013,723776635,88011499,811788134,89.16,10.84
309,Ware,2014,710399261,87467988,797867249,89.04,10.96
309,Ware,2015,680458497,93987538,774446035,87.86,12.14
309,Ware,2016,687095736,94001801,781097537,87.97,12.03
310,Wareham,2003,2192983477,184121500,2377104977,92.25,7.75
310,Wareham,2004,2239288900,182633800,2421922700,92.46,7.54
310,Wareham,2005,2952730500,213016400,3165746900,93.27,6.73
310,Wareham,2006,3711665100,226810600,3938475700,94.24,5.76
310,Wareham,2007,3845738200,226743100,4072481300,94.43,5.57
310,Wareham,2008,3928807110,254329000,4183136110,93.92,6.08
310,Wareham,2009,3861179220,289915100,4151094320,93.02,6.98
310,Wareham,2010,3664105690,289561000,3953666690,92.68,7.32
310,Wareham,2011,3444050910,285246500,3729297410,92.35,7.65
310,Wareham,2012,3368858340,273214200,3642072540,92.5,7.5
310,Wareham,2013,3116570140,268487500,3385057640,92.07,7.93
310,Wareham,2014,3146222210,287524000,3433746210,91.63,8.37
310,Wareham,2015,3167130415,301084800,3468215215,91.32,8.68
310,Wareham,2016,3198696105,303015000,3501711105,91.35,8.65
311,Warren,2003,205629724,26550410,232180134,88.56,11.44
311,Warren,2004,228487113,26750400,255237513,89.52,10.48
311,Warren,2005,298257451,31409800,329667251,90.47,9.53
311,Warren,2006,324268011,31482900,355750911,91.15,8.85
311,Warren,2007,391727998,34488900,426216898,91.91,8.09
311,Warren,2008,394437936,34155700,428593636,92.03,7.97
311,Warren,2009,397181968,34296600,431478568,92.05,7.95
311,Warren,2010,369175444,33558800,402734244,91.67,8.33
311,Warren,2011,354103045,33300800,387403845,91.4,8.6
311,Warren,2012,353983814,33490700,387474514,91.36,8.64
311,Warren,2013,323632754,30580900,354213654,91.37,8.63
311,Warren,2014,312768392,29263400,342031792,91.44,8.56
311,Warren,2015,317212387,28895700,346108087,91.65,8.35
311,Warren,2016,328407547,28465300,356872847,92.02,7.98
312,Warwick,2003,46211601,8094900,54306501,85.09,14.91
312,Warwick,2004,53056095,13147045,66203140,80.14,19.86
312,Warwick,2005,53358310,13147045,66505355,80.23,19.77
312,Warwick,2006,72527011,12309150,84836161,85.49,14.51
312,Warwick,2007,84314522,18532800,102847322,81.98,18.02
312,Warwick,2008,84725808,18526100,103251908,82.06,17.94
312,Warwick,2009,85788767,18545300,104334067,82.23,17.77
312,Warwick,2010,82169190,21895000,104064190,78.96,21.04
312,Warwick,2011,81642651,21859100,103501751,78.88,21.12
312,Warwick,2012,81491736,21856100,103347836,78.85,21.15
312,Warwick,2013,77517116,20817900,98335016,78.83,21.17
312,Warwick,2014,77021177,20489400,97510577,78.99,21.01
312,Warwick,2015,76824362,20489400,97313762,78.95,21.05
312,Warwick,2016,72810084,17477900,90287984,80.64,19.36
313,Washington,2003,37548276,7474000,45022276,83.4,16.6
313,Washington,2004,49926976,16428400,66355376,75.24,24.76
313,Washington,2005,50249783,17087100,67336883,74.62,25.38
313,Washington,2006,51787008,17100400,68887408,75.18,24.82
313,Washington,2007,59265406,18017900,77283306,76.69,23.31
313,Washington,2008,60846614,27126500,87973114,69.17,30.83
313,Washington,2009,64879048,27372100,92251148,70.33,29.67
313,Washington,2010,70666890,36944300,107611190,65.67,34.33
313,Washington,2011,70290862,37004500,107295362,65.51,34.49
313,Washington,2012,69000570,36895600,105896170,65.16,34.84
313,Washington,2013,70045514,36895600,106941114,65.5,34.5
313,Washington,2014,77092556,25419600,102512156,75.2,24.8
313,Washington,2015,77666252,26504500,104170752,74.56,25.44
313,Washington,2016,79790690,26665700,106456390,74.95,25.05
314,Watertown,2003,3707466309,276641054,3984107363,93.06,6.94
314,Watertown,2004,4779603684,313552256,5093155940,93.84,6.16
314,Watertown,2005,4954801943,319713476,5274515419,93.94,6.06
314,Watertown,2006,5124063891,339992224,5464056115,93.78,6.22
314,Watertown,2007,5686136860,387872103,6074008963,93.61,6.39
314,Watertown,2008,5416095366,372946955,5789042321,93.56,6.44
314,Watertown,2009,5245291204,469661555,5714952759,91.78,8.22
314,Watertown,2010,4968622010,438912034,5407534044,91.88,8.12
314,Watertown,2011,4893342875,434845239,5328188114,91.84,8.16
314,Watertown,2012,4931676975,443969817,5375646792,91.74,8.26
314,Watertown,2013,5052185496,429906917,5482092413,92.16,7.84
314,Watertown,2014,5167075222,414382220,5581457442,92.58,7.42
314,Watertown,2015,5444172323,438118920,5882291243,92.55,7.45
314,Watertown,2016,6272536699,524645320,6797182019,92.28,7.72
315,Wayland,2003,2807819902,218873857,3026693759,92.77,7.23
315,Wayland,2004,2822189683,219557600,3041747283,92.78,7.22
315,Wayland,2005,3024246760,220197200,3244443960,93.21,6.79
315,Wayland,2006,3360065306,264127900,3624193206,92.71,7.29
315,Wayland,2007,3334374800,270629900,3605004700,92.49,7.51
315,Wayland,2008,3189629498,253681800,3443311298,92.63,7.37
315,Wayland,2009,3161364820,228364700,3389729520,93.26,6.74
315,Wayland,2010,3020718290,219122100,3239840390,93.24,6.76
315,Wayland,2011,2900672500,214012000,3114684500,93.13,6.87
315,Wayland,2012,2920263000,219167600,3139430600,93.02,6.98
315,Wayland,2013,2907556710,227487100,3135043810,92.74,7.26
315,Wayland,2014,2978114500,214298600,3192413100,93.29,6.71
315,Wayland,2015,3240146400,244864500,3485010900,92.97,7.03
315,Wayland,2016,3366486700,251689600,3618176300,93.04,6.96
316,Webster,2003,1065214150,82866790,1148080940,92.78,7.22
316,Webster,2004,1085778890,83614290,1169393180,92.85,7.15
316,Webster,2005,1357014080,86958700,1443972780,93.98,6.02
316,Webster,2006,1578524760,95469800,1673994560,94.3,5.7
316,Webster,2007,1675730520,95992900,1771723420,94.58,5.42
316,Webster,2008,1712843870,128789700,1841633570,93.01,6.99
316,Webster,2009,1670949540,133476500,1804426040,92.6,7.4
316,Webster,2010,1552795850,130100500,1682896350,92.27,7.73
316,Webster,2011,1436202790,121618100,1557820890,92.19,7.81
316,Webster,2012,1411514180,119330200,1530844380,92.2,7.8
316,Webster,2013,1362391580,117186500,1479578080,92.08,7.92
316,Webster,2014,1350852320,109720700,1460573020,92.49,7.51
316,Webster,2015,1367519500,110274100,1477793600,92.54,7.46
316,Webster,2016,1400262970,134048500,1534311470,91.26,8.74
317,Wellesley,2003,7189273200,245959000,7435232200,96.69,3.31
317,Wellesley,2004,7443761900,661140000,8104901900,91.84,8.16
317,Wellesley,2005,7895988000,797048000,8693036000,90.83,9.17
317,Wellesley,2006,8627841500,957151000,9584992500,90.01,9.99
317,Wellesley,2007,8941927400,958379000,9900306400,90.32,9.68
317,Wellesley,2008,9175647000,977547000,10153194000,90.37,9.63
317,Wellesley,2009,9420912000,1006337000,10427249000,90.35,9.65
317,Wellesley,2010,8981931000,945956000,9927887000,90.47,9.53
317,Wellesley,2011,8761624100,927032000,9688656100,90.43,9.57
317,Wellesley,2012,9149641800,957624000,10107265800,90.53,9.47
317,Wellesley,2013,9355607185,957624000,10313231185,90.71,9.29
317,Wellesley,2014,9755135300,999419000,10754554300,90.71,9.29
317,Wellesley,2015,10387812900,992705000,11380517900,91.28,8.72
317,Wellesley,2016,10774478700,1035264000,11809742700,91.23,8.77
318,Wellfleet,2003,1308494480,68014300,1376508780,95.06,4.94
318,Wellfleet,2004,1848286360,106737400,1955023760,94.54,5.46
318,Wellfleet,2005,2046241890,148884800,2195126690,93.22,6.78
318,Wellfleet,2006,2292227890,164927500,2457155390,93.29,6.71
318,Wellfleet,2007,2503985560,181734900,2685720460,93.23,6.77
318,Wellfleet,2008,2461341540,178200000,2639541540,93.25,6.75
318,Wellfleet,2009,2329108470,170613570,2499722040,93.17,6.83
318,Wellfleet,2010,2189898760,143408400,2333307160,93.85,6.15
318,Wellfleet,2011,2191156890,144702200,2335859090,93.81,6.19
318,Wellfleet,2012,2186720520,147012200,2333732720,93.7,6.3
318,Wellfleet,2013,2169538960,146834410,2316373370,93.66,6.34
318,Wellfleet,2014,2167618940,142097260,2309716200,93.85,6.15
318,Wellfleet,2015,2166650960,143208760,2309859720,93.8,6.2
318,Wellfleet,2016,2252621930,150319180,2402941110,93.74,6.26
319,Wendell,2003,51180765,16788100,67968865,75.3,24.7
319,Wendell,2004,52360993,17413600,69774593,75.04,24.96
319,Wendell,2005,55757382,15486656,71244038,78.26,21.74
319,Wendell,2006,75322654,19468100,94790754,79.46,20.54
319,Wendell,2007,75958295,19740900,95699195,79.37,20.63
319,Wendell,2008,81879299,20993000,102872299,79.59,20.41
319,Wendell,2009,90453379,25211800,115665179,78.2,21.8
319,Wendell,2010,90574687,25882900,116457587,77.77,22.23
319,Wendell,2011,90046400,26039600,116086000,77.57,22.43
319,Wendell,2012,89885550,25632700,115518250,77.81,22.19
319,Wendell,2013,90495180,25625000,116120180,77.93,22.07
319,Wendell,2014,91092330,26027300,117119630,77.78,22.22
319,Wendell,2015,92148368,26152000,118300368,77.89,22.11
319,Wendell,2016,92190410,26165900,118356310,77.89,22.11
320,Wenham,2003,687618285,37873100,725491385,94.78,5.22
320,Wenham,2004,692245572,37846200,730091772,94.82,5.18
320,Wenham,2005,745094602,37435700,782530302,95.22,4.78
320,Wenham,2006,818018565,49036000,867054565,94.34,5.66
320,Wenham,2007,822587133,56294000,878881133,93.59,6.41
320,Wenham,2008,833457209,70402700,903859909,92.21,7.79
320,Wenham,2009,853767317,74090900,927858217,92.01,7.99
320,Wenham,2010,770250958,70894900,841145858,91.57,8.43
320,Wenham,2011,711119125,69346200,780465325,91.11,8.89
320,Wenham,2012,697682438,65766500,763448938,91.39,8.61
320,Wenham,2013,667798528,65208200,733006728,91.1,8.9
320,Wenham,2014,673014292,65209800,738224092,91.17,8.83
320,Wenham,2015,792164911,89374500,881539411,89.86,10.14
320,Wenham,2016,789556796,89296700,878853496,89.84,10.16
321,West Boylston,2003,584012756,99693600,683706356,85.42,14.58
321,West Boylston,2004,647077671,102300900,749378571,86.35,13.65
321,West Boylston,2005,725677940,87079700,812757640,89.29,10.71
321,West Boylston,2006,852855143,129199400,982054543,86.84,13.16
321,West Boylston,2007,878237404,129737300,1007974704,87.13,12.87
321,West Boylston,2008,889799234,111215900,1001015134,88.89,11.11
321,West Boylston,2009,916800922,115244900,1032045822,88.83,11.17
321,West Boylston,2010,858112273,115344800,973457073,88.15,11.85
321,West Boylston,2011,818220620,113841600,932062220,87.79,12.21
321,West Boylston,2012,819969825,113594900,933564725,87.83,12.17
321,West Boylston,2013,806117274,114343800,920461074,87.58,12.42
321,West Boylston,2014,817935949,117226000,935161949,87.46,12.54
321,West Boylston,2015,833283305,116972700,950256005,87.69,12.31
321,West Boylston,2016,857610284,116100800,973711084,88.08,11.92
322,West Bridgewater,2003,798764860,78879800,877644660,91.01,8.99
322,West Bridgewater,2004,806309857,78754500,885064357,91.1,8.9
322,West Bridgewater,2005,923426058,82080300,1005506358,91.84,8.16
322,West Bridgewater,2006,1061035260,80368500,1141403760,92.96,7.04
322,West Bridgewater,2007,1103984710,80867100,1184851810,93.17,6.83
322,West Bridgewater,2008,1125609890,82476000,1208085890,93.17,6.83
322,West Bridgewater,2009,1106362217,85784600,1192146817,92.8,7.2
322,West Bridgewater,2010,1048518431,84816500,1133334931,92.52,7.48
322,West Bridgewater,2011,989819589,84084600,1073904189,92.17,7.83
322,West Bridgewater,2012,975375585,85287800,1060663385,91.96,8.04
322,West Bridgewater,2013,965844939,83613400,1049458339,92.03,7.97
322,West Bridgewater,2014,983721986,84287000,1068008986,92.11,7.89
322,West Bridgewater,2015,1010475104,84200500,1094675604,92.31,7.69
322,West Bridgewater,2016,1045818817,94131000,1139949817,91.74,8.26
323,West Brookfield,2003,232955010,25435400,258390410,90.16,9.84
323,West Brookfield,2004,240363452,25435400,265798852,90.43,9.57
323,West Brookfield,2005,325319779,35796500,361116279,90.09,9.91
323,West Brookfield,2006,368183627,37012300,405195927,90.87,9.13
323,West Brookfield,2007,406813815,40703900,447517715,90.9,9.1
323,West Brookfield,2008,417964551,40902200,458866751,91.09,8.91
323,West Brookfield,2009,421904794,40514600,462419394,91.24,8.76
323,West Brookfield,2010,379475856,37631600,417107456,90.98,9.02
323,West Brookfield,2011,365895882,38767400,404663282,90.42,9.58
323,West Brookfield,2012,370324052,38764900,409088952,90.52,9.48
323,West Brookfield,2013,337289229,31591200,368880429,91.44,8.56
323,West Brookfield,2014,344461236,31965100,376426336,91.51,8.49
323,West Brookfield,2015,336687567,31231900,367919467,91.51,8.49
323,West Brookfield,2016,342385853,31541800,373927653,91.56,8.44
324,West Newbury,2003,539567412,40181800,579749212,93.07,6.93
324,West Newbury,2004,733651653,57633000,791284653,92.72,7.28
324,West Newbury,2005,765149959,59055600,824205559,92.83,7.17
324,West Newbury,2006,791563278,61008900,852572178,92.84,7.16
324,West Newbury,2007,819428309,63528500,882956809,92.81,7.19
324,West Newbury,2008,813013539,64162900,877176439,92.69,7.31
324,West Newbury,2009,792630379,63296500,855926879,92.6,7.4
324,West Newbury,2010,763954702,61149400,825104102,92.59,7.41
324,West Newbury,2011,748934521,60283000,809217521,92.55,7.45
324,West Newbury,2012,722118302,60694400,782812702,92.25,7.75
324,West Newbury,2013,732101740,62077500,794179240,92.18,7.82
324,West Newbury,2014,745425183,62347200,807772383,92.28,7.72
324,West Newbury,2015,773954065,64633400,838587465,92.29,7.71
324,West Newbury,2016,851048604,67929200,918977804,92.61,7.39
325,West Springfield,2003,1585975406,139658100,1725633506,91.91,8.09
325,West Springfield,2004,1653336467,162926700,1816263167,91.03,8.97
325,West Springfield,2005,2066175948,175054900,2241230848,92.19,7.81
325,West Springfield,2006,2191098254,187728600,2378826854,92.11,7.89
325,West Springfield,2007,2453354331,192812600,2646166931,92.71,7.29
325,West Springfield,2008,2626255325,192686700,2818942025,93.16,6.84
325,West Springfield,2009,2654851892,191748300,2846600192,93.26,6.74
325,West Springfield,2010,2574503922,203258800,2777762722,92.68,7.32
325,West Springfield,2011,2580535233,209133400,2789668633,92.5,7.5
325,West Springfield,2012,2554393712,205201000,2759594712,92.56,7.44
325,West Springfield,2013,2563262022,211237900,2774499922,92.39,7.61
325,West Springfield,2014,2637426669,214489000,2851915669,92.48,7.52
325,West Springfield,2015,2647612099,243313800,2890925899,91.58,8.42
325,West Springfield,2016,2715935722,288852925,3004788647,90.39,9.61
326,West Stockbridge,2003,215886214,7882800,223769014,96.48,3.52
326,West Stockbridge,2004,228074989,7895600,235970589,96.65,3.35
326,West Stockbridge,2005,234270827,9085000,243355827,96.27,3.73
326,West Stockbridge,2006,330828310,9503900,340332210,97.21,2.79
326,West Stockbridge,2007,405058806,10575700,415634506,97.46,2.54
326,West Stockbridge,2008,417893644,10757700,428651344,97.49,2.51
326,West Stockbridge,2009,416195895,11551000,427746895,97.3,2.7
326,West Stockbridge,2010,419268697,11304000,430572697,97.37,2.63
326,West Stockbridge,2011,384562312,10705600,395267912,97.29,2.71
326,West Stockbridge,2012,369477300,14316600,383793900,96.27,3.73
326,West Stockbridge,2013,370181634,14316600,384498234,96.28,3.72
326,West Stockbridge,2014,368029027,15146700,383175727,96.05,3.95
326,West Stockbridge,2015,370539378,15073700,385613078,96.09,3.91
326,West Stockbridge,2016,371379468,16718000,388097468,95.69,4.31
327,West Tisbury,2003,1647000907,355775900,2002776807,82.24,17.76
327,West Tisbury,2004,1656064052,354675200,2010739252,82.36,17.64
327,West Tisbury,2005,2203419069,385045200,2588464269,85.12,14.88
327,West Tisbury,2006,2234102161,386055000,2620157161,85.27,14.73
327,West Tisbury,2007,2475033026,419595600,2894628626,85.5,14.5
327,West Tisbury,2008,2714141904,486882400,3201024304,84.79,15.21
327,West Tisbury,2009,2612065658,487423600,3099489258,84.27,15.73
327,West Tisbury,2010,2542553601,490251000,3032804601,83.84,16.16
327,West Tisbury,2011,2433158447,480726900,2913885347,83.5,16.5
327,West Tisbury,2012,2411685767,538627000,2950312767,81.74,18.26
327,West Tisbury,2013,2380518271,535362600,2915880871,81.64,18.36
327,West Tisbury,2014,2385941704,539601400,2925543104,81.56,18.44
327,West Tisbury,2015,2392975860,399494100,2792469960,85.69,14.31
327,West Tisbury,2016,2402730447,396609500,2799339947,85.83,14.17
328,Westborough,2003,2899830031,215030100,3114860131,93.1,6.9
328,Westborough,2004,3050486034,236155600,3286641634,92.81,7.19
328,Westborough,2005,3242442522,245814200,3488256722,92.95,7.05
328,Westborough,2006,3505729243,280469500,3786198743,92.59,7.41
328,Westborough,2007,3719427808,294247300,4013675108,92.67,7.33
328,Westborough,2008,3642009756,300196800,3942206556,92.39,7.61
328,Westborough,2009,3600937940,293745200,3894683140,92.46,7.54
328,Westborough,2010,3392442851,291432900,3683875751,92.09,7.91
328,Westborough,2011,3233974001,284910300,3518884301,91.9,8.1
328,Westborough,2012,3175734433,282874400,3458608833,91.82,8.18
328,Westborough,2013,3288092151,286437900,3574530051,91.99,8.01
328,Westborough,2014,3276225785,286302300,3562528085,91.96,8.04
328,Westborough,2015,3436641258,300620800,3737262058,91.96,8.04
328,Westborough,2016,3677163152,310691450,3987854602,92.21,7.79
329,Westfield,2003,1908017792,264113900,2172131692,87.84,12.16
329,Westfield,2004,2299794449,247963250,2547757699,90.27,9.73
329,Westfield,2005,2368806383,253900900,2622707283,90.32,9.68
329,Westfield,2006,2736614959,256380500,2992995459,91.43,8.57
329,Westfield,2007,3164860532,290081700,3454942232,91.6,8.4
329,Westfield,2008,3202758767,289342600,3492101367,91.71,8.29
329,Westfield,2009,3243930036,300946400,3544876436,91.51,8.49
329,Westfield,2010,3211965484,289066800,3501032284,91.74,8.26
329,Westfield,2011,3171764419,290515800,3462280219,91.61,8.39
329,Westfield,2012,3182645428,287003500,3469648928,91.73,8.27
329,Westfield,2013,3187262666,285437400,3472700066,91.78,8.22
329,Westfield,2014,3047312806,274906300,3322219106,91.73,8.27
329,Westfield,2015,3072169049,275602960,3347772009,91.77,8.23
329,Westfield,2016,3073071671,259893545,3332965216,92.2,7.8
330,Westford,2003,2944209422,208121700,3152331122,93.4,6.6
330,Westford,2004,3208482145,249234200,3457716345,92.79,7.21
330,Westford,2005,3470780788,239870300,3710651088,93.54,6.46
330,Westford,2006,3793951953,237718000,4031669953,94.1,5.9
330,Westford,2007,3894563061,247669300,4142232361,94.02,5.98
330,Westford,2008,3907172157,279218600,4186390757,93.33,6.67
330,Westford,2009,3885827988,277505700,4163333688,93.33,6.67
330,Westford,2010,3822820412,286019300,4108839712,93.04,6.96
330,Westford,2011,3758783545,376363000,4135146545,90.9,9.1
330,Westford,2012,3824755642,376400200,4201155842,91.04,8.96
330,Westford,2013,3839246350,375922200,4215168550,91.08,8.92
330,Westford,2014,3905437388,350815200,4256252588,91.76,8.24
330,Westford,2015,4177511486,377549500,4555060986,91.71,8.29
330,Westford,2016,4314171996,388689500,4702861496,91.74,8.26
331,Westhampton,2003,114065294,18299400,132364694,86.18,13.82
331,Westhampton,2004,151033459,28067745,179101204,84.33,15.67
331,Westhampton,2005,153865400,28026871,181892271,84.59,15.41
331,Westhampton,2006,202788269,30610855,233399124,86.88,13.12
331,Westhampton,2007,230553726,19816500,250370226,92.09,7.91
331,Westhampton,2008,233037176,22304900,255342076,91.26,8.74
331,Westhampton,2009,234709848,22948100,257657948,91.09,8.91
331,Westhampton,2010,231249164,24468800,255717964,90.43,9.57
331,Westhampton,2011,225506858,27629100,253135958,89.09,10.91
331,Westhampton,2012,222787809,27460500,250248309,89.03,10.97
331,Westhampton,2013,214943425,26887500,241830925,88.88,11.12
331,Westhampton,2014,213519738,26850500,240370238,88.83,11.17
331,Westhampton,2015,216064013,27823800,243887813,88.59,11.41
331,Westhampton,2016,223236507,27980700,251217207,88.86,11.14
332,Westminster,2003,533156592,41464800,574621392,92.78,7.22
332,Westminster,2004,762384594,46788400,809172994,94.22,5.78
332,Westminster,2005,813579848,50868700,864448548,94.12,5.88
332,Westminster,2006,937771751,54224000,991995751,94.53,5.47
332,Westminster,2007,1006629579,93289700,1099919279,91.52,8.48
332,Westminster,2008,996231448,94403200,1090634648,91.34,8.66
332,Westminster,2009,1025599650,95779500,1121379150,91.46,8.54
332,Westminster,2010,924592652,91396300,1015988952,91,9
332,Westminster,2011,907543172,87219500,994762672,91.23,8.77
332,Westminster,2012,837708656,82892600,920601256,91,9
332,Westminster,2013,821114124,80100225,901214349,91.11,8.89
332,Westminster,2014,820615452,79827225,900442677,91.13,8.87
332,Westminster,2015,833099735,80943025,914042760,91.14,8.86
332,Westminster,2016,864642103,83471925,948114028,91.2,8.8
333,Weston,2003,3898855500,441088900,4339944400,89.84,10.16
333,Weston,2004,4304171200,476542500,4780713700,90.03,9.97
333,Weston,2005,4625622800,703269800,5328892600,86.8,13.2
333,Weston,2006,4855540000,985374400,5840914400,83.13,16.87
333,Weston,2007,5013872600,990728600,6004601200,83.5,16.5
333,Weston,2008,5102207400,1071276000,6173483400,82.65,17.35
333,Weston,2009,5172262600,1072674000,6244936600,82.82,17.18
333,Weston,2010,5232011700,1072590700,6304602400,82.99,17.01
333,Weston,2011,5260804800,1073076600,6333881400,83.06,16.94
333,Weston,2012,5223472800,1169376900,6392849700,81.71,18.29
333,Weston,2013,5195430200,1175945700,6371375900,81.54,18.46
333,Weston,2014,5340928200,1178367400,6519295600,81.92,18.08
333,Weston,2015,5612459200,1063606900,6676066100,84.07,15.93
333,Weston,2016,5861486000,1070755600,6932241600,84.55,15.45
334,Westport,2003,1762403470,150097900,1912501370,92.15,7.85
334,Westport,2004,1880044700,154326200,2034370900,92.41,7.59
334,Westport,2005,2584794050,193657100,2778451150,93.03,6.97
334,Westport,2006,3114313610,302011800,3416325410,91.16,8.84
334,Westport,2007,3300361620,312371000,3612732620,91.35,8.65
334,Westport,2008,3284716610,361419800,3646136410,90.09,9.91
334,Westport,2009,3374770050,284916500,3659686550,92.21,7.79
334,Westport,2010,3115662470,215124500,3330786970,93.54,6.46
334,Westport,2011,3004027270,210383870,3214411140,93.45,6.55
334,Westport,2012,2987269710,212507600,3199777310,93.36,6.64
334,Westport,2013,2944869380,200031400,3144900780,93.64,6.36
334,Westport,2014,2929442530,201234300,3130676830,93.57,6.43
334,Westport,2015,2941673850,203159400,3144833250,93.54,6.46
334,Westport,2016,3076136560,216855500,3292992060,93.41,6.59
335,Westwood,2003,2903798449,147887300,3051685749,95.15,4.85
335,Westwood,2004,2952058658,148112600,3100171258,95.22,4.78
335,Westwood,2005,3246875955,158523550,3405399505,95.34,4.66
335,Westwood,2006,3649059247,163944700,3813003947,95.7,4.3
335,Westwood,2007,3662134150,164283790,3826417940,95.71,4.29
335,Westwood,2008,3694294449,164593990,3858888439,95.73,4.27
335,Westwood,2009,3735651152,159246710,3894897862,95.91,4.09
335,Westwood,2010,3566682921,175105970,3741788891,95.32,4.68
335,Westwood,2011,3482416355,175365020,3657781375,95.21,4.79
335,Westwood,2012,3484183487,216276670,3700460157,94.16,5.84
335,Westwood,2013,3488168100,217582770,3705750870,94.13,5.87
335,Westwood,2014,3481490687,222962720,3704453407,93.98,6.02
335,Westwood,2015,3660121187,228741700,3888862887,94.12,5.88
335,Westwood,2016,4067622032,224193450,4291815482,94.78,5.22
336,Weymouth,2003,4246343229,426963700,4673306929,90.86,9.14
336,Weymouth,2004,4329406530,429724000,4759130530,90.97,9.03
336,Weymouth,2005,6282958937,521827400,6804786337,92.33,7.67
336,Weymouth,2006,6472757190,523630700,6996387890,92.52,7.48
336,Weymouth,2007,6609585540,525809200,7135394740,92.63,7.37
336,Weymouth,2008,6816425470,686855900,7503281370,90.85,9.15
336,Weymouth,2009,6674046700,688845200,7362891900,90.64,9.36
336,Weymouth,2010,6151439700,670911800,6822351500,90.17,9.83
336,Weymouth,2011,6025446400,707602000,6733048400,89.49,10.51
336,Weymouth,2012,6006054640,715786000,6721840640,89.35,10.65
336,Weymouth,2013,5833504940,732265800,6565770740,88.85,11.15
336,Weymouth,2014,5867770890,747738000,6615508890,88.7,11.3
336,Weymouth,2015,6202774410,741729600,6944504010,89.32,10.68
336,Weymouth,2016,6683708920,795742900,7479451820,89.36,10.64
337,Whately,2003,134817372,7659165,142476537,94.62,5.38
337,Whately,2004,136002971,8256915,144259886,94.28,5.72
337,Whately,2005,168342150,11148712,179490862,93.79,6.21
337,Whately,2006,186380807,11522839,197903646,94.18,5.82
337,Whately,2007,197865506,12843154,210708660,93.9,6.1
337,Whately,2008,222318846,15667100,237985946,93.42,6.58
337,Whately,2009,225518391,15683500,241201891,93.5,6.5
337,Whately,2010,228098535,16596200,244694735,93.22,6.78
337,Whately,2011,219248754,13933500,233182254,94.02,5.98
337,Whately,2012,236900353,14037000,250937353,94.41,5.59
337,Whately,2013,245401469,14112400,259513869,94.56,5.44
337,Whately,2014,247446681,14197100,261643781,94.57,5.43
337,Whately,2015,247952802,14374300,262327102,94.52,5.48
337,Whately,2016,262014034,14544600,276558634,94.74,5.26
338,Whitman,2003,821322246,56042800,877365046,93.61,6.39
338,Whitman,2004,916397241,60112500,976509741,93.84,6.16
338,Whitman,2005,1290256225,70180500,1360436725,94.84,5.16
338,Whitman,2006,1427011188,73916200,1500927388,95.08,4.92
338,Whitman,2007,1488443388,75295800,1563739188,95.18,4.82
338,Whitman,2008,1533931523,75295800,1609227323,95.32,4.68
338,Whitman,2009,1455040708,74520700,1529561408,95.13,4.87
338,Whitman,2010,1403422684,70952400,1474375084,95.19,4.81
338,Whitman,2011,1348669281,68585300,1417254581,95.16,4.84
338,Whitman,2012,1312600286,69136500,1381736786,95,5
338,Whitman,2013,1276035378,68546900,1344582278,94.9,5.1
338,Whitman,2014,1278452142,66853700,1345305842,95.03,4.97
338,Whitman,2015,1315541091,67918200,1383459291,95.09,4.91
338,Whitman,2016,1423288613,68641600,1491930213,95.4,4.6
339,Wilbraham,2003,1040514768,106457300,1146972068,90.72,9.28
339,Wilbraham,2004,1286892781,119101900,1405994681,91.53,8.47
339,Wilbraham,2005,1318322023,123243800,1441565823,91.45,8.55
339,Wilbraham,2006,1533246300,129831300,1663077600,92.19,7.81
339,Wilbraham,2007,1684273100,134931900,1819205000,92.58,7.42
339,Wilbraham,2008,1712612600,136181500,1848794100,92.63,7.37
339,Wilbraham,2009,1735839900,135743000,1871582900,92.75,7.25
339,Wilbraham,2010,1693563000,135242600,1828805600,92.6,7.4
339,Wilbraham,2011,1699562300,136135100,1835697400,92.58,7.42
339,Wilbraham,2012,1668935300,135696100,1804631400,92.48,7.52
339,Wilbraham,2013,1595024200,176692200,1771716400,90.03,9.97
339,Wilbraham,2014,1578098000,177572300,1755670300,89.89,10.11
339,Wilbraham,2015,1596810900,178193800,1775004700,89.96,10.04
339,Wilbraham,2016,1608602600,180935500,1789538100,89.89,10.11
340,Williamsburg,2003,169173092,15085500,184258592,91.81,8.19
340,Williamsburg,2004,218408308,17106200,235514508,92.74,7.26
340,Williamsburg,2005,218715681,17075900,235791581,92.76,7.24
340,Williamsburg,2006,273303991,20568700,293872691,93,7
340,Williamsburg,2007,306843282,22880800,329724082,93.06,6.94
340,Williamsburg,2008,309303964,24446700,333750664,92.68,7.32
340,Williamsburg,2009,313835387,25488500,339323887,92.49,7.51
340,Williamsburg,2010,312297611,25622300,337919911,92.42,7.58
340,Williamsburg,2011,314657513,25492500,340150013,92.51,7.49
340,Williamsburg,2012,308610982,25345600,333956582,92.41,7.59
340,Williamsburg,2013,299172309,23932500,323104809,92.59,7.41
340,Williamsburg,2014,301729237,23942200,325671437,92.65,7.35
340,Williamsburg,2015,303272437,23941900,327214337,92.68,7.32
340,Williamsburg,2016,303338082,24198900,327536982,92.61,7.39
341,Williamstown,2003,709831600,345295000,1055126600,67.27,32.73
341,Williamstown,2004,723156900,381030000,1104186900,65.49,34.51
341,Williamstown,2005,772762800,368190000,1140952800,67.73,32.27
341,Williamstown,2006,938181800,431401000,1369582800,68.5,31.5
341,Williamstown,2007,1022847500,433720000,1456567500,70.22,29.78
341,Williamstown,2008,1038579400,431800000,1470379400,70.63,29.37
341,Williamstown,2009,1115942600,479749000,1595691600,69.93,30.07
341,Williamstown,2010,1071641458,388066000,1459707458,73.41,26.59
341,Williamstown,2011,1076846256,388575300,1465421556,73.48,26.52
341,Williamstown,2012,1030451850,360674700,1391126550,74.07,25.93
341,Williamstown,2013,995250355,356392500,1351642855,73.63,26.37
341,Williamstown,2014,950376594,350534900,1300911494,73.05,26.95
341,Williamstown,2015,959107200,272604800,1231712000,77.87,22.13
341,Williamstown,2016,956447233,290300500,1246747733,76.72,23.28
342,Wilmington,2003,2181281380,141640300,2322921680,93.9,6.1
342,Wilmington,2004,3005246280,184568100,3189814380,94.21,5.79
342,Wilmington,2005,3205135370,190572200,3395707570,94.39,5.61
342,Wilmington,2006,3480988270,199430500,3680418770,94.58,5.42
342,Wilmington,2007,3733214990,227459800,3960674790,94.26,5.74
342,Wilmington,2008,3784640130,228963500,4013603630,94.3,5.7
342,Wilmington,2009,3705355790,266550700,3971906490,93.29,6.71
342,Wilmington,2010,3497381090,192333300,3689714390,94.79,5.21
342,Wilmington,2011,3524548250,193708700,3718256950,94.79,5.21
342,Wilmington,2012,3530085710,195954600,3726040310,94.74,5.26
342,Wilmington,2013,3452284420,214929700,3667214120,94.14,5.86
342,Wilmington,2014,3523547028,216456300,3740003328,94.21,5.79
342,Wilmington,2015,3707628129,219511059,3927139188,94.41,5.59
342,Wilmington,2016,3839715204,261030700,4100745904,93.63,6.37
343,Winchendon,2003,469038004,84800758,553838762,84.69,15.31
343,Winchendon,2004,505232513,90185200,595417713,84.85,15.15
343,Winchendon,2005,591532315,105581200,697113515,84.85,15.15
343,Winchendon,2006,699669413,112944000,812613413,86.1,13.9
343,Winchendon,2007,770038210,126628800,896667010,85.88,14.12
343,Winchendon,2008,779857374,128849200,908706574,85.82,14.18
343,Winchendon,2009,768195037,120351639,888546676,86.46,13.54
343,Winchendon,2010,727384406,114817488,842201894,86.37,13.63
343,Winchendon,2011,700782402,108845046,809627448,86.56,13.44
343,Winchendon,2012,663827794,119014806,782842600,84.8,15.2
343,Winchendon,2013,644849588,116475882,761325470,84.7,15.3
343,Winchendon,2014,619275029,115680000,734955029,84.26,15.74
343,Winchendon,2015,616215351,114781250,730996601,84.3,15.7
343,Winchendon,2016,614786324,115623550,730409874,84.17,15.83
344,Winchester,2003,4130472306,233630840,4364103146,94.65,5.35
344,Winchester,2004,4287816266,240953480,4528769746,94.68,5.32
344,Winchester,2005,4854183258,244524360,5098707618,95.2,4.8
344,Winchester,2006,5099467078,247379000,5346846078,95.37,4.63
344,Winchester,2007,5304920618,261390100,5566310718,95.3,4.7
344,Winchester,2008,5450383798,292067600,5742451398,94.91,5.09
344,Winchester,2009,5347432260,295862330,5643294590,94.76,5.24
344,Winchester,2010,5382360300,298877130,5681237430,94.74,5.26
344,Winchester,2011,5339208060,295225470,5634433530,94.76,5.24
344,Winchester,2012,5367101340,297753140,5664854480,94.74,5.26
344,Winchester,2013,5444838530,301560680,5746399210,94.75,5.25
344,Winchester,2014,5686337860,510698276,6197036136,91.76,8.24
344,Winchester,2015,6143076927,555884953,6698961880,91.7,8.3
344,Winchester,2016,6591905517,563987773,7155893290,92.12,7.88
345,Windsor,2003,70722591,7469500,78192091,90.45,9.55
345,Windsor,2004,71099370,7996800,79096170,89.89,10.11
345,Windsor,2005,72879240,8100200,80979440,90,10
345,Windsor,2006,90185447,15761200,105946647,85.12,14.88
345,Windsor,2007,93428496,15661800,109090296,85.64,14.36
345,Windsor,2008,109846334,16073400,125919734,87.24,12.76
345,Windsor,2009,121540860,13320000,134860860,90.12,9.88
345,Windsor,2010,115325230,13536400,128861630,89.5,10.5
345,Windsor,2011,106366436,13502800,119869236,88.74,11.26
345,Windsor,2012,117742592,16758504,134501096,87.54,12.46
345,Windsor,2013,113232572,16749154,129981726,87.11,12.89
345,Windsor,2014,111422444,17008800,128431244,86.76,13.24
345,Windsor,2015,111555713,17527000,129082713,86.42,13.58
345,Windsor,2016,107883908,15131900,123015808,87.7,12.3
346,Winthrop,2003,1570545810,112291100,1682836910,93.33,6.67
346,Winthrop,2004,1576451520,112230500,1688682020,93.35,6.65
346,Winthrop,2005,1866015090,148161600,2014176690,92.64,7.36
346,Winthrop,2006,2041705710,160383600,2202089310,92.72,7.28
346,Winthrop,2007,2102821320,180768800,2283590120,92.08,7.92
346,Winthrop,2008,2066771900,181762900,2248534800,91.92,8.08
346,Winthrop,2009,2000432720,181695000,2182127720,91.67,8.33
346,Winthrop,2010,1815523870,183323000,1998846870,90.83,9.17
346,Winthrop,2011,1714074430,151809200,1865883630,91.86,8.14
346,Winthrop,2012,1677355600,193483600,1870839200,89.66,10.34
346,Winthrop,2013,1666262180,189031200,1855293380,89.81,10.19
346,Winthrop,2014,1642449740,187536600,1829986340,89.75,10.25
346,Winthrop,2015,1839697710,198753000,2038450710,90.25,9.75
346,Winthrop,2016,1913883640,199654200,2113537840,90.55,9.45
347,Woburn,2003,4469162400,284016000,4753178400,94.02,5.98
347,Woburn,2004,4907688100,287716900,5195405000,94.46,5.54
347,Woburn,2005,5229006300,417789100,5646795400,92.6,7.4
347,Woburn,2006,5587995000,459980800,6047975800,92.39,7.61
347,Woburn,2007,5765026700,448853700,6213880400,92.78,7.22
347,Woburn,2008,5864322810,441349700,6305672510,93,7
347,Woburn,2009,5739865490,437655200,6177520690,92.92,7.08
347,Woburn,2010,5560894260,403480900,5964375160,93.24,6.76
347,Woburn,2011,5573118810,404691200,5977810010,93.23,6.77
347,Woburn,2012,5619109630,550440800,6169550430,91.08,8.92
347,Woburn,2013,5716014380,552557200,6268571580,91.19,8.81
347,Woburn,2014,5820155480,554587000,6374742480,91.3,8.7
347,Woburn,2015,6167849490,632798400,6800647890,90.7,9.3
347,Woburn,2016,6486536260,1084769100,7571305360,85.67,14.33
348,Worcester,2003,7621077900,2110469000,9731546900,78.31,21.69
348,Worcester,2004,8818751900,2449698200,11268450100,78.26,21.74
348,Worcester,2005,10360089100,2445616000,12805705100,80.9,19.1
348,Worcester,2006,11595527700,2494021200,14089548900,82.3,17.7
348,Worcester,2007,12563051200,2768325600,15331376800,81.94,18.06
348,Worcester,2008,12726994400,2890917000,15617911400,81.49,18.51
348,Worcester,2009,12137258500,3004042200,15141300700,80.16,19.84
348,Worcester,2010,10911942365,2996064835,13908007200,78.46,21.54
348,Worcester,2011,10856862089,2960568711,13817430800,78.57,21.43
348,Worcester,2012,11277616303,4460004458,15737620761,71.66,28.34
348,Worcester,2013,10878856279,4419631018,15298487297,71.11,28.89
348,Worcester,2014,11030010983,4920225173,15950236156,69.15,30.85
348,Worcester,2015,11171271238,4945157390,16116428628,69.32,30.68
348,Worcester,2016,11236881245,4948795642,16185676887,69.42,30.58
349,Worthington,2003,94926509,6934100,101860609,93.19,6.81
349,Worthington,2004,97136454,6951700,104088154,93.32,6.68
349,Worthington,2005,125711177,11123900,136835077,91.87,8.13
349,Worthington,2006,133115341,12142100,145257441,91.64,8.36
349,Worthington,2007,156509726,14240000,170749726,91.66,8.34
349,Worthington,2008,171074436,16582000,187656436,91.16,8.84
349,Worthington,2009,173622664,16576300,190198964,91.28,8.72
349,Worthington,2010,175492339,16925000,192417339,91.2,8.8
349,Worthington,2011,179959035,18446500,198405535,90.7,9.3
349,Worthington,2012,162042136,17117000,179159136,90.45,9.55
349,Worthington,2013,162680088,17118100,179798188,90.48,9.52
349,Worthington,2014,162923448,17119600,180043048,90.49,9.51
349,Worthington,2015,167236113,19925200,187161313,89.35,10.65
349,Worthington,2016,166713849,20117700,186831549,89.23,10.77
350,Wrentham,2003,1227702430,112516500,1340218930,91.6,8.4
350,Wrentham,2004,1521504610,132831500,1654336110,91.97,8.03
350,Wrentham,2005,1646454790,133447900,1779902690,92.5,7.5
350,Wrentham,2006,1798741820,156337100,1955078920,92,8
350,Wrentham,2007,1899519290,159770800,2059290090,92.24,7.76
350,Wrentham,2008,1870754680,157725400,2028480080,92.22,7.78
350,Wrentham,2009,1825972760,162773300,1988746060,91.82,8.18
350,Wrentham,2010,1764415790,160001200,1924416990,91.69,8.31
350,Wrentham,2011,1702846300,157658100,1860504400,91.53,8.47
350,Wrentham,2012,1704508680,158732900,1863241580,91.48,8.52
350,Wrentham,2013,1688553600,172559500,1861113100,90.73,9.27
350,Wrentham,2014,1716620450,173131100,1889751550,90.84,9.16
350,Wrentham,2015,1802828580,176494800,1979323380,91.08,8.92
350,Wrentham,2016,1958065090,183711500,2141776590,91.42,8.58
351,Yarmouth,2003,2915918800,217592500,3133511300,93.06,6.94
351,Yarmouth,2004,5321833949,299355500,5621189449,94.67,5.33
351,Yarmouth,2005,5332561189,291721400,5624282589,94.81,5.19
351,Yarmouth,2006,6352648826,321113000,6673761826,95.19,4.81
351,Yarmouth,2007,6840485900,409594500,7250080400,94.35,5.65
351,Yarmouth,2008,6482411200,406852600,6889263800,94.09,5.91
351,Yarmouth,2009,6318235300,399056600,6717291900,94.06,5.94
351,Yarmouth,2010,5766802400,340869700,6107672100,94.42,5.58
351,Yarmouth,2011,5435388300,326006700,5761395000,94.34,5.66
351,Yarmouth,2012,5220444900,321141900,5541586800,94.2,5.8
351,Yarmouth,2013,5102298500,308938500,5411237000,94.29,5.71
351,Yarmouth,2014,5065856300,300485700,5366342000,94.4,5.6
351,Yarmouth,2015,5312658300,330162400,5642820700,94.15,5.85
351,Yarmouth,2016,5469918100,339935700,5809853800,94.15,5.85
,,,,,,,
Year_1,SUM_A__TOTALTAXABLEPROPERTYVALUES__,SUM_A__TOTALTAXEXEMPTVALUES__,SUM_A__TOTAL__,TPERCENTOFT,EPERCENTOFT,,
2003,638041388391,87365818247,725407206638,87.96,12.04,,
2004,732916233342,96291647692,829207881034,88.39,11.61,,
2005,830527060250,102874066502,933401126752,88.98,11.02,,
2006,915062308347,114852523686,1029914832033,88.85,11.15,,
2007,982718590191,125063539132,1107782129323,88.71,11.29,,
2008,991718349190,127966089361,1119684438551,88.57,11.43,,
2009,976306499319,136883480387,1113189979706,87.7,12.3,,
2010,934718585752,133535019239,1068253604991,87.5,12.5,,
2011,907712265228,133515886068,1041228151296,87.18,12.82,,
2012,904793147373,127243869197,1032037016570,87.67,12.33,,
2013,904081212077,138765788900,1042847000977,86.69,13.31,,
2014,919752023249,144849636342,1064601659591,86.39,13.61,,
2015,968472803536,151646282457,1120119085993,86.46,13.54,,
,,,,,,,