"Municipal","F_year","Total Budget","Residential","Open Space","Commercial","Industrial","Personal Property","Total Levy"
"Abington","2003",32728571.75,14091729,0,1634200,203531,352540,16282000
"Abington","2004",33460683.07,16190475,0,1467471,199513,347702,18205161
"Abington","2005",35924152.51,17058536,0,1725512,234563,306809,19325420
"Abington","2006",39731412.16,17788540,0,1970248,258294,305607,20322689
"Abington","2007",43207964.11,19117571,0,2209809,251847,317854,21897081
"Abington","2008",43813673.18,19292140,0,2358395,265473,361778,22277786
"Abington","2009",47011532.36,21082103,0,2641578,303976,450619,24478276
"Abington","2010",43629169.5,21846515,0,2861285,304765,514680,25527245
"Abington","2011",44697691.23,22877359,0,3050037,310909,646622,26884927
"Abington","2012",46934186.06,23178847,0,3055774,321921,572770,27129312
"Abington","2013",47342153.62,23969410,0,3143844,338378,588912,28040544
"Acton","2003",57504888.41,36590043,0,3601992,1241819,486956,41920810
"Acton","2004",64445851.97,40670679,0,3956132,1384771,689566,46701148
"Acton","2005",68881312.47,42855278,0,3965401,1363670,734190,48918539
"Acton","2006",68977826.55,48388760,0,4524519,1555226,590910,55059415
"Acton","2007",72881896.74,50094321,0,5336154,1684866,604000,57719341
"Acton","2008",77314915.73,51324892,0,5512885,1716493,718409,59272679
"Acton","2009",80925052.3,53769049,0,5559306,1711118,968774,62008247
"Acton","2010",82498451.54,55769176,0,5497569,1675574,1110816,64053135
"Acton","2011",85551488.14,57398208,0,5590238,1644477,1192268,65825191
"Acton","2012",85484019.69,59085091,0,5550450,1703587,1211627,67550755
"Acton","2013",87895061.29,61275263,0,5976485,1798426,1220951,70271125
"Acushnet","2003",21492265.63,8290981,0,387661,339835,298013,9316490
"Acushnet","2004",22907878.24,8921375,0,439919,533639,260430,10155363
"Acushnet","2005",23457794.08,9596142,0,366034,460488,223603,10646267
"Acushnet","2006",24820766.66,9980913,0,360231,375565,198610,10915319
"Acushnet","2007",25624194.86,10585823,0,369414,361552,196150,11512939
"Acushnet","2008",26875499.36,10798074,0,387632,380351,230513,11796570
"Acushnet","2009",27279303.8,11164636,0,404891,391876,294224,12255627
"Acushnet","2010",26539461.28,11551731,0,430929,366522,335047,12684229
"Acushnet","2011",27040316.62,11872193,0,453670,373037,373841,13072741
"Acushnet","2012",27701330.09,12200222,0,491871,387385,447308,13526786
"Acushnet","2013",28262209.72,12517607,0,529951,409139,498326,13955023
"Adams","2003",11292756.47,4485390,0,584414,407101,324636,5801541
"Adams","2004",11552610.91,4707412,0,597274,427333,335317,6067336
"Adams","2005",12262738.2,5148537,0,621609,438033,337397,6545576
"Adams","2006",12702231.65,5268654,0,646356,449674,311044,6675728
"Adams","2007",13518883.1,5798557,0,706922,497501,346773,7349753
"Adams","2008",13332857.05,5985232,0,666702,521904,341251,7515089
"Adams","2009",14158695.69,6291215,0,692019,545259,429347,7957840
"Adams","2010",13690519.94,6290748,0,625539,499283,396873,7812443
"Adams","2011",13437737.3,6616422,0,648160,523077,410307,8197966
"Adams","2012",13056942.29,7082262,0,695169,566323,452072,8795826
"Adams","2013",13596816.38,7029068,0,709379,565641,467335,8771423
"Agawam","2003",64099999.3,19694097,0,4249884,6645206,2605508,33194695
"Agawam","2004",64047815.26,21138113,0,4465889,5966605,3611218,35181825
"Agawam","2005",66210859.23,22530691,0,5610169,6156878,3671606,37969344
"Agawam","2006",70524557.13,23466856,0,6203753,6632569,3100473,39403651
"Agawam","2007",74304342.13,25234456,0,6100445,6565265,2974145,40874311
"Agawam","2008",77666007.27,26298504,0,6143989,6629662,3010887,42083042
"Agawam","2009",80528424.6,27624866,0,6226323,6030292,2740846,42622327
"Agawam","2010",80578879.02,28786614,0,6435977,6236613,2802625,44261829
"Agawam","2011",81642942.78,29881875,0,6454974,6273258,2994978,45605085
"Agawam","2012",84000550.14,30887173,0,6688174,6243820,3314339,47133506
"Agawam","2013",90634593.67,32014931,0,6826799,5985464,5231141,50058335
"Alford","2003",974340.96,787670,0,10960,140,15272,814042
"Alford","2004",1024945.29,817595,0,9660,140,19996,847391
"Alford","2005",1231546.18,868642,0,9432,0,16564,894638
"Alford","2006",1040390.55,900134,0,9342,136,17126,926738
"Alford","2007",1121606.96,941894,0,9144,137,20540,971715
"Alford","2008",1356563.57,988956,0,9814,113,14704,1013587
"Alford","2009",1231996,1036495,0,8861,117,17525,1062998
"Alford","2010",1346364.7,1093136,0,9233,124,18486,1120979
"Alford","2011",1466647.38,1066414,0,8840,118,16154,1091526
"Alford","2012",1419387.72,1105551,0,7031,121,16660,1129363
"Alford","2013",1277315.26,1116095,0,6967,131,16826,1140019
"Amesbury","2003",44676119.52,19756264,0,1949704,1435018,603745,23744731
"Amesbury","2004",46504281.67,21416434,0,1974932,1353037,556162,25300565
"Amesbury","2005",47357904.01,22398003,0,1820710,1231114,455740,25905567
"Amesbury","2006",50484926.46,23970672,0,1830194,1244569,440695,27486130
"Amesbury","2007",50933052.23,24279176,0,2070861,1529001,480759,28359797
"Amesbury","2008",54610148.18,25738160,0,2571805,1747007,550012,30606984
"Amesbury","2009",55843673.69,28053569,0,2411931,1603404,614549,32683453
"Amesbury","2010",55951772.67,29007565,0,2557154,1690962,642237,33897918
"Amesbury","2011",55353099.71,28673425,0,2549108,1802731,1143570,34168834
"Amesbury","2012",57004210.83,29524649,0,2619994,1804037,1286868,35235548
"Amesbury","2013",58162402.83,29928804,0,2806127,1926447,1263032,35924410
"Amherst","2003",56672544.6,21719548,0,2278072,79187,708209,24785016
"Amherst","2004",59485598.4,22750342,0,2287047,70117,747955,25855461
"Amherst","2005",59718854.65,25641716,0,2270532,74666,615689,28602603
"Amherst","2006",63824132.74,27597486,0,2225570,73806,639122,30535984
"Amherst","2007",67403878.16,28983904,0,2311801,75446,708900,32080051
"Amherst","2008",70166213.39,30228150,0,2287655,77082,802271,33395158
"Amherst","2009",73422737.42,31654521,0,2335621,72198,809087,34871427
"Amherst","2010",71427931.42,32517975,0,2615297,77355,848380,36059007
"Amherst","2011",72456981.18,34807241,0,2724022,78569,922478,38532310
"Amherst","2012",75179227.65,36250802,0,2887813,89955,1115462,40344032
"Amherst","2013",77689577.51,37517255,0,3030827,92917,1158726,41799725
"Andover","2003",110625297.17,51960392,103870,10605091,11333086,1828662,75831101
"Andover","2004",111810612.84,54450344,100436,10642004,12021397,1950159,79164340
"Andover","2005",114893386.36,57782211,108250,10366015,11443486,1967848,81667810
"Andover","2006",120383474.27,62759119,159337,9990212,11409435,1690901,86009004
"Andover","2007",128185806.23,65881296,141575,10683126,11734646,1820640,90261283
"Andover","2008",133966088.52,67849371,139540,11193954,12287402,2607452,94077719
"Andover","2009",138674534.66,69977374,136135,11661921,12978067,3223256,97976753
"Andover","2010",136619405.38,72056708,143330,12081704,13328125,3680249,101290116
"Andover","2011",139893172.31,74257417,151001,12419187,13308940,4521755,104658300
"Andover","2012",144409828.95,76984793,113354,12892759,13622414,5260836,108874156
"Andover","2013",146746402.17,78962157,121766,13197696,13926800,5685094,111893513
"Aquinnah","2003",2341062.95,1742316,0,7846,0,21347,1771509
"Aquinnah","2004",2649841.16,1870796,0,8346,0,24048,1903190
"Aquinnah","2005",2664053.4,1992618,0,8503,0,16146,2017267
"Aquinnah","2006",2966591.41,2045908,0,10432,0,17126,2073466
"Aquinnah","2007",3079136.27,2248038,0,11355,0,20327,2279720
"Aquinnah","2008",3293944,2336950,0,22774,0,21255,2380979
"Aquinnah","2009",3315700.54,2457670,0,24161,0,23460,2505291
"Aquinnah","2010",3471698.63,2638026,0,25799,0,26990,2690815
"Aquinnah","2011",3614605.59,2713155,0,26282,0,26618,2766055
"Aquinnah","2012",3733149.87,2757053,0,33647,0,29290,2819990
"Aquinnah","2013",3751536.14,3044306,0,44782,0,34294,3123382
"Arlington","2003",101306287.95,56962049,1037,3257885,230446,795428,61246845
"Arlington","2004",101870637.04,59880691,0,2883991,199945,775513,63740140
"Arlington","2005",106195893.6,61820467,0,2954889,205582,739032,65719970
"Arlington","2006",112407733.36,69428973,0,3056013,229044,811771,73525801
"Arlington","2007",116958837.64,72656089,0,3171347,238535,712380,76778351
"Arlington","2008",119641220.06,74394576,0,3364378,248917,805505,78813376
"Arlington","2009",124071338.33,76075616,0,3633624,259705,977062,80946007
"Arlington","2010",125265218.07,78508301,0,3560968,253944,1147823,83471036
"Arlington","2011",127089727.41,80795883,0,3677868,260235,1224988,85958974
"Arlington","2012",135505942.79,89256859,0,4060401,286447,1398787,95002494
"Arlington","2013",144445396.08,91871472,0,4522048,219793,1396068,98009381
"Ashburnham","2003",10062464.41,6226611,3363,138832,53803,45036,6467645
"Ashburnham","2004",9760805.85,6204785,2905,119078,46990,39611,6413369
"Ashburnham","2005",11230059.84,7352551,4090,140088,55783,36731,7589243
"Ashburnham","2006",12563265.76,7722949,4167,145219,63510,44308,7980153
"Ashburnham","2007",13540799.77,8306316,4258,164384,60299,47927,8583184
"Ashburnham","2008",14106906.62,8368218,4255,165592,57871,61794,8657730
"Ashburnham","2009",15008209.26,9208378,0,214045,71700,97181,9591304
"Ashburnham","2010",14652663.02,9699773,0,234085,79905,120997,10134760
"Ashburnham","2011",15159819.9,9924890,0,244296,86914,150122,10406222
"Ashburnham","2012",15029837.66,10060587,0,251420,87520,160122,10559649
"Ashburnham","2013",15687703.54,10283729,0,262332,86278,164595,10796934
"Ashby","2003",4541128.71,2913873,0,96229,9200,43712,3063014
"Ashby","2004",4766204.39,3258743,0,100139,11873,48517,3419272
"Ashby","2005",4855776.19,3319796,0,96319,12657,46218,3474990
"Ashby","2006",5281087.64,3458279,0,92706,12285,43561,3606831
"Ashby","2007",5289637.7,3892437,0,142198,13702,46699,4095036
"Ashby","2008",5430887.4,3837578,0,141788,12710,47884,4039960
"Ashby","2009",5563246.89,3980782,0,143761,13400,69625,4207568
"Ashby","2010",5546027.57,4133547,0,122014,13745,84499,4353805
"Ashby","2011",5748964.33,4261242,0,105894,14188,123270,4504594
"Ashby","2012",6058979.83,4362101,0,130525,11734,132662,4637022
"Ashby","2013",6483730.98,4630375,0,151206,12259,148779,4942619
"Ashfield","2003",3129475.82,2001185,0,109753,19306,62234,2192478
"Ashfield","2004",3153072.57,2050855,0,102840,18195,65351,2237241
"Ashfield","2005",3361023.74,2183560,0,109212,19133,60117,2372022
"Ashfield","2006",3659763.37,2240137,0,104356,20865,52720,2418078
"Ashfield","2007",3791815.22,2372512,0,105776,20662,66156,2565106
"Ashfield","2008",3899102.5,2624615,0,108758,22794,64176,2820343
"Ashfield","2009",4156249.81,2698856,0,125543,22604,87705,2934708
"Ashfield","2010",4138174.6,2778461,0,117194,13125,84953,2993733
"Ashfield","2011",4097552.5,2868833,0,118441,13513,97775,3098562
"Ashfield","2012",4009913.78,2979425,0,123406,14432,112088,3229351
"Ashfield","2013",4203641.8,3074613,0,125920,14363,110780,3325676
"Ashland","2003",38620704.24,20496271,160320,1041760,715336,344957,22758644
"Ashland","2004",42526569.63,22117139,130489,1124044,728673,406784,24507129
"Ashland","2005",45643635.75,24364998,138752,1254631,743688,430510,26932579
"Ashland","2006",53707166.54,26715212,17892,1439795,519113,443952,29135964
"Ashland","2007",57086449.38,27736859,10522,1473193,553352,455225,30229151
"Ashland","2008",55153330.55,28491786,9525,1518064,575094,506950,31101419
"Ashland","2009",56084055.81,29444493,5853,1621680,614978,527540,32214544
"Ashland","2010",56083552.19,30300762,4852,1686157,635156,601286,33228213
"Ashland","2011",58064806.31,31141214,5010,1742102,637649,677070,34203045
"Ashland","2012",57718026.08,31979376,5218,1807273,643824,746453,35182144
"Ashland","2013",60476531.05,32670338,5397,1870320,661148,804897,36012100
"Athol","2003",13140863.94,5356790,0,509638,198021,215770,6280219
"Athol","2004",12551794.96,5699227,0,482291,175577,145852,6502947
"Athol","2005",12721291.69,6035581,0,464821,161159,128711,6790272
"Athol","2006",13918029.85,6427899,0,464889,155889,124352,7173029
"Athol","2007",16581318.1,7791608,0,547023,167683,143795,8650109
"Athol","2008",17595559.62,8016593,0,558640,174437,148377,8898047
"Athol","2009",19947617.95,8378969,0,597290,190345,211306,9377910
"Athol","2010",18528975.55,8507215,0,677786,203032,246527,9634560
"Athol","2011",18866734.85,8740593,0,695082,216541,274181,9926397
"Athol","2012",19062878.25,8907898,0,746779,241558,297355,10193590
"Athol","2013",19019017.45,8534594,0,751105,240346,297851,9823896
"Attleboro","2003",96152626.04,27509015,0,5149700,2834671,1433789,36927175
"Attleboro","2004",97254600.22,29337020,0,5459142,3095722,1770164,39662048
"Attleboro","2005",103199588.89,32895710,0,5151125,2847511,1364553,42258899
"Attleboro","2006",108476248.71,35245075,0,4937233,2751639,1362674,44296621
"Attleboro","2007",116655681.11,36796938,0,5166491,3352272,1438056,46753757
"Attleboro","2008",118490121.9,37641578,0,5910779,3544414,1599650,48696421
"Attleboro","2009",121386003.49,38547814,0,6526926,3969603,1962943,51007286
"Attleboro","2010",122568954.1,39747140,0,6805701,4176850,2160011,52889702
"Attleboro","2011",121188968.13,40491512,0,7399157,4483344,2235393,54609406
"Attleboro","2012",124042889.09,41796165,0,7908400,4592453,2358614,56655632
"Attleboro","2013",128348996.56,43259875,0,8290880,4636858,2420622,58608235
"Auburn","2003",33308880.24,11237980,37924,5733737,2086201,633378,19729220
"Auburn","2004",34341711.35,13301024,36964,5302076,2159815,694190,21494069
"Auburn","2005",38360581.59,14780323,34180,6492602,2416337,708491,24431933
"Auburn","2006",39376199.7,14959438,40023,7205359,2629696,837565,25672081
"Auburn","2007",43355051.41,16193066,0,8024726,3011542,811386,28040720
"Auburn","2008",46361212.24,16997732,0,8193700,3068781,1068896,29329109
"Auburn","2009",48132475.33,17659245,0,8518619,3464812,1300470,30943146
"Auburn","2010",48960730.49,19024375,0,8166816,3381287,1281786,31854264
"Auburn","2011",49808081.47,19953837,0,8028448,3377177,1383195,32742657
"Auburn","2012",50612492.86,20701514,0,7882420,3365654,1440545,33390133
"Auburn","2013",53298741.14,21302202,0,7676895,3327529,1525322,33831948
"Avon","2003",13984634.27,3468686,0,1691219,4039084,381818,9580807
"Avon","2004",14813344.12,3662250,0,1753201,4299802,584439,10299692
"Avon","2005",15959705.27,4121918,0,2892539,3978209,599190,11591856
"Avon","2006",16843914.27,4471370,0,3021670,4036110,610639,12139789
"Avon","2007",18900858.83,4813168,0,3125581,4120525,749634,12808908
"Avon","2008",18972239.32,4819104,0,3330432,4453114,907921,13510571
"Avon","2009",19457440.64,4878679,0,3436051,4677978,1315041,14307749
"Avon","2010",20261626.18,4734112,0,3298618,4802927,1314833,14150490
"Avon","2011",19580912.25,5013742,0,3383959,4707194,1854152,14959047
"Avon","2012",21865180.78,5511699,0,3694464,5092742,2032777,16331682
"Avon","2013",21523892.48,5929765,0,3715355,5202635,1949900,16797655
"Ayer","2003",22040462.64,3995955,0,1498916,2716336,2778531,10989738
"Ayer","2004",23772070.13,4646501,0,1801715,3012310,2877994,12338520
"Ayer","2005",24626701.91,4939953,0,1861457,3022616,2596613,12420639
"Ayer","2006",26185273.25,5621845,0,2153505,3299788,2664960,13740098
"Ayer","2007",26854296.81,6016293,0,2146592,3194980,2549126,13906991
"Ayer","2008",28661213.59,6579567,0,2232932,3435719,2396819,14645037
"Ayer","2009",29847914.2,6901306,0,2312950,3576934,2529388,15320578
"Ayer","2010",30016600.99,7209553,0,2377577,3710936,2729941,16028007
"Ayer","2011",32021948.09,7555263,0,2629975,3776420,2778039,16739697
"Ayer","2012",26712734.96,8186182,0,2654587,3828721,2947746,17617236
"Ayer","2013",27088850.07,8465859,0,2747196,4016960,2980395,18210410
"Barnstable","2003",117935754.37,61071003,0,7218829,532780,1768279,70590891
"Barnstable","2004",117528632.14,66253730,0,6392738,500285,1419282,74566035
"Barnstable","2005",122989323.33,68856452,0,6833576,485517,1379486,77555031
"Barnstable","2006",137270958.75,70402627,0,7976300,504130,1592704,80475761
"Barnstable","2007",150696853.44,74852367,0,7102019,428952,835396,83218734
"Barnstable","2008",156517686.42,77278051,0,7461638,424939,876263,86040891
"Barnstable","2009",166387989.31,79506446,0,7979830,481022,1097160,89064458
"Barnstable","2010",162174811.2,81208025,0,8788461,561831,1211545,91769862
"Barnstable","2011",165297175.5,83565582,0,8995868,598906,1418747,94579103
"Barnstable","2012",172626876.14,86077491,0,9149186,603948,1494754,97325379
"Barnstable","2013",169408309.34,88546873,0,9650883,633494,1554771,100386021
"Barre","2003",7421028.34,3542650,0,292539,67754,151937,4054880
"Barre","2004",7953022.44,3597977,0,259378,59828,117189,4034372
"Barre","2005",8786394.99,4160512,0,255763,58296,118135,4592706
"Barre","2006",9079154.68,4397768,0,273873,60072,113288,4845001
"Barre","2007",9245961.09,4435798,0,282205,63583,106036,4887622
"Barre","2008",9803027.49,4721543,0,291294,64238,104346,5181421
"Barre","2009",10025539.66,4675832,0,289746,60855,127154,5153587
"Barre","2010",9772387.33,5046719,0,301965,73755,152197,5574636
"Barre","2011",9624812.75,5265296,0,326920,80870,170775,5843861
"Barre","2012",9995948.06,5198594,0,348034,92323,223222,5862173
"Barre","2013",11511615.53,5361194,0,362497,99150,322772,6145613
"Becket","2003",3896212.24,2658537,0,92645,9734,135835,2896751
"Becket","2004",4260738.95,2856605,0,91819,9667,143158,3101249
"Becket","2005",4103243.08,3061014,0,104866,9635,146888,3322403
"Becket","2006",4545436.37,3371131,0,160034,9721,129347,3670233
"Becket","2007",4965220.71,3555724,0,150263,11651,116811,3834449
"Becket","2008",5234349.79,3781354,0,148017,11363,120798,4061532
"Becket","2009",5341557.39,3899017,0,150858,11323,145619,4206817
"Becket","2010",5484264.01,4078030,0,150352,9511,150410,4388303
"Becket","2011",5515187.35,4341057,0,166087,10280,163930,4681354
"Becket","2012",6099617.76,4559761,0,177605,11019,197000,4945385
"Becket","2013",6002713.79,4603387,0,183968,11171,239252,5037778
"Bedford","2003",54060134.41,18170637,67314,8081367,4906572,1266635,32492525
"Bedford","2004",56744715.26,19954890,65644,8477917,5332108,1736685,35567244
"Bedford","2005",58053251.07,21646151,50331,8353127,5283150,1563399,36896158
"Bedford","2006",64306796.26,23624817,46283,8596026,4983949,1648243,38899318
"Bedford","2007",66891044.84,24413538,45584,8950632,5339528,1666028,40415310
"Bedford","2008",70789631.34,25174779,45233,10208123,5699408,1528291,42655834
"Bedford","2009",74081185.54,26707083,45756,10942515,6260440,2063060,46018854
"Bedford","2010",75584699.33,27669541,47460,8004606,8675486,2079100,46476193
"Bedford","2011",78961107.55,30725700,44035,7799416,8479971,2898038,49947160
"Bedford","2012",77236237.8,33090394,27239,7927371,8449361,2806547,52300912
"Bedford","2013",79596311.3,33442243,26399,8170730,8984517,2913740,53537629
"Belchertown","2003",32450547.55,12894765,8003,472744,134602,301667,13811781
"Belchertown","2004",36298925.69,14031706,8674,557115,141947,298103,15037545
"Belchertown","2005",34570180.28,14689045,3351,606218,138189,270007,15706810
"Belchertown","2006",38868138.53,15773889,3545,644720,141238,249742,16813134
"Belchertown","2007",39107241.76,16514140,5059,709673,147025,244068,17619965
"Belchertown","2008",41680599.01,17465853,4692,800582,153124,257369,18681620
"Belchertown","2009",44320348.4,18406393,0,902967,177879,354678,19841917
"Belchertown","2010",44214803.89,18934101,0,979708,182393,374148,20470350
"Belchertown","2011",44609805.98,19554146,0,1028940,183228,390521,21156835
"Belchertown","2012",45363743.7,20137364,0,1049164,193403,473828,21853759
"Belchertown","2013",47315356.6,20777288,0,1095068,201766,477359,22551481
"Bellingham","2003",42275426.46,11911271,0,2365686,903752,4843718,20024427
"Bellingham","2004",45122856.07,13618066,0,2416436,954861,5432054,22421417
"Bellingham","2005",43901362.82,14590630,0,2546024,986073,5526934,23649661
"Bellingham","2006",46986209.81,15633669,0,2704734,1119675,5261940,24720018
"Bellingham","2007",50452434.75,16772621,0,2896588,1511019,5127438,26307666
"Bellingham","2008",51666447.64,17340448,0,3404783,1715044,4550932,27011207
"Bellingham","2009",52636927.72,18203067,0,3480357,1728452,4776704,28188580
"Bellingham","2010",51495587.26,18849244,0,3545194,1966607,4963756,29324801
"Bellingham","2011",52205775.83,19866859,0,3388212,1844517,5345712,30445300
"Bellingham","2012",53403122.58,20602222,0,3428980,1859535,5347034,31237771
"Bellingham","2013",55163607.23,21253878,0,3851514,2104185,4916798,32126375
"Belmont","2003",73161159.14,44608279,0,2183562,158380,213567,47163788
"Belmont","2004",76153528.93,48297587,0,2366124,161753,222234,51047698
"Belmont","2005",80522395.07,50592189,0,2351588,161494,205254,53310525
"Belmont","2006",81308856.92,52458813,0,2392037,157576,212034,55220460
"Belmont","2007",89858789.67,54470950,0,2621335,158393,231258,57481936
"Belmont","2008",93646968.66,56657132,0,2836330,171935,281741,59947138
"Belmont","2009",93608248.15,58893974,0,3025844,182512,411214,62513544
"Belmont","2010",93393655.99,60534081,0,3140668,182680,482709,64340138
"Belmont","2011",96592809.42,63526359,0,3383942,199408,555866,67665575
"Belmont","2012",99962702.71,65650903,0,3428235,199182,589045,69867365
"Belmont","2013",104637725,67971721,0,3302088,198684,585029,72057522
"Berkley","2003",12872862.56,4262385,0,130242,51783,57665,4502075
"Berkley","2004",13090778.83,4759851,0,181573,28445,62241,5032110
"Berkley","2005",13440964.31,4987788,0,177877,22856,80919,5269440
"Berkley","2006",13955408.07,5292204,0,182954,24797,68923,5568878
"Berkley","2007",16670667.71,6553194,0,141370,31910,83255,6809729
"Berkley","2008",16608445.49,6332339,0,135713,32316,79104,6579472
"Berkley","2009",16655376.28,6948433,0,158567,34002,122522,7263524
"Berkley","2010",16232317.94,7021043,0,161545,33080,124966,7340634
"Berkley","2011",17087998.09,8427154,0,190448,40926,177121,8835649
"Berkley","2012",17534906.69,8481727,0,190341,41507,181379,8894954
"Berkley","2013",17245253.4,8508556,0,187841,40625,186430,8923452
"Berlin","2003",7109633.06,3312781,0,1226796,70168,106157,4715902
"Berlin","2004",7834233.77,4066756,0,1297567,86413,102774,5553510
"Berlin","2005",8394860.89,4381913,0,1269059,77307,112680,5840959
"Berlin","2006",8444159.81,4741529,0,1242446,108402,123777,6216154
"Berlin","2007",9203066.64,4904490,0,1294730,106076,90553,6395849
"Berlin","2008",9383218.59,5095692,0,1363199,109229,110746,6678866
"Berlin","2009",13298020.05,5421713,0,1436005,113715,124176,7095609
"Berlin","2010",9703914.22,5613116,0,1586014,127678,151053,7477861
"Berlin","2011",9844357.83,5812132,0,1829324,143799,152090,7937345
"Berlin","2012",10941017.06,6034960,27660,1951720,169283,200211,8383834
"Berlin","2013",11147116.45,5893451,32895,2364194,192187,226660,8709387
"Bernardston","2003",3837574.27,1799418,0,212628,62227,59406,2133679
"Bernardston","2004",3631813.5,1886700,0,172383,56294,58718,2174095
"Bernardston","2005",3611167.78,2215917,0,193147,66588,59630,2535282
"Bernardston","2006",4212789.69,2284343,0,184633,61347,47189,2577512
"Bernardston","2007",4509896.55,2659757,0,197334,50954,49684,2957729
"Bernardston","2008",4482577.5,2914909,0,212554,54901,57779,3240143
"Bernardston","2009",4601539.48,2953944,0,215626,56151,68808,3294529
"Bernardston","2010",4141569.31,2946718,0,210557,54349,72681,3284305
"Bernardston","2011",4233785.06,3039798,0,216552,57750,79687,3393787
"Bernardston","2012",4352401.32,3083770,0,233107,60509,120940,3498326
"Bernardston","2013",4505764.69,3052424,0,286202,66671,152551,3557848
"Beverly","2003",91850202.8,42684017,7111,7059531,2726747,1401814,53879220
"Beverly","2004",95256133.13,44402077,7239,7618614,2720600,1466367,56214897
"Beverly","2005",97602101.75,46992959,6912,7978453,2537340,2075317,59590981
"Beverly","2006",105240289.52,49203468,7105,8045574,2711256,2166381,62133784
"Beverly","2007",108740939.04,51384913,7292,8935785,2774410,2184341,65286741
"Beverly","2008",112474666.44,53316134,7647,9384727,2842740,2303862,67855110
"Beverly","2009",113541063.5,54512451,7742,10271414,2999455,2601524,70392586
"Beverly","2010",116900539.99,56067825,8291,10894015,3295446,2859496,73125073
"Beverly","2011",114419309.01,58259804,8740,11233113,3453226,2942868,75897751
"Beverly","2012",117267968.39,60603449,9134,11436877,3647702,3041965,78739127
"Beverly","2013",122227798.39,62482340,9606,12089190,3772006,3206551,81559693
"Billerica","2003",103996553.21,35177334,0,5631070,20676728,2401707,63886839
"Billerica","2004",105446711.26,38672198,0,5672885,20215201,3848431,68408715
"Billerica","2005",111269443.57,42469652,0,5512643,20214787,2926720,71123802
"Billerica","2006",116183918.67,45919657,0,6068619,20044351,2739817,74772444
"Billerica","2007",120553020.7,47469716,0,6367442,20790605,3723507,78351270
"Billerica","2008",127067545.95,49366929,0,6808332,21871884,3962940,82010085
"Billerica","2009",132924451.22,50576978,0,7751988,22964728,4335965,85629659
"Billerica","2010",130690090.89,52299217,0,8116030,23813487,4494018,88722752
"Billerica","2011",136301401.89,54632512,0,8764315,23945533,6098792,93441152
"Billerica","2012",140697266.5,56072379,0,8526006,25003809,7094804,96696998
"Billerica","2013",146560626.63,57336408,0,8834081,25723702,7378095,99272286
"Blackstone","2003",15047316.6,6231552,0,224572,806482,2325275,9587881
"Blackstone","2004",14523999.87,6822384,0,241921,477283,2758440,10300028
"Blackstone","2005",16836224.56,7582162,0,249828,491740,2703830,11027560
"Blackstone","2006",17847076.92,8239186,0,257844,447912,2617357,11562299
"Blackstone","2007",17769111.47,9317202,0,284809,425678,1971139,11998828
"Blackstone","2008",17900815.03,9560831,0,299839,445608,2064321,12370599
"Blackstone","2009",18353739.17,9842977,0,322988,394353,2034502,12594820
"Blackstone","2010",17642296.89,10564833,0,345932,424699,2078189,13413653
"Blackstone","2011",18216486.38,10754001,0,357287,434939,2142135,13688362
"Blackstone","2012",20993782.9,11058459,0,376709,436102,2183037,14054307
"Blackstone","2013",21700786.19,11546198,0,406873,452117,2257587,14662775
"Blandford","2003",2226553.16,1356645,0,63792,3268,125302,1549007
"Blandford","2004",2151383.09,1310389,0,67734,2868,127004,1507995
"Blandford","2005",2279737.9,1221576,0,70347,2756,115741,1410420
"Blandford","2006",2411317.81,1303606,0,62183,3125,95962,1464876
"Blandford","2007",3129711.54,1369935,0,63048,3390,108862,1545235
"Blandford","2008",3184072.55,1530397,0,64661,3582,122383,1721023
"Blandford","2009",3294572.15,1817450,0,82078,4929,153376,2057833
"Blandford","2010",3313697.43,1872572,0,87679,5100,176443,2141794
"Blandford","2011",3346790.17,1921897,0,88418,6706,204835,2221856
"Blandford","2012",3504540.15,1952295,0,93340,6952,223758,2276345
"Blandford","2013",3588776.09,2027325,0,86006,7145,300404,2420880
"Bolton","2003",14211031.08,9300864,0,817127,60802,138599,10317392
"Bolton","2004",14444370.21,9838791,0,875021,64373,262825,11041010
"Bolton","2005",15198232.94,10736180,0,963060,68355,484749,12252344
"Bolton","2006",16018728.22,11586806,0,772655,208957,467869,13036287
"Bolton","2007",16848670.17,12469795,0,745500,212541,457999,13885835
"Bolton","2008",17485466.16,13193540,0,667377,227974,499828,14588719
"Bolton","2009",18694746.06,13658207,0,765477,258467,781538,15463689
"Bolton","2010",19210118.04,14819269,0,805262,230540,549064,16404135
"Bolton","2011",19663392.87,15501159,0,801861,236745,513619,17053384
"Bolton","2012",19618799.7,15961585,0,798107,225454,428695,17413841
"Bolton","2013",20578285.31,16569220,0,814245,234964,401813,18020242
"Boston","2003",1918208864.89,330356225,0,586974803,18979963,98959820,1035270811
"Boston","2004",1902195681.95,371868680,0,587557871,21244004,113266072,1093936627
"Boston","2005",1981264595.47,415504174,0,609915943,20926631,102395159,1148741907
"Boston","2006",2100040244.71,469312663,0,615286681,20866180,102154332,1207619856
"Boston","2007",2208331635.74,538787733,0,616323611,20683022,94465473,1270259839
"Boston","2008",2374542837.35,539055047,0,674218593,22703162,98301568,1334278370
"Boston","2009",2479269842.93,507499242,0,764453531,21950465,106111340,1400014578
"Boston","2010",2447610106.7,554938764,0,761864723,23474080,124780341,1465057908
"Boston","2011",2471239211.21,601112424,0,781312487,21092318,136162595,1539679824
"Boston","2012",2437477169.34,625063442,0,823244546,21555260,144165586,1614028834
"Boston","2013",2530364148.64,659303136,0,855314259,22618189,146445496,1683681080
"Bourne","2003",48401065.21,20962842,6497,2120206,165818,522005,23777368
"Bourne","2004",50806241.99,22353008,3352,2103641,169383,539855,25169239
"Bourne","2005",57341117.83,23902085,4077,2138840,180110,535508,26760620
"Bourne","2006",62309225.03,26476081,1824,2310694,202870,456703,29448172
"Bourne","2007",63360483.89,27597751,2000,2419119,219013,466924,30704807
"Bourne","2008",69482117.2,28625919,2067,2524024,216887,532854,31901751
"Bourne","2009",71033632.02,30138475,0,2952078,245983,678869,34015405
"Bourne","2010",63933257.98,30806322,0,2975094,251644,725442,34758502
"Bourne","2011",66046525.09,31772903,0,3211324,272604,818927,36075758
"Bourne","2012",64518740.71,32633517,0,3450011,286865,912130,37282523
"Bourne","2013",71724619.74,33811668,0,3536661,295347,939644,38583320
"Boxborough","2003",14980647.26,8391192,0,967969,1511190,94248,10964599
"Boxborough","2004",15433221.11,8903872,0,1084693,1648147,114257,11750969
"Boxborough","2005",16184012.76,9283794,0,1058867,1687486,116146,12146293
"Boxborough","2006",17603462.42,10355081,0,1123763,1890279,132984,13502107
"Boxborough","2007",18588798.75,11045926,0,1119272,1955859,138623,14259680
"Boxborough","2008",19187802.18,11472457,0,1203039,1995432,207119,14878047
"Boxborough","2009",19594338.07,11638851,0,1341388,2165889,272465,15418593
"Boxborough","2010",19948025.15,11935703,0,1341843,2286998,326253,15890797
"Boxborough","2011",20026987.21,12457699,0,1291852,2257935,392039,16399525
"Boxborough","2012",20724915.42,12714855,0,1353725,2288621,517731,16874932
"Boxborough","2013",20716695.36,12579998,0,1370878,2246194,519085,16716155
"Boxford","2003",24128565.54,15865276,28463,156726,6913,182317,16239695
"Boxford","2004",23132092.93,16946752,26134,146457,7020,212964,17339327
"Boxford","2005",24277160.16,17301672,24941,135391,6824,337957,17806785
"Boxford","2006",25666372.47,18597296,0,145440,6267,322145,19071148
"Boxford","2007",29300629.29,19156970,0,140632,6391,357044,19661037
"Boxford","2008",30293948.37,20144742,0,147461,6899,398466,20697568
"Boxford","2009",28099611.32,20740699,0,158347,14424,493487,21406957
"Boxford","2010",27214398.79,20863377,0,165121,13875,557582,21599955
"Boxford","2011",27666383.73,21477509,0,178689,14622,574080,22244900
"Boxford","2012",28179873.73,21908876,0,185818,14938,606564,22716196
"Boxford","2013",29470088.08,22658136,0,188915,15855,626939,23489845
"Boylston","2003",9612592.75,5357400,4697,374225,176749,84669,5997740
"Boylston","2004",10619724.76,5603297,5466,361886,178027,111198,6259874
"Boylston","2005",10780237.47,6661695,8296,388759,192912,91301,7342963
"Boylston","2006",11291357.79,6976520,8331,395269,193950,97308,7671378
"Boylston","2007",12012860.49,7366778,8032,406433,205454,83786,8070483
"Boylston","2008",12514148.22,7595265,0,419712,216711,108698,8340386
"Boylston","2009",12658242.96,7720490,0,452738,230621,184833,8588682
"Boylston","2010",13076980.8,7947566,0,477616,245543,162224,8832949
"Boylston","2011",16310503.78,8284670,0,503451,263487,192911,9244519
"Boylston","2012",13025699.57,9082930,0,540686,278810,220880,10123306
"Boylston","2013",13568105.68,9146487,0,564463,282314,240038,10233302
"Braintree","2003",91562581.79,31228155,0,15003512,3142530,848498,50222695
"Braintree","2004",92462225.65,30891770,0,16734419,3450482,1056237,52132908
"Braintree","2005",94415664.31,31984202,0,17067359,3643570,1252169,53947300
"Braintree","2006",100071232.89,33646738,0,17458711,3692078,1208921,56006448
"Braintree","2007",107306975.46,36149286,0,17093880,3618359,1250087,58111612
"Braintree","2008",110501410.66,38458704,0,17143603,3602627,1332431,60537365
"Braintree","2009",110243934.58,39128008,0,18761612,3896617,1848202,63634439
"Braintree","2010",111831335.73,40144103,0,20171314,4187444,1798591,66301452
"Braintree","2011",115807078.59,40781698,0,21696766,4475986,2156235,69110685
"Braintree","2012",118326331.4,42527851,0,21925560,4282173,2236964,70972548
"Braintree","2013",124472983.96,43651715,0,23643400,4651722,2457319,74404156
"Brewster","2003",32638015.18,16399942,0,902534,42105,337321,17681902
"Brewster","2004",31628816.95,17586753,0,893937,71920,346198,18898808
"Brewster","2005",32530072.59,18342543,0,771574,63168,335964,19513249
"Brewster","2006",35537290.39,19228979,0,790779,45505,314257,20379520
"Brewster","2007",36900123.93,20039916,0,853528,50948,175379,21119771
"Brewster","2008",38372404.27,20308984,0,886856,52123,169443,21417406
"Brewster","2009",42877891.58,21311924,0,961509,60170,200745,22534348
"Brewster","2010",38841540.5,21946447,0,1020703,62534,237933,23267617
"Brewster","2011",37970623.94,22395451,0,1052661,64543,274940,23787595
"Brewster","2012",40537968.13,23462560,0,1088673,66116,278248,24895597
"Brewster","2013",42351495.51,24256972,0,1123517,77263,297827,25755579
"Bridgewater","2003",39699123.1,18897491,0,1123998,479032,443111,20943632
"Bridgewater","2004",38108908.05,19739113,0,1201265,492746,485737,21918861
"Bridgewater","2005",37999306.14,21043160,0,1071716,436062,424067,22975005
"Bridgewater","2006",43391368.44,22486576,0,1288859,575243,477900,24828578
"Bridgewater","2007",45629345.68,24100731,0,1376863,630074,472605,26580273
"Bridgewater","2008",49474196.52,25264561,0,1506421,668408,547934,27987324
"Bridgewater","2009",51835973.28,26233427,0,1918084,808560,712953,29673024
"Bridgewater","2010",49067220.46,26436194,0,2048958,845086,775924,30106162
"Bridgewater","2011",51408828.58,29597308,0,2332237,968312,866111,33763968
"Bridgewater","2012",52364336.92,30363312,0,2432455,1080875,930459,34807101
"Bridgewater","2013",54983176.01,31169485,0,2679493,1096972,975811,35921761
"Brimfield","2003",7459559.11,3558043,0,322594,59775,129726,4070138
"Brimfield","2004",7677161,3873934,0,322033,63292,168960,4428219
"Brimfield","2005",7493723.1,4175124,0,308602,61276,124425,4669427
"Brimfield","2006",8225327.4,4402248,0,288601,57120,117040,4865009
"Brimfield","2007",8349333.47,4390898,0,280869,55680,110881,4838328
"Brimfield","2008",8845310.45,4604585,0,298317,54775,120748,5078425
"Brimfield","2009",8555341.26,4763203,0,306713,55839,154009,5279764
"Brimfield","2010",8392097.81,4762874,0,325381,57376,150655,5296286
"Brimfield","2011",8329571,4979799,0,366723,66672,172183,5585377
"Brimfield","2012",8413583.04,5147750,0,384785,69655,194991,5797181
"Brimfield","2013",8430527.77,5334381,0,396807,71410,221804,6024402
"Brockton","2003",279981206.9,51091263,0,17416436,4305804,3033665,75847168
"Brockton","2004",284687698.82,55385231,0,16331614,4002910,2829440,78549195
"Brockton","2005",280111686.19,58961276,0,17175617,4129196,2817343,83083432
"Brockton","2006",291739322.51,61568628,0,17876559,4317553,2438134,86200874
"Brockton","2007",304622051.39,64691811,0,17979032,4206207,2592948,89469998
"Brockton","2008",314680204.71,64045448,0,21172557,4757394,2796887,92772286
"Brockton","2009",324638788.7,63799719,0,23488426,5237908,3854953,96381006
"Brockton","2010",320515028.28,62700316,0,26302974,5634074,5192962,99830326
"Brockton","2011",332645320.91,67558999,0,25310864,5133521,5331220,103334604
"Brockton","2012",350118272.59,70768901,0,26964142,5046183,5437991,108217217
"Brockton","2013",367289601.16,71389769,0,28650281,5308370,6151841,111500261
"Brookfield","2003",6763829.93,2636965,0,158492,15755,85420,2896632
"Brookfield","2004",7556972.8,2827664,0,129880,15492,72260,3045296
"Brookfield","2005",6739273.01,3091868,0,134330,17283,75573,3319054
"Brookfield","2006",7101704.05,3282585,0,136510,19938,63094,3502127
"Brookfield","2007",7459474.05,3429733,0,133119,22190,55588,3640630
"Brookfield","2008",8006784.18,3698305,0,136438,24115,66384,3925242
"Brookfield","2009",7797802.82,3798517,0,144964,29581,81422,4054484
"Brookfield","2010",7797236.57,3914913,0,152864,30780,87385,4185942
"Brookfield","2011",7608207.29,3983809,0,155177,32075,97703,4268764
"Brookfield","2012",7982967.61,4066676,0,159291,33764,108439,4368170
"Brookfield","2013",7954767.5,4115628,0,159792,34300,106666,4416386
"Brookline","2003",175490435.95,92077267,0,15148189,213670,2092933,109532059
"Brookline","2004",179841370,96785156,0,15561395,212125,2101807,114660483
"Brookline","2005",190006169.67,101040049,0,16586324,226436,1999395,119852204
"Brookline","2006",191990098.22,105772647,0,17308643,178464,1755085,125014839
"Brookline","2007",201080496.66,109748548,0,18245847,184251,1897888,130076534
"Brookline","2008",207561587.61,113856223,0,19621824,195338,2138515,135811900
"Brookline","2009",221930852.46,123770116,0,20972982,232209,2297761,147273068
"Brookline","2010",227035081.57,127971535,0,22008755,240706,2460176,152681172
"Brookline","2011",224592463.98,132704728,0,22266873,245531,2661155,157878287
"Brookline","2012",232739180.27,136876274,0,23151956,262628,3329629,163620487
"Brookline","2013",249108385.95,142186600,0,24179492,269850,3501667,170137609
"Buckland","2003",3223430.94,1634554,0,97623,190463,134696,2057336
"Buckland","2004",3051603.84,1659876,0,100520,196189,126874,2083459
"Buckland","2005",3243973.44,1797509,0,101986,194231,125622,2219348
"Buckland","2006",3966807.23,2049464,0,100552,210709,127929,2488654
"Buckland","2007",3832955.87,2191151,0,105824,353574,56387,2706936
"Buckland","2008",4123911.44,2272563,0,108687,359508,62208,2802966
"Buckland","2009",4169590.31,2385081,0,116693,374082,76517,2952373
"Buckland","2010",4247650.49,2418779,0,118312,369847,81763,2988701
"Buckland","2011",4285787.34,2468140,0,126055,378704,88391,3061290
"Buckland","2012",4181198.48,2495314,0,127385,391855,91465,3106019
"Buckland","2013",4201281.99,2547176,0,126940,399370,93595,3167081
"Burlington","2003",78620773.09,18750636,0,27341563,4219228,2865920,53177347
"Burlington","2004",79094355.94,20291979,0,26130972,6028230,3716788,56167969
"Burlington","2005",81922588.46,21917290,0,26561005,6626654,3633092,58738041
"Burlington","2006",87791298.3,27060184,0,25687790,6157934,3036392,61942300
"Burlington","2007",91015103.92,29010872,0,26554784,6005532,2835939,64407127
"Burlington","2008",99861234.26,29766495,0,31687913,5019205,3042405,69516018
"Burlington","2009",105203542.84,30701171,0,35834604,5255587,3425749,75217111
"Burlington","2010",106802730.92,32028157,0,37649233,5241352,4064248,78982990
"Burlington","2011",109869499.08,33130655,0,39314304,5333981,4257207,82036147
"Burlington","2012",115792243.48,34054223,0,41491361,5523807,4071821,85141212
"Burlington","2013",122344814,35327945,0,43322645,5613566,4384066,88648222
"Cambridge","2003",370803036.56,68316446,0,95180146,27354756,6869198,197720546
"Cambridge","2004",387171564.79,74721486,0,91919342,34489554,8469014,209599396
"Cambridge","2005",406774721.66,86276488,0,91034010,37100337,8542600,222953435
"Cambridge","2006",424070717.31,82130657,0,88048310,41978831,10802493,222960291
"Cambridge","2007",454356277.46,84808073,0,90205363,44707723,12065935,231787094
"Cambridge","2008",477378605.23,85203296,0,95533385,48900505,12697187,242334373
"Cambridge","2009",514295811.66,89163075,0,100743721,51233868,13804913,254945577
"Cambridge","2010",511328287.27,92836959,0,104259163,54484185,17082677,268662984
"Cambridge","2011",507351044.69,98125671,0,110024775,56714827,19096427,283961700
"Cambridge","2012",515644507.46,103348315,0,114021477,61978495,19742350,299090637
"Cambridge","2013",568349379.06,109529460,0,116221691,68186309,23010309,316947769
"Canton","2003",60485103.41,22646324,0,6427308,6891014,1270786,37235432
"Canton","2004",62311714.27,23939042,0,6881247,6883313,1248679,38952281
"Canton","2005",67475733.85,26429509,0,7353033,7260930,1425309,42468781
"Canton","2006",70505935.97,28568772,0,7202711,6962679,1369249,44103411
"Canton","2007",73031652.39,29156888,0,7697637,7339633,1566201,45760359
"Canton","2008",72563102.31,29923246,0,8007990,7353439,1683890,46968565
"Canton","2009",77188498.84,32282272,0,8449050,7661812,2366688,50759822
"Canton","2010",80452072.69,32838961,0,9920864,8250184,2671751,53681760
"Canton","2011",82342676.01,35163615,0,10193029,8314883,2923903,56595430
"Canton","2012",84957443.04,36489190,0,10483208,8091524,3010563,58074485
"Canton","2013",88576946.01,37895052,0,10840500,8257008,3162707,60155267
"Carlisle","2003",18125503.75,14548526,7498,89221,35083,124991,14805319
"Carlisle","2004",19662704.91,15412464,6185,87272,36194,111871,15653986
"Carlisle","2005",20847984.89,15801697,6260,83659,36630,122622,16050868
"Carlisle","2006",21128537.45,16488587,6443,85643,37704,133684,16752061
"Carlisle","2007",21908885.65,17070260,6519,118854,16770,128572,17340975
"Carlisle","2008",23305759.5,18517692,7010,128642,18032,145357,18816733
"Carlisle","2009",23960611.02,19167655,6178,122756,19687,176140,19492416
"Carlisle","2010",24614142.58,19903018,0,144139,19309,193075,20259541
"Carlisle","2011",24363229.74,20573085,0,148261,20185,248200,20989731
"Carlisle","2012",24722156.05,21118300,0,149057,20685,269068,21557110
"Carlisle","2013",25295738.53,21284512,0,120942,20636,282258,21708348
"Carver","2003",27051828.29,10044637,0,1368214,312394,462689,12187934
"Carver","2004",27240923.53,10617822,0,1123593,362670,500674,12604759
"Carver","2005",28064724.05,11096408,0,1300708,385707,442800,13225623
"Carver","2006",30025724.33,12119190,0,1364697,387083,452914,14323884
"Carver","2007",31835860.58,12771996,0,1633393,441517,519932,15366838
"Carver","2008",32323840.84,12862458,0,1574295,461397,647726,15545876
"Carver","2009",33259762.92,13145641,0,1751386,498712,778602,16174341
"Carver","2010",32616103.23,13483976,0,1790033,597471,833561,16705041
"Carver","2011",33237699.31,14001562,0,1884817,622797,1397680,17906856
"Carver","2012",34620094.89,14399076,0,2018716,625040,1458139,18500971
"Carver","2013",34755435.16,14748693,0,2074111,638254,1668368,19129426
"Charlemont","2003",2322483.76,1342761,0,140889,15482,75691,1574823
"Charlemont","2004",2439862.1,1459937,0,146662,14589,76393,1697581
"Charlemont","2005",2762881.13,1563274,0,147829,14118,63266,1788487
"Charlemont","2006",2603034.02,1624263,0,156062,14424,74045,1868794
"Charlemont","2007",2859799.44,1783559,0,154056,14433,66256,2018304
"Charlemont","2008",2975235.12,1687900,0,141672,11691,62781,1904044
"Charlemont","2009",3051171.84,1810925,0,154138,12479,89397,2066939
"Charlemont","2010",2949024.48,1835343,0,153054,12583,90651,2091631
"Charlemont","2011",3114037.31,1828215,0,148898,12078,107096,2096287
"Charlemont","2012",3245473.66,1841568,0,154571,12161,106580,2114880
"Charlemont","2013",2971990.63,1897930,0,158771,12881,118538,2188120
"Charlton","2003",17075980.59,8786030,0,600075,465575,518115,10369795
"Charlton","2004",16692084.69,9390212,0,656867,481462,624811,11153352
"Charlton","2005",18133585.53,10208843,0,588413,436138,414717,11648111
"Charlton","2006",21817537.8,11034074,0,579502,431516,408280,12453372
"Charlton","2007",24134245.28,12186395,0,615393,452776,382026,13636590
"Charlton","2008",23747766.62,12770902,0,715618,460528,399670,14346718
"Charlton","2009",24074654.07,12734546,0,737951,484455,462134,14419086
"Charlton","2010",23559620.02,13277698,0,838457,545852,514849,15176856
"Charlton","2011",24596153.43,13839856,0,958025,623574,588339,16009794
"Charlton","2012",25221553.51,14348000,0,979122,637407,623355,16587884
"Charlton","2013",25927940.15,14740687,0,1017821,672378,670143,17101029
"Chatham","2003",31399870.96,17713277,0,1369909,67786,160967,19311939
"Chatham","2004",33146462.47,18835877,0,1092260,61838,142884,20132859
"Chatham","2005",35545230.44,19537473,0,1013269,62279,146949,20759970
"Chatham","2006",34990456.42,20335732,0,1079957,65285,169411,21650385
"Chatham","2007",37244047.05,21256036,0,1094319,91932,77856,22520143
"Chatham","2008",39597831.81,21986623,0,1177904,111703,92684,23368914
"Chatham","2009",40205826.71,22456174,0,1299960,115497,108117,23979748
"Chatham","2010",40762533.57,22728602,0,1328971,133916,119179,24310668
"Chatham","2011",41155573.92,23283480,0,1466827,153960,142620,25046887
"Chatham","2012",41078959.45,24295700,0,1508838,162177,155203,26121918
"Chatham","2013",40569565.81,27065857,0,1789099,103823,174423,29133202
"Chelmsford","2003",82840396.56,42997688,0,4195850,3971046,2111362,53275946
"Chelmsford","2004",82832998.59,46308374,0,4262080,3858728,1784207,56213389
"Chelmsford","2005",87617915.93,49551743,0,4620934,4014347,1855565,60042589
"Chelmsford","2006",91351278.62,52354292,0,4718614,4075834,1935199,63083939
"Chelmsford","2007",96211182.22,55417891,0,5072809,4946572,1779830,67217102
"Chelmsford","2008",101129990.21,57763735,0,5751253,5502269,1833567,70850824
"Chelmsford","2009",105190233.37,57440012,0,5967783,5748335,2193109,71349239
"Chelmsford","2010",103888013.74,59292285,0,6057811,5934966,2274688,73559750
"Chelmsford","2011",110331494.71,61119814,0,6322803,6119162,2799364,76361143
"Chelmsford","2012",114768878.89,63524613,0,6321055,6047850,3072456,78965974
"Chelmsford","2013",118349461.34,64690331,0,6339750,6001737,3360298,80392116
"Chelsea","2003",112881943.09,11332253,0,7801986,3199079,1070389,23403707
"Chelsea","2004",110184665.7,12320464,0,8933528,3115001,1110622,25479615
"Chelsea","2005",112777016.18,13843934,0,8711875,3219170,1106157,26881136
"Chelsea","2006",115464284.62,15640006,0,8332564,3228824,1126870,28328264
"Chelsea","2007",119888242.99,16303459,0,9140740,3368032,1136503,29948734
"Chelsea","2008",126511216,17255237,0,9699196,3067886,1471882,31494201
"Chelsea","2009",133272434.1,16551251,0,11276423,3522281,1913074,33263029
"Chelsea","2010",131437071.25,15525256,0,13131486,4199557,2465961,35322260
"Chelsea","2011",152540163.01,16368114,0,13301745,4244808,2837676,36752343
"Chelsea","2012",131720135.96,17023700,0,13966417,4358055,3157555,38505727
"Chelsea","2013",141534605.67,17863195,0,15101505,4442416,3801172,41208288
"Cheshire","2003",3902439.65,1827649,2812,127211,8220,40365,2006257
"Cheshire","2004",4363372.3,1887573,3372,134506,8435,42366,2076252
"Cheshire","2005",4241239.31,1967737,2908,137051,8046,34521,2150263
"Cheshire","2006",4085344.71,1979053,2700,142180,7576,29955,2161464
"Cheshire","2007",4754635.68,2186029,0,135382,13450,29469,2364330
"Cheshire","2008",4630066.58,2222534,0,132854,12159,33029,2400576
"Cheshire","2009",4831670.94,2409659,0,156892,13262,58275,2638088
"Cheshire","2010",4988108.69,2585410,0,174254,14446,70449,2844559
"Cheshire","2011",5101042.93,2624738,0,172945,15339,68432,2881454
"Cheshire","2012",4943037.06,2686424,0,175002,15597,76032,2953055
"Cheshire","2013",5449515.01,2833112,0,189661,18793,89379,3130945
"Chester","2003",2098274.65,1359300,0,72511,8983,33372,1474166
"Chester","2004",2180000.09,1469622,0,71458,9401,43932,1594413
"Chester","2005",2316232.01,1493606,0,73147,9386,30931,1607070
"Chester","2006",2839411.24,1655601,0,73866,10717,35277,1775461
"Chester","2007",2566460.23,1749553,0,76827,10635,28556,1865571
"Chester","2008",3233769.97,1888450,0,74501,9712,27797,2000460
"Chester","2009",3217158.09,1923063,0,86528,9331,56933,2075855
"Chester","2010",3169076.46,1985926,0,80871,9565,58561,2134923
"Chester","2011",2939746.27,2052129,0,87830,10651,65641,2216251
"Chester","2012",2998605.12,2094893,0,85102,16350,64995,2261340
"Chester","2013",3446084.86,2183147,0,89272,19693,73918,2366030
"Chesterfield","2003",2151954.97,1477867,0,32688,25208,46904,1582667
"Chesterfield","2004",2236488.13,1599014,0,26699,26590,44303,1696606
"Chesterfield","2005",2368775.57,1653531,0,26759,26749,40445,1747484
"Chesterfield","2006",2434392.93,1722909,0,31799,29308,32115,1816131
"Chesterfield","2007",2603818.49,1809362,0,29805,29688,30861,1899716
"Chesterfield","2008",2669958.15,1877237,0,37136,30091,32038,1976502
"Chesterfield","2009",2817090.23,1985235,0,44112,30548,50580,2110475
"Chesterfield","2010",2789305.08,2076501,0,39122,33772,55260,2204655
"Chesterfield","2011",2903338.42,2164819,0,40695,34821,58203,2298538
"Chesterfield","2012",3326553.82,2178578,0,38382,31720,58123,2306803
"Chesterfield","2013",3540124.23,2354838,0,33578,31006,71242,2490664
"Chicopee","2003",117715128.18,29229724,0,8265012,6312559,2762917,46570212
"Chicopee","2004",123142740.98,30273857,0,8762753,6696970,3036952,48770532
"Chicopee","2005",122491119.87,31189081,0,9350041,6818969,2752983,50111074
"Chicopee","2006",130833931.02,32936821,0,9526916,6758862,2802325,52024924
"Chicopee","2007",139648285.47,35793728,0,9369729,6511188,2831351,54505996
"Chicopee","2008",148783095.35,37818226,0,9014265,6088348,2770325,55691164
"Chicopee","2009",157102099.24,39966624,0,10009145,6795538,3474696,60246003
"Chicopee","2010",161004657.04,39832584,0,10621250,7080328,3806084,61340246
"Chicopee","2011",163869262.87,42373343,0,11234507,7296404,3672579,64576833
"Chicopee","2012",170051191.01,43299528,0,11462608,7441079,3651121,65854336
"Chicopee","2013",177195255.66,43733929,0,11844572,7567783,5906228,69052512
"Chilmark","2003",5932686.97,4101672,0,41209,1469,32643,4176993
"Chilmark","2004",5860056.67,4450526,0,45206,1614,37408,4534754
"Chilmark","2005",6545196.01,4880509,0,49714,1716,47631,4979570
"Chilmark","2006",7100928.38,5066412,0,57802,1785,43489,5169488
"Chilmark","2007",7555909.32,5325627,0,57431,2117,46458,5431633
"Chilmark","2008",7296709.23,5609164,0,60112,2224,53155,5724655
"Chilmark","2009",9269800.86,6030533,0,57951,2256,61113,6151853
"Chilmark","2010",7616673.36,6076455,0,57629,2302,76600,6212986
"Chilmark","2011",8747510.72,6404406,0,61586,2415,84628,6553035
"Chilmark","2012",8573077.89,6507230,0,65347,2424,73289,6648290
"Chilmark","2013",8425528.78,7045555,0,67325,2520,85049,7200449
"Clarksburg","2003",3132987.41,825921,0,15176,9785,13213,864095
"Clarksburg","2004",3049851.5,901667,0,15912,9998,12387,939964
"Clarksburg","2005",3264546.06,935237,0,15676,10192,11574,972679
"Clarksburg","2006",3398500.78,971806,0,17065,9747,10670,1009288
"Clarksburg","2007",3507872.66,1054958,0,19867,8722,8928,1092475
"Clarksburg","2008",3772357.74,1107977,0,19215,9091,9801,1146084
"Clarksburg","2009",3806231.34,1165565,0,20010,9518,15473,1210566
"Clarksburg","2010",3682896.98,1192839,0,20127,9156,17152,1239274
"Clarksburg","2011",3940290.72,1317466,0,21809,10071,18350,1367696
"Clarksburg","2012",4049671.27,1370498,0,22587,10452,23218,1426755
"Clarksburg","2013",4395684.25,1491271,0,23372,11467,21940,1548050
"Clinton","2003",30859702.88,9098483,0,1116310,1419517,436094,12070404
"Clinton","2004",31307364.78,9468637,0,1226607,1490325,446387,12631956
"Clinton","2005",32568099.16,10492824,0,1152521,1403834,342710,13391889
"Clinton","2006",33565091.87,11253454,0,1302500,1416623,369907,14342484
"Clinton","2007",36061709.07,11968953,0,1189996,1306569,469521,14935039
"Clinton","2008",37456292.75,12615315,0,1246639,1321488,514451,15697893
"Clinton","2009",39082277.13,12804444,0,1411263,1469929,620862,16306498
"Clinton","2010",38312636.39,13444721,0,1653440,1535366,677958,17311485
"Clinton","2011",38522574.98,13312654,0,1835640,1708334,956628,17813256
"Clinton","2012",38742671.65,13689980,0,2040416,1898278,916015,18544689
"Clinton","2013",40519318.36,14102537,0,2059215,1856522,895386,18913660
"Cohasset","2003",30916978.67,17907596,0,1075744,76972,157421,19217733
"Cohasset","2004",33198552.92,19211064,0,1114671,79755,167316,20572806
"Cohasset","2005",32617910.53,20260956,0,1302160,88616,127665,21779397
"Cohasset","2006",33833236.06,21962276,0,1370673,92154,131814,23556917
"Cohasset","2007",36883150,22758201,0,1437578,80702,125834,24402315
"Cohasset","2008",37676319.16,23725442,0,1481501,103976,162154,25473073
"Cohasset","2009",38989288.19,24632493,0,1534921,105742,193622,26466778
"Cohasset","2010",40559387.18,25422915,0,1619316,110058,210372,27362661
"Cohasset","2011",42988436.37,26198225,0,1707093,120988,256791,28283097
"Cohasset","2012",44363123.97,27433098,0,1830165,5613,270872,29539748
"Cohasset","2013",47914431.82,28601525,0,1868232,6423,286440,30762620
"Colrain","2003",2486253.98,1498991,0,61955,66301,87042,1714289
"Colrain","2004",2567189.42,1580759,0,47040,65343,80720,1773862
"Colrain","2005",2873280.12,1783202,0,53652,68210,81860,1986924
"Colrain","2006",3082770.05,1938534,0,55238,73604,85653,2153029
"Colrain","2007",3517592.33,2010611,0,50942,70096,68445,2200094
"Colrain","2008",3352482.76,2066166,0,57863,69277,80310,2273616
"Colrain","2009",3623410.34,2192863,0,77024,68172,100380,2438439
"Colrain","2010",3555244.27,2283362,0,72727,63799,105285,2525173
"Colrain","2011",3320433.52,2279996,0,72642,62736,108548,2523922
"Colrain","2012",3555164.76,2353768,0,76802,66729,132942,2630241
"Colrain","2013",3520881.39,2355420,0,76803,64888,180731,2677842
"Concord","2003",52917180.52,37953202,0,3118102,814844,609881,42496029
"Concord","2004",55674060.18,41780674,0,3432824,896236,611784,46721518
"Concord","2005",59795621.29,45807197,0,3577875,339801,422712,50147585
"Concord","2006",64036101.04,48459281,0,3999564,355135,459106,53273086
"Concord","2007",70230560.46,51129926,0,4150054,338629,447112,56065721
"Concord","2008",74730998.3,53646873,0,4472614,354956,472011,58946454
"Concord","2009",80291290.26,56820656,0,4847328,388395,592263,62648642
"Concord","2010",79378022.68,59621336,0,5100090,406458,669685,65797569
"Concord","2011",81263869.99,60278264,0,5140737,394353,732043,66545397
"Concord","2012",83856407.8,62677835,0,5335418,393254,716489,69122996
"Concord","2013",89155715.96,64497082,0,5508357,397342,720648,71123429
"Conway","2003",4303680.54,2298257,0,50473,105644,78149,2532523
"Conway","2004",4291896.81,2468531,0,53335,112022,117746,2751634
"Conway","2005",4868633.38,2761285,0,62034,96348,77510,2997177
"Conway","2006",4852523.28,2798039,0,62516,89519,77116,3027190
"Conway","2007",5351778.07,3001780,0,72582,87736,75734,3237832
"Conway","2008",5352472.86,2880260,0,71894,127404,67541,3147099
"Conway","2009",5240896.36,2977115,0,74527,137307,88222,3277171
"Conway","2010",5732464.57,3101253,0,74034,138476,94657,3408420
"Conway","2011",5650728.97,3103533,0,63237,155181,94138,3416089
"Conway","2012",5466107.8,3345540,0,73459,157566,102162,3678727
"Conway","2013",6159816.72,3177159,0,68254,151623,86772,3483808
"Cummington","2003",1600756.86,898711,0,84036,7469,38660,1028876
"Cummington","2004",1528107.42,973315,0,61193,8881,39971,1083360
"Cummington","2005",1663741.92,1026954,0,75713,8679,41495,1152841
"Cummington","2006",1631708.03,1131909,0,77402,7261,37938,1254510
"Cummington","2007",1837883.74,1143306,0,82266,9652,35437,1270661
"Cummington","2008",2111332.06,1198285,0,78091,14185,34134,1324695
"Cummington","2009",1783426.81,1263817,0,84642,14919,51210,1414588
"Cummington","2010",1987233.92,1351099,0,88299,16345,60340,1516083
"Cummington","2011",2321492.34,1419791,0,91503,19891,62906,1594091
"Cummington","2012",2084227.93,1374920,0,89479,16024,63308,1543731
"Cummington","2013",2212648.83,1427542,0,99255,17306,68085,1612188
"Dalton","2003",11044893.82,5427432,0,348199,790696,182682,6749009
"Dalton","2004",11309974.87,5927827,0,353490,784249,190531,7256097
"Dalton","2005",12776119.89,6510274,0,372421,815157,189193,7887045
"Dalton","2006",12666598.27,6954460,0,368945,835102,188730,8347237
"Dalton","2007",13375983.58,7244853,0,369119,798291,173960,8586223
"Dalton","2008",13608111.82,7669160,0,386896,832322,181316,9069694
"Dalton","2009",13822998.86,7804857,0,404500,848054,208077,9265488
"Dalton","2010",13923439.44,8169695,0,420337,880823,252468,9723323
"Dalton","2011",14253822.91,8578570,0,458909,971059,286577,10295115
"Dalton","2012",14509060.45,8812050,0,457732,976779,284563,10531124
"Dalton","2013",14927191.25,8999706,0,481831,976923,303660,10762120
"Danvers","2003",73438173.49,26530433,0,11010807,3033498,673124,41247862
"Danvers","2004",71039382.42,29519303,0,10093862,2795808,677972,43086945
"Danvers","2005",72529988.52,29398349,0,11490234,3018059,1035207,44941849
"Danvers","2006",76897170.62,31020818,0,11625793,3073275,1054664,46774550
"Danvers","2007",80916150.97,32400905,0,12143355,3138181,1162900,48845341
"Danvers","2008",88791384.94,34331294,0,12640139,3147737,1212198,51331368
"Danvers","2009",92491318.76,35924009,0,13280106,3369741,1410736,53984592
"Danvers","2010",92412724.05,37272132,0,13545395,3566149,1648300,56031976
"Danvers","2011",94756577.82,38484157,0,14318220,3677739,1763078,58243194
"Danvers","2012",98677029.49,40058409,0,14746187,3863935,1678569,60347100
"Danvers","2013",102568652.9,41563369,0,15162998,4011566,1788847,62526780
"Dartmouth","2003",57228284.03,25862452,0,3944269,626092,1047652,31480465
"Dartmouth","2004",61390313.2,28217238,0,3623103,575734,920072,33336147
"Dartmouth","2005",63483496,29967355,0,3600572,548770,933775,35050472
"Dartmouth","2006",67318437.61,31479634,0,3614834,565629,877421,36537518
"Dartmouth","2007",71233765.71,32718622,0,4224890,592058,642733,38178303
"Dartmouth","2008",76109278.34,31545581,0,6757673,903673,988855,40195782
"Dartmouth","2009",82593367.1,33972689,0,7451121,1002663,1236997,43663470
"Dartmouth","2010",82022450.1,34788134,0,7863235,1042413,1352568,45046350
"Dartmouth","2011",81405712.53,35796328,0,8067058,1040376,1578637,46482399
"Dartmouth","2012",84369799.31,36987531,0,8318376,1071162,1626166,48003235
"Dartmouth","2013",86272541.9,38101484,0,8642061,1114187,1875902,49733634
"Dedham","2003",64030021.45,26188016,0,12914285,951456,2675712,42729469
"Dedham","2004",67701917.59,28767925,0,12875949,887659,2984629,45516162
"Dedham","2005",71541241.96,31490783,0,13023165,847875,3166946,48528769
"Dedham","2006",76282938.01,35519847,0,13365762,874813,3040793,52801215
"Dedham","2007",81389289.35,38871794,0,12970622,985240,2712708,55540364
"Dedham","2008",87295642.29,40383797,0,14378853,958346,2955814,58676810
"Dedham","2009",87940199.21,42162077,0,15274561,938889,3120031,61495558
"Dedham","2010",92557379.7,43961906,0,17537774,1281885,3301681,66083246
"Dedham","2011",95072491.88,46076061,0,20206337,1224392,3845595,71352385
"Dedham","2012",98002125.61,47972876,0,21139919,1274744,4094159,74481698
"Dedham","2013",102554264.27,49490747,0,22645681,1375175,4124665,77636268
"Deerfield","2003",9998178.88,3718371,0,610859,778975,161333,5269538
"Deerfield","2004",10345440.6,3913902,0,638947,822206,305214,5680269
"Deerfield","2005",10679314.35,4892971,0,743908,882529,162470,6681878
"Deerfield","2006",11369066.96,5380466,0,737140,865689,161265,7144560
"Deerfield","2007",11803418.27,5624717,0,749916,866264,146032,7386929
"Deerfield","2008",12776029.66,5751572,0,799253,913640,148056,7612521
"Deerfield","2009",13596408.73,5981230,0,792174,903491,177199,7854094
"Deerfield","2010",13098333.52,6173762,0,813604,957397,187467,8132230
"Deerfield","2011",13357148.71,6294518,0,814068,962733,274807,8346126
"Deerfield","2012",13621991.11,6372677,0,846818,966964,325720,8512179
"Deerfield","2013",14472729.72,6553998,0,864548,996385,337966,8752897
"Dennis","2003",36483952.23,20932885,4125,1328197,86110,583755,22935072
"Dennis","2004",40680944.76,22847921,4123,1284629,81442,419275,24637390
"Dennis","2005",41758704.89,23847875,3735,1374069,91244,245647,25562570
"Dennis","2006",42684403.21,24778128,4901,1483229,101604,243727,26611589
"Dennis","2007",45139292.11,26043990,4181,1546496,99800,251510,27945977
"Dennis","2008",49244454.24,27142368,3097,1631483,107261,280738,29164947
"Dennis","2009",50429431.52,30988145,3260,1899381,125065,371417,33387268
"Dennis","2010",50733426.75,30784609,3144,1951814,125569,396147,33261283
"Dennis","2011",50327531.89,31248405,3455,2066435,132764,432336,33883395
"Dennis","2012",50657911.72,31740416,3548,2108860,145136,448127,34446087
"Dennis","2013",52709438.65,32795223,3625,2161129,145514,466856,35572347
"Dighton","2003",10526830.39,5539158,0,602937,1069385,390650,7602130
"Dighton","2004",11218312.24,6165204,0,562605,841405,318401,7887615
"Dighton","2005",11847155.11,6744401,0,579759,830203,400553,8554916
"Dighton","2006",13042331.22,7591216,0,598143,777320,366108,9332787
"Dighton","2007",13472026.97,8029277,0,643541,937614,367638,9978070
"Dighton","2008",14396365.75,8587157,0,671681,922754,395220,10576812
"Dighton","2009",14364193.23,8883862,0,700078,942293,517995,11044228
"Dighton","2010",14925557.91,9073451,0,768847,1279495,569934,11691727
"Dighton","2011",15664183.03,9270516,0,789693,1466534,705300,12232043
"Dighton","2012",16538147.96,9845930,0,813405,1524901,750921,12935157
"Dighton","2013",16963507.66,10028744,0,782317,986251,1342611,13139923
"Douglas","2003",17520674.35,7660408,0,175093,195808,134342,8165651
"Douglas","2004",18970092.47,8668625,0,188200,219538,167974,9244337
"Douglas","2005",20070914.35,8658220,0,185609,156129,118848,9118806
"Douglas","2006",22842806.04,9820545,0,208309,202849,123366,10355069
"Douglas","2007",23618232.16,9996682,0,214205,184130,113128,10508145
"Douglas","2008",24002381.24,9745813,0,219144,250887,132667,10348511
"Douglas","2009",25414490.21,10086648,0,216161,212308,179906,10695023
"Douglas","2010",24298367.43,10416003,0,234415,210763,193182,11054363
"Douglas","2011",26213227.02,10631702,0,245968,229209,218258,11325137
"Douglas","2012",26864423.24,11267254,0,263829,219919,256993,12007995
"Douglas","2013",27507408.05,12780843,0,297759,247370,306295,13632267
"Dover","2003",18883517.91,15483581,0,121631,37979,132743,15775934
"Dover","2004",21736050.11,17073380,0,140216,41313,154068,17408977
"Dover","2005",22977081.7,18326040,0,149245,41861,154396,18671542
"Dover","2006",25081563.3,20635897,0,180976,58661,163026,21038560
"Dover","2007",26857139.9,21387738,0,182551,59031,171226,21800546
"Dover","2008",28642744.69,22382830,0,195954,72492,245290,22896566
"Dover","2009",29283986.86,23268531,0,164656,72223,310520,23815930
"Dover","2010",31911373.17,24390905,0,189552,80512,363531,25024500
"Dover","2011",30770257.31,25107003,0,190275,83465,405537,25786280
"Dover","2012",31176914.77,25794659,0,187133,84911,413637,26480340
"Dover","2013",32780211.37,26622720,0,203507,89368,443695,27359290
"Dracut","2003",55215701.23,23291148,0,1137436,370676,472428,25271688
"Dracut","2004",59525795.06,24268828,0,1183736,431255,500547,26384366
"Dracut","2005",60933249.75,25553222,0,1223637,453840,488992,27719691
"Dracut","2006",65241675.94,27356129,0,1218449,460824,472056,29507458
"Dracut","2007",67707690.48,28680525,0,1224771,483071,529545,30917912
"Dracut","2008",71287424,30042611,0,1351721,506691,655271,32556294
"Dracut","2009",73830696.45,30712922,0,1610984,555567,835753,33715226
"Dracut","2010",71782026.15,31582051,0,1729367,592876,969190,34873484
"Dracut","2011",73614530.57,32541056,0,1801968,628934,1031782,36003740
"Dracut","2012",76553879.59,33608223,0,1855068,642925,1053778,37159994
"Dracut","2013",80019818.08,34717854,0,1967022,682217,1142039,38509132
"Dudley","2003",12619286.29,5548875,0,246187,149292,104562,6048916
"Dudley","2004",12926494.73,6151052,0,243464,166660,105772,6666948
"Dudley","2005",14081544.94,6873438,0,234519,126514,87814,7322285
"Dudley","2006",13748257.07,7051749,0,216072,136603,88831,7493255
"Dudley","2007",15163965.77,7341536,0,222187,140857,79378,7783958
"Dudley","2008",14966038.19,7562887,0,237619,157528,74561,8032595
"Dudley","2009",15274136.61,7587469,0,257314,171362,96874,8113019
"Dudley","2010",15648725.89,8060105,0,300995,202057,124929,8688086
"Dudley","2011",16114888.85,8376770,0,334316,226004,135762,9072852
"Dudley","2012",15805447.7,8398484,0,330632,225499,142107,9096722
"Dudley","2013",15999381.76,8631724,0,353931,242406,151599,9379660
"Dunstable","2003",6493697.93,4845497,0,63450,22814,121670,5053431
"Dunstable","2004",6673711.77,5006050,0,53984,22815,108570,5191419
"Dunstable","2005",6667399.93,5233626,0,57164,41506,99000,5431296
"Dunstable","2006",7395590.22,5517835,0,60781,46124,90557,5715297
"Dunstable","2007",7226144.99,5665516,0,59983,48184,85150,5858833
"Dunstable","2008",7731760.98,6009183,0,61574,51949,106588,6229294
"Dunstable","2009",8016309.99,6369126,0,66386,55224,135216,6625952
"Dunstable","2010",8322304.66,6521047,0,69111,56164,163951,6810273
"Dunstable","2011",8753303.86,6812672,0,66679,53383,154828,7087562
"Dunstable","2012",8089466.56,6586824,0,64379,46174,139618,6836995
"Dunstable","2013",8959239.21,6888460,0,66341,48191,139186,7142178
"Duxbury","2003",48164784.67,29955093,0,855968,23955,223798,31058814
"Duxbury","2004",49990638.5,31474965,0,837982,24875,238305,32576127
"Duxbury","2005",52121649.8,32394898,0,797644,20314,223868,33436724
"Duxbury","2006",55112370.75,34285483,0,824819,20098,226415,35356815
"Duxbury","2007",57700709.88,36062629,0,860630,21248,251455,37195962
"Duxbury","2008",58994349.07,37445382,0,973826,22871,300139,38742218
"Duxbury","2009",65253140.25,39337675,0,1011756,23725,372910,40746066
"Duxbury","2010",61513266.75,39851641,0,1056031,26378,428018,41362068
"Duxbury","2011",62902478.58,40600633,0,1107490,29226,508980,42246329
"Duxbury","2012",66755276.31,42299750,0,1222976,39224,574811,44136761
"Duxbury","2013",66414425.96,43650449,0,1308382,38821,618482,45616134
"East Bridgewater","2003",31261637.33,11454811,0,727542,645299,299851,13127503
"East Bridgewater","2004",31267171.66,12594518,0,617901,438766,197806,13848991
"East Bridgewater","2005",32594628.06,14001056,0,644452,440575,204512,15290595
"East Bridgewater","2006",33326394.64,14875559,0,645280,432458,211455,16164752
"East Bridgewater","2007",37033664.04,16049623,0,740444,467514,213572,17471153
"East Bridgewater","2008",39101305.95,16705769,0,888365,466143,274821,18335098
"East Bridgewater","2009",41251523.85,17324089,0,1018349,513452,327095,19182985
"East Bridgewater","2010",41032890.9,17859092,0,1127776,544304,466791,19997963
"East Bridgewater","2011",40041422.32,18475238,0,1187146,580031,510850,20753265
"East Bridgewater","2012",44424397.86,21184020,0,1404473,664192,689136,23941821
"East Bridgewater","2013",44107743.68,21989134,0,1428740,702446,559212,24679532
"East Brookfield","2003",3228735.94,1623523,0,132261,22275,40322,1818381
"East Brookfield","2004",2866101.05,1658489,0,130484,25434,57083,1871490
"East Brookfield","2005",3267150.37,1958741,0,115764,21659,42216,2138380
"East Brookfield","2006",3728522.6,2096542,0,136492,20757,40007,2293798
"East Brookfield","2007",3404465.03,1940642,0,123920,18664,34704,2117930
"East Brookfield","2008",4081686.16,2403085,0,161473,25613,40281,2630452
"East Brookfield","2009",4066936.53,2514732,0,174126,27705,46248,2762811
"East Brookfield","2010",4313520.45,2599190,0,181074,26527,54436,2861227
"East Brookfield","2011",4846479.37,2791615,0,187756,29667,58418,3067456
"East Brookfield","2012",4337708.02,2886570,0,193235,29681,59653,3169139
"East Brookfield","2013",4550165.64,2944028,0,200852,33152,61631,3239663
"East Longmeadow","2003",36676130.59,17890106,0,2331873,2158971,581758,22962708
"East Longmeadow","2004",37207276.26,19056236,1716,2462724,2099621,627153,24247450
"East Longmeadow","2005",38829617.44,20218289,0,2114583,1812305,440828,24586005
"East Longmeadow","2006",44073453.5,21937843,0,2181187,1894216,451022,26464268
"East Longmeadow","2007",44755803.93,23196233,0,2195949,1873587,433188,27698957
"East Longmeadow","2008",48727887.82,24253553,0,2419143,1964001,489948,29126645
"East Longmeadow","2009",53169732.36,25048271,0,2510537,1986476,584189,30129473
"East Longmeadow","2010",51571826.25,25928042,0,2642900,1996030,630176,31197148
"East Longmeadow","2011",51721144.54,26219214,0,2669370,2013138,682569,31584291
"East Longmeadow","2012",55253518.58,27572489,0,2852694,2249559,745742,33420484
"East Longmeadow","2013",56893390.53,27296191,0,2806223,2211039,727266,33040719
"Eastham","2003",15344620.38,10695209,0,393424,36583,311084,11436300
"Eastham","2004",16592276.53,11402628,0,367024,26320,172577,11968549
"Eastham","2005",17713805.64,12402179,0,397529,28888,175942,13004538
"Eastham","2006",19114663.5,12977697,0,369069,29052,183567,13559385
"Eastham","2007",18932245.84,13437100,0,383494,29849,95388,13945831
"Eastham","2008",20861750.6,14677881,0,414891,43261,112292,15248325
"Eastham","2009",21669314.7,14947161,0,424932,43668,127136,15542897
"Eastham","2010",21354390.95,15322701,0,459758,44901,139861,15967221
"Eastham","2011",22133878.98,15640257,0,471768,46567,154497,16313089
"Eastham","2012",23193944.09,16513845,0,488642,48676,163359,17214522
"Eastham","2013",23644677.78,16794269,0,492997,50990,165353,17503609
"Easthampton","2003",30530016.3,10544426,0,789934,651741,460006,12446107
"Easthampton","2004",31014626.19,11205059,0,814668,601910,398564,13020201
"Easthampton","2005",31024042.58,11757517,0,789121,574057,354223,13474918
"Easthampton","2006",32556450.66,12689671,0,809508,490466,339960,14329605
"Easthampton","2007",36120074.14,13499585,0,850944,520523,350578,15221630
"Easthampton","2008",36737063.01,14076378,0,880839,538639,374524,15870380
"Easthampton","2009",38379952.63,14512900,0,892272,554083,448435,16407690
"Easthampton","2010",36928442.13,15272436,0,974151,569862,446877,17263326
"Easthampton","2011",37683763.73,15598177,0,1084478,574003,520871,17777529
"Easthampton","2012",38068095.88,16341598,0,1147738,600173,510967,18600476
"Easthampton","2013",39778456.22,17685368,0,1357932,740096,545525,20328921
"Easton","2003",46451874.22,22922901,0,1470184,1018862,396010,25807957
"Easton","2004",48519236.36,24325711,0,1523292,1031126,344360,27224489
"Easton","2005",51981153.25,26181972,0,1518849,969272,335009,29005102
"Easton","2006",54595608.04,28340862,0,1681810,983303,344878,31350853
"Easton","2007",60225181.63,31932616,0,2513337,1267696,351985,36065634
"Easton","2008",65943644.27,33025331,0,2869710,1343013,412758,37650812
"Easton","2009",67501362.6,34307835,0,3143490,1410045,571891,39433261
"Easton","2010",68439670.01,35783114,0,3401877,1457960,618442,41261393
"Easton","2011",76397376.56,36597199,0,3757827,1521230,791092,42667348
"Easton","2012",70514889.85,37958785,0,3832164,1470150,803082,44064181
"Easton","2013",73228325.31,38996191,0,4061792,1618012,846548,45522543
"Edgartown","2003",19632401.95,12321490,13024,794140,8462,210042,13347158
"Edgartown","2004",21659489.05,14179453,11497,840730,9319,211773,15252772
"Edgartown","2005",23623316.35,15412696,17831,882415,10247,196015,16519204
"Edgartown","2006",26633013.34,16785145,12853,1003969,11390,212431,18025788
"Edgartown","2007",27525875.63,16760629,12842,1026082,12203,211102,18022858
"Edgartown","2008",30043295.16,17825902,0,1065720,11108,232714,19135444
"Edgartown","2009",32295305.77,18589318,0,1156124,11721,259281,20016444
"Edgartown","2010",30487249.31,19319144,0,1229780,12013,291790,20852727
"Edgartown","2011",31787589.22,20617225,0,1354271,13199,332768,22317463
"Edgartown","2012",32954537.3,21213564,0,1291556,12954,348152,22866226
"Edgartown","2013",34208068.26,21716528,0,1323826,13074,369437,23422865
"Egremont","2003",3087887.1,2095810,0,109741,0,58197,2263748
"Egremont","2004",3086491.96,2310358,0,121040,0,54329,2485727
"Egremont","2005",3334791.97,2382916,0,118614,0,48698,2550228
"Egremont","2006",3230122.77,2320933,0,117343,0,39107,2477383
"Egremont","2007",3573445.63,2377613,0,120216,0,52932,2550761
"Egremont","2008",3737012.34,2617918,0,128528,0,50757,2797203
"Egremont","2009",3886167.35,2733026,0,126651,0,51210,2910887
"Egremont","2010",3869877.02,2878973,0,139535,36,56135,3074679
"Egremont","2011",3775346.02,2747445,0,118971,37,57266,2923719
"Egremont","2012",4130628.08,2883389,0,121201,39,61190,3065819
"Egremont","2013",3975471.31,2843011,0,113360,39,65596,3022006
"Erving","2003",7121416.72,455446,2095,54330,3434440,1620588,5566899
"Erving","2004",7596756.09,482158,2146,54902,3524192,1667230,5730628
"Erving","2005",7642060.98,571620,2542,69652,3579742,1668842,5892398
"Erving","2006",7526912.2,716677,3042,77634,3208128,2053018,6058499
"Erving","2007",8537191.97,785961,3193,76933,3276840,2076191,6219118
"Erving","2008",9496845.22,804907,3151,79288,3357600,2129408,6374354
"Erving","2009",9776085.28,840172,3587,87157,3488580,2282923,6702419
"Erving","2010",9784156.84,853755,3639,87739,3588966,2356302,6890401
"Erving","2011",11405944.07,881027,3758,92442,3700468,2520568,7198263
"Erving","2012",10126106.26,914052,3902,89878,3836320,2653515,7497667
"Erving","2013",11168214.75,975238,4577,94121,5690268,1309926,8074130
"Essex","2003",8134955.39,5257913,0,498397,120206,89098,5965614
"Essex","2004",9613452.38,5570221,0,496268,125797,71544,6263830
"Essex","2005",10872747.4,6029008,0,503789,136689,76927,6746413
"Essex","2006",12115764.04,6878027,0,598163,147292,89955,7713437
"Essex","2007",12384781.03,7269618,0,654838,177936,90278,8192670
"Essex","2008",12997199.52,7746997,0,693131,185119,96402,8721649
"Essex","2009",14195282.81,8677282,0,742458,208800,125031,9753571
"Essex","2010",14656311.99,9136140,0,708724,193520,135658,10174042
"Essex","2011",15353052.51,9459437,0,763659,207097,154436,10584629
"Essex","2012",15216996.07,9639095,0,790491,214366,167603,10811555
"Essex","2013",16037838.67,10214214,0,820903,224609,190366,11450092
"Everett","2003",101181822.82,15675580,0,6655378,23595609,3879705,49806272
"Everett","2004",103289510.08,17569016,0,8769974,24549383,4948710,55837083
"Everett","2005",110394885.28,22733261,0,9258770,25009110,4680203,61681344
"Everett","2006",113525967.8,24052244,0,8813509,24018133,4781777,61665663
"Everett","2007",124445938.6,27162037,0,8767519,23933413,4750415,64613384
"Everett","2008",136508170.82,29732490,0,9637182,23622541,5019608,68011821
"Everett","2009",150487577.41,27944822,0,13906656,25592671,6044985,73489134
"Everett","2010",145811046.32,27479885,0,15467434,27278727,8201677,78427723
"Everett","2011",153276682.02,29679438,0,17127615,24734162,10348936,81890151
"Everett","2012",156207075.87,31824634,0,16214582,25865749,10260746,84165711
"Everett","2013",169794446.34,31862483,0,17545937,26554493,11299132,87262045
"Fairhaven","2003",36212750.76,12270146,0,3395791,298732,398692,16363361
"Fairhaven","2004",36615151.38,12673352,0,3403070,294326,501225,16871973
"Fairhaven","2005",38242272.15,13211028,0,3522702,326721,471039,17531490
"Fairhaven","2006",42911035.68,13953317,0,3493812,353732,459980,18260841
"Fairhaven","2007",43089904.11,14707690,0,3504049,346325,483948,19042012
"Fairhaven","2008",47450867.83,15164251,0,4014028,398181,507829,20084289
"Fairhaven","2009",50761893.28,15637714,0,4231374,412513,604221,20885822
"Fairhaven","2010",48686057.57,16148650,0,4450253,447634,694873,21741410
"Fairhaven","2011",49174622.85,16484088,0,4624115,509020,766618,22383841
"Fairhaven","2012",49119105.83,17097203,0,4637738,460957,806507,23002405
"Fairhaven","2013",52526015.74,17705782,0,4737639,491317,747754,23682492
"Fall River","2003",203150477.8,24577254,0,10242068,5553710,2523136,42896168
"Fall River","2004",201249734.03,27235183,0,10621354,5781639,2477915,46116091
"Fall River","2005",208256666.42,30742800,0,10832294,5856221,2105941,49537256
"Fall River","2006",220462764.04,32882617,0,11071195,5930647,1923614,51808073
"Fall River","2007",234547623.67,38054297,0,12173613,6465278,1964901,58658089
"Fall River","2008",240842463.94,41683792,0,12335506,6320611,2253938,62593847
"Fall River","2009",259389358.77,41191489,0,13176621,7010884,2878892,64257886
"Fall River","2010",241576081.96,43640696,0,14493570,7717239,3309043,69160548
"Fall River","2011",239791406.39,46233638,0,15032967,7816295,3497139,72580039
"Fall River","2012",251507699.07,46661107,0,16443448,8350809,4771525,76226889
"Fall River","2013",259130818.02,49146488,0,17540540,8741603,4005083,79433714
"Falmouth","2003",84327148.93,49868870,9969,2934611,325009,838198,53976657
"Falmouth","2004",87742063.14,52627154,9266,3027413,333431,912979,56910243
"Falmouth","2005",96091491.06,55268192,10672,3378730,391012,794638,59843244
"Falmouth","2006",100956250.52,56790602,13740,3343268,384287,829571,61361468
"Falmouth","2007",104617169.22,59984828,14580,3360251,394341,854549,64608549
"Falmouth","2008",118079417.1,63887384,32389,3832062,468734,1011925,69232494
"Falmouth","2009",108228530.93,66266852,32326,4074294,489592,1173743,72036807
"Falmouth","2010",116016687.26,69449717,26174,4127059,515284,1318097,75436331
"Falmouth","2011",117327001.7,73411389,25229,4252219,518809,1318279,79525925
"Falmouth","2012",120427987.95,75921637,25790,4423859,550577,1389462,82311325
"Falmouth","2013",121734230.93,78657215,26445,4622844,583202,1454421,85344127
"Fitchburg","2003",100843769,20034069,0,3651258,2135719,1318376,27139422
"Fitchburg","2004",100028450,21260336,0,3603597,2125834,1359880,28349647
"Fitchburg","2005",103882928.98,23008256,0,3543575,1959124,1239452,29750407
"Fitchburg","2006",110297953,24624399,0,3581624,1950768,1259673,31416464
"Fitchburg","2007",114487022,26175846,0,3887260,1983665,1316970,33363741
"Fitchburg","2008",117953703.05,27473948,0,4073883,2051149,1419512,35018492
"Fitchburg","2009",120873268.3,28259805,0,4375359,2215581,1680356,36531101
"Fitchburg","2010",116896217,28785470,0,4750126,2368021,1938912,37842529
"Fitchburg","2011",118998647,29498838,0,4918310,2465720,2427284,39310152
"Fitchburg","2012",118994648,30273150,0,5181304,2613298,2715552,40783304
"Fitchburg","2013",129083290,31142760,0,5354599,2774394,3040423,42312176
"Florida","2003",2275167.69,325745,1212,9366,868090,118883,1323296
"Florida","2004",2141307.25,335941,1215,9424,865803,120374,1332757
"Florida","2005",2274543.33,346841,1229,11277,927924,127253,1414524
"Florida","2006",2415266.48,382142,0,22497,992838,267139,1664616
"Florida","2007",2630774.7,390781,0,24498,1000804,295842,1711925
"Florida","2008",2648905.12,433743,0,22663,1027496,298162,1782064
"Florida","2009",2738727.41,431938,0,22904,1010931,309516,1775289
"Florida","2010",3055406.97,496482,0,25487,1069598,332149,1923716
"Florida","2011",2958860.72,487759,0,27205,1097588,339328,1951880
"Florida","2012",3046844.75,487581,0,23631,1313738,208153,2033103
"Florida","2013",3259416.25,517728,0,27069,1323873,220707,2089377
"Foxborough","2003",41147803.79,17598791,0,3159592,802478,535363,22096224
"Foxborough","2004",42873158.98,18062586,0,3665803,788203,482271,22998863
"Foxborough","2005",43901018.49,18989952,0,3689372,797718,620547,24097589
"Foxborough","2006",46477947.49,20749986,0,3835608,768978,578107,25932679
"Foxborough","2007",52094897.75,21425418,0,4331728,818512,591246,27166904
"Foxborough","2008",52358595.5,22366864,0,4606301,874083,706823,28554071
"Foxborough","2009",56270131.75,22655311,0,5489689,900031,781083,29826114
"Foxborough","2010",60436362.5,23946318,0,7174549,763480,1007233,32891580
"Foxborough","2011",62372515.37,25652373,0,6958331,804365,1179869,34594938
"Foxborough","2012",63205052.27,26520139,0,7594905,883369,1409745,36408158
"Foxborough","2013",66213165.72,28105874,0,7750754,895112,1508317,38260057
"Framingham","2003",181242468.42,64387263,0,37629697,7228498,5625600,114871058
"Framingham","2004",186615973.83,67689993,0,38549632,7329874,7059619,120629118
"Framingham","2005",196421166.19,70865677,0,40835502,7528195,6313392,125542766
"Framingham","2006",202459159.12,75641991,0,41708749,7580455,6590375,131521570
"Framingham","2007",213306232.73,80600383,0,40796516,7629202,6681657,135707758
"Framingham","2008",224909058.87,85320578,0,41135118,7780739,7041917,141278352
"Framingham","2009",238719132.33,85088579,0,46044064,8446157,7426904,147005704
"Framingham","2010",237954432.07,86852254,0,48238246,8388683,9088866,152568049
"Framingham","2011",243009622.71,90230017,0,48731956,9316718,9892008,158170699
"Framingham","2012",253095954.1,98528855,0,46247317,9498304,9448992,163723468
"Framingham","2013",268252318.06,99574028,0,48155839,9589795,9705846,167025508
"Franklin","2003",78397424.23,29224719,0,2443303,4748638,775496,37192156
"Franklin","2004",88850978.71,29887605,0,2497339,4926910,1011717,38323571
"Franklin","2005",93375357.86,31651605,0,2998418,4789726,769247,40208996
"Franklin","2006",97794917.27,33885538,0,3064779,4766718,812301,42529336
"Franklin","2007",103566164.37,35367762,0,3076433,4671028,1112451,44227674
"Franklin","2008",105563857.54,38551083,0,3649472,5372236,1040001,48612792
"Franklin","2009",112403391.66,39503410,0,3885502,5783884,1367611,50540407
"Franklin","2010",108415551.03,40896948,0,4008191,5892912,1589678,52387729
"Franklin","2011",109664957.37,43109509,0,4017375,5669630,1493721,54290235
"Franklin","2012",107668119.32,44702223,0,4228889,5635932,1846161,56413205
"Franklin","2013",115364470.69,46138667,0,4440014,5837176,2074076,58489933
"Freetown","2003",15551151.07,7846028,0,809703,651708,511686,9819125
"Freetown","2004",15857416.92,8559412,0,841501,622998,519673,10543584
"Freetown","2005",17857354.18,9026529,0,791404,923947,566151,11308031
"Freetown","2006",18246904.04,9640394,0,814139,1065922,554313,12074768
"Freetown","2007",20525935.05,9968043,0,818266,1316663,543385,12646357
"Freetown","2008",21061724.42,10327597,0,870421,1431245,592339,13221602
"Freetown","2009",21135868.01,10433548,0,1002544,1597049,776091,13809232
"Freetown","2010",21194325.75,10744686,0,1053758,1631443,894742,14324629
"Freetown","2011",21734981.83,11017171,0,1108335,1649652,1049147,14824305
"Freetown","2012",20915903.07,11311922,0,1167518,1729486,1099397,15308323
"Freetown","2013",22130693.91,11638504,0,1237046,1811747,1140591,15827888
"Gardner","2003",46183050.9,11003384,0,1215812,742386,398346,13359928
"Gardner","2004",47260815.73,11504586,0,1256497,788151,426653,13975887
"Gardner","2005",49274038.51,12617715,0,1049838,633377,293552,14594482
"Gardner","2006",50178235.95,13277936,0,1032331,640487,331186,15281940
"Gardner","2007",54455398.3,13951796,0,1068595,586091,308811,15915293
"Gardner","2008",55688620.03,14392588,0,1185199,667925,339694,16585406
"Gardner","2009",57127185.79,14786416,0,1267914,716693,404393,17175416
"Gardner","2010",55314983.96,15124584,0,1463138,812815,463516,17864053
"Gardner","2011",54804230.15,15440062,0,1699889,1045728,611305,18796984
"Gardner","2012",58612975.32,16292027,0,1797950,1037861,627444,19755282
"Gardner","2013",57965863.99,16931086,0,1950829,1075913,669163,20626991
"Georgetown","2003",18944366.59,8124741,0,419703,440657,137627,9122728
"Georgetown","2004",18974731.88,8616451,0,421384,433774,137844,9609453
"Georgetown","2005",19251382.32,9126972,0,400178,411612,125365,10064127
"Georgetown","2006",22540944.58,10151407,0,408449,427188,143137,11130181
"Georgetown","2007",22918157.63,10605423,0,439250,452593,146584,11643850
"Georgetown","2008",24753069.02,11082498,0,451165,481757,152667,12168087
"Georgetown","2009",24792689.07,11352924,0,468704,500539,199261,12521428
"Georgetown","2010",24122224.96,11779387,0,470157,533536,228251,13011331
"Georgetown","2011",24380153.62,11990828,0,504814,577617,247285,13320544
"Georgetown","2012",27188579.05,13495342,0,570058,594528,288006,14947934
"Georgetown","2013",27120906.94,13931995,0,575740,570692,277687,15356114
"Gill","2003",2072914.03,1082601,0,115312,93144,34504,1325561
"Gill","2004",2258949.83,1340450,0,134442,113601,44644,1633137
"Gill","2005",2336069.26,1336646,0,118734,118827,31053,1605260
"Gill","2006",2597227.68,1377364,0,129137,126385,35542,1668428
"Gill","2007",2776423.26,1352180,0,121780,113341,30807,1618108
"Gill","2008",2706053.58,1422978,0,133057,217305,27518,1800858
"Gill","2009",2741381.81,1587851,0,145592,134146,46000,1913589
"Gill","2010",2780403.39,1689258,0,158128,141771,51748,2040905
"Gill","2011",2900658.09,1706219,0,160876,196315,52520,2115930
"Gill","2012",2896299.41,1756929,0,169944,214359,68994,2210226
"Gill","2013",2958305.44,1802784,0,174926,226285,84980,2288975
"Gloucester","2003",77225405.86,37451773,0,2761220,1818109,744245,42775347
"Gloucester","2004",78459592.82,39378787,0,2704634,1711454,676510,44471385
"Gloucester","2005",80892301.65,41833490,0,2467274,1602935,662079,46565778
"Gloucester","2006",85253888.39,44122912,0,2343907,1474089,660767,48601675
"Gloucester","2007",88624341.67,46155530,0,2471322,1483849,669988,50780689
"Gloucester","2008",94354902.82,47706105,0,2724665,1636091,725101,52791962
"Gloucester","2009",96552736.57,49264473,0,2985635,1717044,859454,54826606
"Gloucester","2010",97290349.23,50598208,0,3361427,1873607,1014122,56847364
"Gloucester","2011",101124729.59,53407713,0,3640376,1964982,1230865,60243936
"Gloucester","2012",104345683.02,55640839,0,3884206,2083973,1418030,63027048
"Gloucester","2013",109062181.33,57385588,0,3978824,2152755,1505935,65023102
"Goshen","2003",1929064.77,1304610,0,31056,10967,22756,1369389
"Goshen","2004",2040069.2,1387573,0,31628,14677,26490,1460368
"Goshen","2005",2116588.68,1478460,0,33197,13248,26433,1551338
"Goshen","2006",2622262.85,1526666,0,34072,21669,23864,1606271
"Goshen","2007",2948616.38,1516512,0,35874,20758,23663,1596807
"Goshen","2008",2199029.25,1562817,0,38130,21000,21924,1643871
"Goshen","2009",2828363.66,1636226,0,40779,22222,35943,1735170
"Goshen","2010",2981567.2,1708137,0,35095,22910,48954,1815096
"Goshen","2011",3036513.21,1762773,0,34543,26798,45639,1869753
"Goshen","2012",2825079.35,1813897,0,34471,24810,44442,1917620
"Goshen","2013",2772857.44,1842504,0,34658,29304,46640,1953106
"Gosnold","2003",949215.79,306904,0,6321,786,1003,315014
"Gosnold","2004",951695.18,318190,0,6481,806,806,326283
"Gosnold","2005",997614.58,326075,0,6620,843,586,334124
"Gosnold","2006",1073114.42,382846,0,5202,952,429,389429
"Gosnold","2007",1246966.96,471380,0,6405,1172,528,479485
"Gosnold","2008",1483631.68,469621,0,5477,1233,1689,478020
"Gosnold","2009",1329086.81,493726,0,5689,1283,1767,502465
"Gosnold","2010",1224367.58,502750,0,5753,1297,1786,511586
"Gosnold","2011",1255063.32,526887,0,6091,1377,2016,536371
"Gosnold","2012",1387149.11,594094,0,6868,1553,2263,604778
"Gosnold","2013",1328987.5,604847,0,6993,1581,2304,615725
"Grafton","2003",29080127.72,14310117,0,757899,488136,469449,16025601
"Grafton","2004",32913154.46,16448407,0,655080,430520,381115,17915122
"Grafton","2005",35028394.08,17929144,0,619611,427123,376626,19352504
"Grafton","2006",39272069.82,18988208,0,702293,467809,394180,20552490
"Grafton","2007",41540248.01,20950262,0,829131,452613,386259,22618265
"Grafton","2008",43246209.68,21929509,0,824450,509055,396685,23659699
"Grafton","2009",44090720.86,22917593,0,1028328,606933,523614,25076468
"Grafton","2010",44278881.41,24263786,0,1175201,691951,651610,26782548
"Grafton","2011",47000525.88,25521722,0,1296481,732061,705725,28255989
"Grafton","2012",49112387.91,27113856,0,1360273,786143,763629,30023901
"Grafton","2013",54244616.65,28930786,0,1443442,843669,827083,32044980
"Granby","2003",12584886.09,5128625,0,223834,39476,112890,5504825
"Granby","2004",14784500.38,5342969,0,307992,40625,100563,5792149
"Granby","2005",13544692.52,6107758,0,297984,37667,113310,6556719
"Granby","2006",14328840.9,6472831,0,302029,40942,101834,6917636
"Granby","2007",18160150.08,6979919,0,321864,41404,113742,7456929
"Granby","2008",18144369.82,7287290,0,309618,42659,119780,7759347
"Granby","2009",23872679.36,7590607,0,329510,43727,132650,8096494
"Granby","2010",18555810.54,7845175,0,355024,52683,175812,8428694
"Granby","2011",18789525.64,8102482,0,374950,55383,212411,8745226
"Granby","2012",19838065.1,8344312,0,379577,68876,296452,9089217
"Granby","2013",19445669.17,8634492,0,398397,70916,303309,9407114
"Granville","2003",4023638.4,1506040,0,86931,26453,166933,1786357
"Granville","2004",4120306.06,1613117,0,77041,25006,143038,1858202
"Granville","2005",4182171.06,1657195,0,85780,24740,142112,1909827
"Granville","2006",4419181.46,1757538,0,90666,23461,129157,2000822
"Granville","2007",4445681.01,1596926,0,81925,19204,118431,1816486
"Granville","2008",4845673.87,1914429,0,89593,20413,136554,2160989
"Granville","2009",4794379.22,1862918,0,91627,21444,152104,2128093
"Granville","2010",4620421.14,2020108,0,109365,30689,161928,2322090
"Granville","2011",4626640.26,2096126,0,105918,29576,175923,2407543
"Granville","2012",4643528.53,2137252,0,107781,32104,185572,2462709
"Granville","2013",3211931.79,1958755,0,99799,32868,251015,2342437
"Great Barrington","2003",15504326.81,8363916,0,1945313,141961,374931,10826121
"Great Barrington","2004",16116458.08,9226657,0,2100302,162323,346446,11835728
"Great Barrington","2005",17754292.6,10023684,0,2303945,167448,367361,12862438
"Great Barrington","2006",19230094.09,10830731,0,2544452,183157,338148,13896488
"Great Barrington","2007",20362557.2,11302631,0,2399712,198371,307741,14208455
"Great Barrington","2008",21484145.53,12200590,0,2486184,209499,344651,15240924
"Great Barrington","2009",22483044.7,12962974,0,2637110,218015,396681,16214780
"Great Barrington","2010",22520583.49,13424039,0,2726760,144555,420921,16716275
"Great Barrington","2011",23306343.11,13499214,0,2853415,126385,447959,16926973
"Great Barrington","2012",24045234.11,14049897,0,3060848,131914,490620,17733279
"Great Barrington","2013",24385910.74,14173775,0,3091700,131174,485360,17882009
"Greenfield","2003",42850666.3,14407626,0,3620654,532610,672930,19233820
"Greenfield","2004",40616572.72,15148087,0,3707515,546941,682708,20085251
"Greenfield","2005",42450257.39,16029898,0,3676072,529319,584620,20819909
"Greenfield","2006",44217994.04,16509982,0,4010980,524562,564383,21609907
"Greenfield","2007",49181574.49,17417950,0,3983720,518813,572728,22493211
"Greenfield","2008",49461741.93,18140938,0,4120029,518831,603722,23383520
"Greenfield","2009",50231735.68,18458674,0,4335832,539488,702973,24036967
"Greenfield","2010",48473857.17,18659270,0,4297591,597928,708586,24263375
"Greenfield","2011",49863767.62,18655309,0,4423876,601339,759808,24440332
"Greenfield","2012",53500720.74,19499600,0,4560330,655452,914645,25630027
"Greenfield","2013",54170353.2,20238390,0,5031396,728638,1013768,27012192
"Groton","2003",24472683.87,16675575,0,441463,171839,196885,17485762
"Groton","2004",26220224.78,18653084,0,480595,184229,222370,19540278
"Groton","2005",27363844.4,19772939,0,570753,186871,212159,20742722
"Groton","2006",28793685.98,20373736,0,716518,196156,199357,21485767
"Groton","2007",30579608.77,20880637,0,893423,204887,219512,22198459
"Groton","2008",31900408.05,21689981,0,903059,196357,278692,23068089
"Groton","2009",31883038.59,21901014,0,918573,202807,370360,23392754
"Groton","2010",31860604.78,22542963,0,1023352,223484,425281,24215080
"Groton","2011",32793758.69,23015611,0,1004591,206687,432747,24659636
"Groton","2012",32518409.02,22853244,0,973729,204851,418423,24450247
"Groton","2013",34455956.61,23822296,0,988916,203049,425898,25440159
"Groveland","2003",9758059.55,6324622,0,202525,224001,134419,6885567
"Groveland","2004",10056071.39,6741317,0,232669,262070,119001,7355057
"Groveland","2005",11037320.6,7315876,0,229510,250804,114928,7911118
"Groveland","2006",12133125.08,7912032,0,237654,259316,157206,8566208
"Groveland","2007",13302368.54,8423063,0,258184,274120,168903,9124270
"Groveland","2008",13607827.39,8853454,0,271160,289120,198252,9611986
"Groveland","2009",14552844.13,8861286,0,291699,312528,244685,9710198
"Groveland","2010",14415177.61,9369093,0,295431,308277,258863,10231664
"Groveland","2011",14295633.53,9640763,0,293937,292301,299518,10526519
"Groveland","2012",14334419.85,9930557,0,297849,304718,276963,10810087
"Groveland","2013",15257200.02,10464190,0,333835,316537,408340,11522902
"Hadley","2003",11339629.16,4154601,0,2026966,188613,137399,6507579
"Hadley","2004",11754060.5,4286140,0,2084794,196636,146283,6713853
"Hadley","2005",12264522.36,4623646,0,2174894,209717,109309,7117566
"Hadley","2006",13215730.98,4847036,0,2142850,233670,106604,7330160
"Hadley","2007",13578814.55,5052826,0,2177389,232081,107677,7569973
"Hadley","2008",14109350.33,5245727,0,2371333,243319,113157,7973536
"Hadley","2009",15810414.42,5454369,0,2498390,250476,161526,8364761
"Hadley","2010",14881778.16,5576928,0,2621809,254025,167486,8620248
"Hadley","2011",15808189.66,6010661,0,2605208,245316,171626,9032811
"Hadley","2012",16384318.51,6144229,0,2716950,252734,183513,9297426
"Hadley","2013",16535906.86,6255282,0,2804155,258175,176769,9494381
"Halifax","2003",14737598.14,7187850,0,477313,175174,172175,8012512
"Halifax","2004",15488724.91,8002503,0,462596,133826,204317,8803242
"Halifax","2005",16730375.55,8429316,0,464014,123978,188368,9205676
"Halifax","2006",17389289.02,9530748,0,566073,125305,204580,10426706
"Halifax","2007",18609822.36,10412141,0,599639,144099,210505,11366384
"Halifax","2008",19370957.99,10822084,0,678728,165387,243448,11909647
"Halifax","2009",20177533.4,10957349,0,718946,172796,277854,12126945
"Halifax","2010",20326694.33,11304204,0,722144,187882,275567,12489797
"Halifax","2011",19651533.56,11180681,0,844069,232854,341324,12598928
"Halifax","2012",20286022.66,11793848,0,866033,242652,280510,13183043
"Halifax","2013",21804711.24,12090459,0,914962,235679,294743,13535843
"Hamilton","2003",18962973.93,13775712,0,538594,7253,123415,14444974
"Hamilton","2004",19495173.04,14428952,0,565458,7519,120366,15122295
"Hamilton","2005",20852532.97,15803604,0,639249,8497,124021,16575371
"Hamilton","2006",22551113.97,16853553,0,653448,8315,116398,17631714
"Hamilton","2007",23792846.1,17918220,0,693285,9566,114911,18735982
"Hamilton","2008",24613213.71,18860888,0,796595,11029,138938,19807450
"Hamilton","2009",26364995.72,20766126,0,879663,12543,230929,21889261
"Hamilton","2010",26748282.34,21250305,0,926657,13416,256881,22447259
"Hamilton","2011",27323137.71,21646205,0,984250,14158,265330,22909943
"Hamilton","2012",26815295.27,21140998,0,952087,12323,268553,22373961
"Hamilton","2013",26856080.92,20984360,0,911135,12216,275105,22182816
"Hampden","2003",7980195.93,5901812,0,293816,25494,198156,6419278
"Hampden","2004",8324906.11,6132410,0,292738,26154,214394,6665696
"Hampden","2005",8900473.18,6583662,0,259692,25467,174205,7043026
"Hampden","2006",8987097.15,6927735,0,244528,23944,164694,7360901
"Hampden","2007",10054668.48,7272432,0,267307,25236,162978,7727953
"Hampden","2008",9907848.54,7593417,0,273222,25811,159220,8051670
"Hampden","2009",10470784.63,7713833,0,277327,27026,199554,8217740
"Hampden","2010",10486613.86,8334595,0,302666,30956,234499,8902716
"Hampden","2011",10443420.65,8245466,0,294334,30565,231821,8802186
"Hampden","2012",11386512.79,8698375,0,338993,33096,242160,9312624
"Hampden","2013",11557683.34,8821891,0,350658,34664,297882,9505095
"Hancock","2003",1273555.5,477676,0,51897,2652,39513,571738
"Hancock","2004",1606568.85,547402,0,309936,4386,68479,930203
"Hancock","2005",1740558.28,676839,0,476308,4951,51538,1209636
"Hancock","2006",1687653.51,577493,0,413219,3793,47981,1042486
"Hancock","2007",1865104.82,603955,0,402964,3273,38947,1049139
"Hancock","2008",1759281.72,542778,0,353535,2881,33514,932708
"Hancock","2009",1832333.7,549280,0,364832,2900,33897,950909
"Hancock","2010",1843946.35,647954,0,445245,3798,40739,1137736
"Hancock","2011",1758767.82,581376,0,394738,3457,36515,1016086
"Hancock","2012",1772128.09,572264,0,364544,2580,38839,978227
"Hancock","2013",1777878.41,502661,0,303083,1840,31471,839055
"Hanover","2003",38250196.08,19546821,0,2880795,590988,320899,23339503
"Hanover","2004",38720076.25,19704970,0,2898611,591565,368086,23563232
"Hanover","2005",40479391.86,20137981,0,2939080,558209,318851,23954121
"Hanover","2006",42881230.49,21596075,0,3124337,587828,396528,25704768
"Hanover","2007",45598494.41,22387752,0,3372022,672260,441914,26873948
"Hanover","2008",47991279.08,22812572,0,3926360,794027,467247,28000206
"Hanover","2009",50596469.51,23413487,0,4279593,855187,607541,29155808
"Hanover","2010",52567918.27,25616122,0,4698477,953009,730918,31998526
"Hanover","2011",51927923.43,26284531,0,4440610,904385,755138,32384664
"Hanover","2012",54974074.62,27827854,0,4601025,933459,736422,34098760
"Hanover","2013",55922763.07,29380558,0,4847490,983938,787423,35999409
"Hanson","2003",17111351.35,10734520,0,540209,227515,155946,11658190
"Hanson","2004",17908029.09,11451399,0,465729,191482,146290,12254900
"Hanson","2005",17185362.9,10626186,0,434126,176609,125075,11361996
"Hanson","2006",18536887.91,11313926,0,419137,175485,119651,12028199
"Hanson","2007",19923434.73,11953796,0,425291,180944,122745,12682776
"Hanson","2008",19751405.78,12178169,0,446229,197232,148041,12969671
"Hanson","2009",20706117.18,12842987,0,500661,208577,196682,13748907
"Hanson","2010",20208570.72,13364957,0,609269,268469,227394,14470089
"Hanson","2011",20036626.62,13568368,0,613613,271421,235922,14689324
"Hanson","2012",20683176.9,13761888,0,638692,267018,245875,14913473
"Hanson","2013",22061151.18,15307553,0,695879,300733,279400,16583565
"Hardwick","2003",3401917.95,1926681,0,146052,24611,56665,2154009
"Hardwick","2004",3779008.58,1996166,0,150982,25921,56684,2229753
"Hardwick","2005",4353667.6,1956096,0,126953,21667,44276,2148992
"Hardwick","2006",4832160.61,2180543,0,111466,16989,36469,2345467
"Hardwick","2007",4843836.37,2452451,0,123094,16448,36549,2628542
"Hardwick","2008",5317320.62,2530203,0,128791,16254,36368,2711616
"Hardwick","2009",4869629.5,2472361,0,131280,14578,50664,2668883
"Hardwick","2010",4609239.94,2653276,0,139393,20229,60782,2873680
"Hardwick","2011",4952681.76,2709164,0,147255,23262,73340,2953021
"Hardwick","2012",5002677.6,2854844,0,163435,25007,78460,3121746
"Hardwick","2013",4913278.6,2976601,0,165857,25301,82806,3250565
"Harvard","2003",17876203.35,9691694,0,281967,45672,95038,10114371
"Harvard","2004",16369565.18,10536883,0,326705,30028,121388,11015004
"Harvard","2005",17611246.28,11370442,0,345592,20546,99515,11836095
"Harvard","2006",18770857.83,12416310,0,380881,22408,115219,12934818
"Harvard","2007",19825207.58,13225537,0,402208,26534,110102,13764381
"Harvard","2008",22265897.01,14467301,0,487047,30128,137145,15121621
"Harvard","2009",22049907.1,15160561,0,490107,31910,194712,15877290
"Harvard","2010",21858971.69,15572611,0,498214,33724,217256,16321805
"Harvard","2011",22954017.87,15916574,0,537780,39854,257165,16751373
"Harvard","2012",23598073.53,16222715,0,564779,39393,274517,17101404
"Harvard","2013",23664050.85,16743877,0,570676,40416,269910,17624879
"Harwich","2003",41193542.38,24387076,0,1538097,153650,658014,26736837
"Harwich","2004",44503952.19,25748149,0,1434424,145481,467017,27795071
"Harwich","2005",45788803.08,26443890,0,1474572,156947,468651,28544060
"Harwich","2006",48029674.54,27505214,0,1511316,164413,447814,29628757
"Harwich","2007",48494290.36,28233408,0,1510135,180857,258002,30182402
"Harwich","2008",51366636.57,29419041,0,1691372,203407,310997,31624817
"Harwich","2009",55617629.34,30395687,0,1759233,214047,376766,32745733
"Harwich","2010",56669977.06,32242323,0,1851330,227846,441231,34762730
"Harwich","2011",57415670.37,33127607,0,1962801,234669,494010,35819087
"Harwich","2012",59092289.55,34568358,0,2066836,186641,516809,37338644
"Harwich","2013",57600372.92,35642748,0,2038781,155896,599642,38437067
"Hatfield","2003",8593527.1,2688630,0,861391,185412,143501,3878934
"Hatfield","2004",7642251.16,3370987,0,828536,183491,146806,4529820
"Hatfield","2005",7819576.67,3557620,0,821017,182093,138430,4699160
"Hatfield","2006",8046202.7,3707817,0,862447,186454,167977,4924695
"Hatfield","2007",8110986.87,3726424,0,830752,196224,138828,4892228
"Hatfield","2008",8838465.99,3813744,0,800185,195808,185338,4995075
"Hatfield","2009",8899290.3,3922443,0,809920,199767,220462,5152592
"Hatfield","2010",9321089.55,4000778,0,803580,185206,211861,5201425
"Hatfield","2011",9358428.62,4118347,0,873166,249919,233505,5474937
"Hatfield","2012",9991882.86,4061231,0,960252,272431,232184,5526098
"Hatfield","2013",11021892.12,4568144,0,1107024,269441,204568,6149177
"Haverhill","2003",135439562.28,42736126,18175,6394382,4044554,2278632,55471869
"Haverhill","2004",130695816.81,45562783,17777,6402624,4242105,2321918,58547207
"Haverhill","2005",133286837.14,49029073,0,6643210,4313509,2306363,62292155
"Haverhill","2006",142650658.62,51726419,0,6643155,4316475,2280120,64966169
"Haverhill","2007",151164459.26,54289416,0,6991616,4500055,2369602,68150689
"Haverhill","2008",156560456.84,56442648,0,8046290,4561756,3184814,72235508
"Haverhill","2009",162195452.06,57323834,0,9127446,4934459,3987370,75373109
"Haverhill","2010",160286924.86,58267093,0,9907921,5466391,4489536,78130941
"Haverhill","2011",157353501.5,60366482,0,10008627,5507584,5029660,80912353
"Haverhill","2012",173072067.16,62271070,0,10368455,5631047,5449762,83720334
"Haverhill","2013",169916322.25,63491059,0,10993609,5880404,5607466,85972538
"Hawley","2003",677332.75,412122,0,18149,0,26760,457031
"Hawley","2004",652387,452638,0,15225,0,27524,495387
"Hawley","2005",745388.02,451977,0,15260,0,25457,492694
"Hawley","2006",914667.7,526690,0,15484,0,30539,572713
"Hawley","2007",912139.26,519737,0,15230,0,21509,556476
"Hawley","2008",832683.41,542990,0,15267,0,17570,575827
"Hawley","2009",944814.34,573938,0,26171,0,24023,624132
"Hawley","2010",866870.12,634174,0,29180,0,26525,689879
"Hawley","2011",907500.28,640911,0,29534,0,25891,696336
"Hawley","2012",1052401.8,700662,0,31777,0,26021,758460
"Hawley","2013",1068565.55,699780,0,29732,0,24993,754505
"Heath","2003",1541029.49,1034405,0,16078,1136,43477,1095096
"Heath","2004",1790451.26,1112889,0,17208,1215,49128,1180440
"Heath","2005",1833364.12,1249118,0,10230,1157,39052,1299557
"Heath","2006",1947372.27,1350394,0,8832,1112,38842,1399180
"Heath","2007",1980118.95,1420516,0,9579,1141,32458,1463694
"Heath","2008",2081247.46,1460616,0,9183,1188,39946,1510933
"Heath","2009",2162509.67,1471540,0,12059,1184,50021,1534804
"Heath","2010",2030881.73,1535882,0,12458,1241,50333,1599914
"Heath","2011",2046831.05,1584411,0,17764,2715,60694,1665584
"Heath","2012",2022070.74,1644891,0,15179,2861,75933,1738864
"Heath","2013",2134867.84,1654018,0,14969,2890,106849,1778726
"Hingham","2003",61080684.72,34046926,0,2800121,1716952,620996,39184995
"Hingham","2004",63585647.57,36795805,0,2450384,1635626,744776,41626591
"Hingham","2005",65073816.65,39529519,0,2463003,1578229,617299,44188050
"Hingham","2006",69687353.32,41745055,0,3530155,1894098,601359,47770667
"Hingham","2007",73225169.26,43924117,0,3815111,1743871,670276,50153375
"Hingham","2008",76390727.61,46014332,0,4261811,1760090,637016,52673249
"Hingham","2009",82343359.45,47803243,0,4619270,1822427,879616,55124556
"Hingham","2010",82297548.36,52593165,0,5118167,1966885,1022636,60700853
"Hingham","2011",82926378.93,53617898,0,5332094,2020045,1072637,62042674
"Hingham","2012",88586787.5,56387197,0,5162708,1952554,1157607,64660066
"Hingham","2013",92485209.67,58437075,0,5406377,1942228,1228438,67014118
"Hinsdale","2003",3433005.71,1783191,267,133008,25034,120708,2062208
"Hinsdale","2004",3700707.79,2053859,272,137944,24345,130436,2346856
"Hinsdale","2005",3717787.32,2187755,261,141572,21342,121323,2472253
"Hinsdale","2006",3681071.75,2169289,0,170035,18521,97076,2454921
"Hinsdale","2007",4215668.13,2286044,0,165251,18730,99507,2569532
"Hinsdale","2008",4344460.94,2486832,0,174561,20834,116581,2798808
"Hinsdale","2009",4596878.82,2669608,0,181211,24380,129422,3004621
"Hinsdale","2010",4613135.01,2638684,0,185501,24441,224045,3072671
"Hinsdale","2011",4854545.83,2718846,0,212916,24783,228770,3185315
"Hinsdale","2012",4734449.85,2838924,0,222273,27180,255238,3343615
"Hinsdale","2013",5264535.02,3040221,0,266030,41472,255755,3603478
"Holbrook","2003",25535751.8,10826224,0,1500376,1245781,527805,14100186
"Holbrook","2004",26269609.28,12231778,0,1633813,1359313,529587,15754491
"Holbrook","2005",28391231.11,12834085,0,1454423,1226687,466653,15981848
"Holbrook","2006",28302720.64,12494559,0,1664344,1325848,473979,15958730
"Holbrook","2007",30090879.68,13443195,0,1834086,1371677,482502,17131460
"Holbrook","2008",33179920.1,13643362,0,2009337,1449838,538617,17641154
"Holbrook","2009",33384933.17,14351344,0,2353985,1695128,691818,19092275
"Holbrook","2010",32466725.56,14733081,0,2398034,1798874,758369,19688358
"Holbrook","2011",33018140.21,15198932,0,2458098,1849754,889904,20396688
"Holbrook","2012",34487936.66,15543919,0,2529632,1866408,994693,20934652
"Holbrook","2013",34751349.48,15523617,0,2530746,1743522,1133853,20931738
"Holden","2003",32804925.07,18247016,4863,838828,357979,275879,19724565
"Holden","2004",35164646.79,19592370,4742,732075,342254,273789,20945230
"Holden","2005",37136063.27,21473820,5210,698752,327774,253468,22759024
"Holden","2006",39126176.01,22574628,5367,710856,329473,245004,23865328
"Holden","2007",40123367.59,22246269,5019,757420,325113,278787,23612608
"Holden","2008",42535852.71,24006452,5244,825876,347003,305848,25490423
"Holden","2009",43314049.02,25452342,5141,896957,366145,356239,27076824
"Holden","2010",44787655.48,26205934,0,914753,364367,397888,27882942
"Holden","2011",45076547.76,27329398,0,944496,381528,443098,29098520
"Holden","2012",47340088.38,28531553,0,985702,409486,456765,30383506
"Holden","2013",49449869.37,29487379,0,1068146,420929,478863,31455317
"Holland","2003",5003326.17,3125436,0,57705,2148,95972,3281261
"Holland","2004",5022929.85,3296600,0,66380,2032,85335,3450347
"Holland","2005",5000981.42,3436617,0,65171,1961,78957,3582706
"Holland","2006",5314929.92,3640264,0,61635,2653,80911,3785463
"Holland","2007",5665543.03,3870542,0,68640,3239,58524,4000945
"Holland","2008",5856728.26,4000091,0,71805,8556,67660,4148112
"Holland","2009",6024987.04,4101704,0,75434,8972,86659,4272769
"Holland","2010",5965100.45,4232643,0,67892,10539,97434,4408508
"Holland","2011",6233071.4,4292620,0,73796,11231,108119,4485766
"Holland","2012",6401682.7,4380504,0,73495,11499,119081,4584579
"Holland","2013",6612405.06,4492837,0,67126,11450,141226,4712639
"Holliston","2003",41207757.85,21486124,0,729969,1448733,365336,24030162
"Holliston","2004",43751430.85,23074596,0,763272,1468191,391135,25697194
"Holliston","2005",44773499.55,23957828,0,749310,1501622,412296,26621056
"Holliston","2006",46131799.61,25283329,0,751825,1463466,414587,27913207
"Holliston","2007",51684168.41,26580753,0,778271,1576024,421719,29356767
"Holliston","2008",52654238.67,27705620,0,875651,1728043,478468,30787782
"Holliston","2009",51665012.63,28453551,0,934262,1939412,687680,32014905
"Holliston","2010",52999319.7,29628917,0,1034847,2182175,771670,33617609
"Holliston","2011",54343912.62,31161088,0,1130204,2404471,894878,35590641
"Holliston","2012",56487307.56,32079660,0,1148891,2491267,888286,36608104
"Holliston","2013",58644838.39,33007565,0,1187602,2684393,979164,37858724
"Holyoke","2003",124739485.26,14650666,0,15607635,3414387,1063542,34736230
"Holyoke","2004",123517940.91,15355304,0,15787388,3974934,1216140,36333766
"Holyoke","2005",126027441.16,17180897,0,15552298,3999765,1140282,37873242
"Holyoke","2006",136614015.61,18387529,0,15876611,3862349,1172856,39299345
"Holyoke","2007",143698141.22,20470727,0,15730494,3708730,1227518,41137469
"Holyoke","2008",145049697.81,21758087,0,15927215,3777406,1225726,42688434
"Holyoke","2009",144773195.14,22198480,0,16512845,4487668,1440092,44639085
"Holyoke","2010",143498986.08,22842495,0,17795245,3148433,2516284,46302457
"Holyoke","2011",142153078.87,24095961,0,18085724,3151160,2490963,47823808
"Holyoke","2012",145254481.6,25671605,0,18549733,3249800,1822487,49293625
"Holyoke","2013",149585109.45,27424602,0,18571365,3328111,1957013,51281091
"Hopedale","2003",17740908.97,5796403,0,518931,288424,141385,6745143
"Hopedale","2004",17990866.06,6158475,0,567018,282719,166389,7174601
"Hopedale","2005",19261268.6,6761322,0,627147,301327,183082,7872878
"Hopedale","2006",19630079.39,7108716,0,623199,420802,151479,8304196
"Hopedale","2007",21282698.77,7525139,0,655433,534658,161179,8876409
"Hopedale","2008",21522953.72,8002919,0,724116,587715,184707,9499457
"Hopedale","2009",22801025.21,8458652,0,780389,586733,239788,10065562
"Hopedale","2010",22113659.96,8505077,0,824386,598611,262953,10191027
"Hopedale","2011",22049596.75,8397732,0,818104,593483,301977,10111296
"Hopedale","2012",22682840.57,8610338,0,835820,612864,371323,10430345
"Hopedale","2013",23146719.63,8775567,0,873844,644446,381469,10675326
"Hopkinton","2003",49538052.99,23363957,3050,860125,3913770,703975,28844877
"Hopkinton","2004",50148359.27,26236110,5984,819305,3732488,721240,31515127
"Hopkinton","2005",51387368.93,27879566,5863,813881,3559793,734242,32993345
"Hopkinton","2006",55648632.02,30312589,6110,879754,3675279,823205,35696937
"Hopkinton","2007",62064963.52,33576361,5706,1101276,3942761,898590,39524694
"Hopkinton","2008",61720554.66,35113486,6004,1205652,4328236,991518,41644896
"Hopkinton","2009",63197711.18,36270219,6571,1348534,4536174,1247000,43408498
"Hopkinton","2010",62466007.61,36940686,5804,1409803,4601227,1405226,44362746
"Hopkinton","2011",64763075.92,38045321,3000,1457087,4592267,1523051,45620726
"Hopkinton","2012",66179396.58,39226799,3057,1482924,4634040,1687136,47033956
"Hopkinton","2013",69066531.7,40314131,1538,1843849,4622224,1885911,48667653
"Hubbardston","2003",5425780.66,3222435,0,91176,32966,62528,3409105
"Hubbardston","2004",5709668.19,3606119,0,82504,25967,55841,3770431
"Hubbardston","2005",5883006.31,4053911,0,87444,26034,52572,4219961
"Hubbardston","2006",6354823.56,4245415,0,86602,48674,75399,4456090
"Hubbardston","2007",6917239.95,4527856,0,91410,53007,62603,4734876
"Hubbardston","2008",7214314.2,4596617,0,140817,58520,70877,4866831
"Hubbardston","2009",7221477.73,4647189,0,154594,178823,91752,5072358
"Hubbardston","2010",7173461.09,4801444,0,179593,165389,107780,5254206
"Hubbardston","2011",7146203.42,4751065,0,180757,81337,106565,5119724
"Hubbardston","2012",7876634.58,5120417,0,190313,86105,115919,5512754
"Hubbardston","2013",8392548.85,5314758,0,203284,75975,100402,5694419
"Hudson","2003",42846267.81,14700758,0,2762555,4325252,449851,22238416
"Hudson","2004",45413000.67,16203018,0,2979348,4636014,605192,24423572
"Hudson","2005",48289487.32,18051934,0,3269858,5053479,673492,27048763
"Hudson","2006",51362560.27,20266103,0,3292869,4785066,694528,29038566
"Hudson","2007",54209394.4,21078607,0,3496664,4864534,626825,30066630
"Hudson","2008",58694047.96,22254092,0,3657105,5026049,635274,31572520
"Hudson","2009",60052549.38,23463506,0,3869240,5399842,884113,33616701
"Hudson","2010",62293516.41,24628412,0,4427665,5718696,970204,35744977
"Hudson","2011",64008872.91,25325321,0,4853668,5663907,1182903,37025799
"Hudson","2012",67373844.92,26985535,0,5203465,5540152,1357152,39086304
"Hudson","2013",70521716.47,28327591,0,5564171,5847034,1368209,41107005
"Hull","2003",31801947.23,15879189,0,560515,0,173550,16613254
"Hull","2004",31431610.88,16787811,0,550812,0,189475,17528098
"Hull","2005",32855111.04,17696882,0,544907,0,174649,18416438
"Hull","2006",34185575.94,18585986,0,555722,0,163393,19305101
"Hull","2007",36041091.85,19768590,0,567022,0,173156,20508768
"Hull","2008",35705333.96,20254725,0,580370,0,190360,21025455
"Hull","2009",35889498.15,20880477,0,601498,0,235498,21717473
"Hull","2010",36026905.35,21447831,0,666340,0,261988,22376159
"Hull","2011",36258316.79,22063717,0,705776,0,361169,23130662
"Hull","2012",37113652.26,22719646,0,740686,0,385470,23845802
"Hull","2013",37675880.33,23374391,0,776759,0,390664,24541814
"Huntington","2003",2930681.66,1683781,0,63549,16126,53357,1816813
"Huntington","2004",3084626.8,1816411,0,62322,18776,53603,1951112
"Huntington","2005",3366403.9,1867072,0,60114,19188,47652,1994026
"Huntington","2006",3680308.95,2045993,0,64364,19234,41953,2171544
"Huntington","2007",4311288.4,2199425,0,63292,19573,38709,2320999
"Huntington","2008",4132278.24,2432202,0,68762,21624,42073,2564661
"Huntington","2009",4630404.2,2468220,0,73044,21840,57263,2620367
"Huntington","2010",4576973.65,2638829,0,75049,22071,62257,2798206
"Huntington","2011",4295177.49,2751455,0,85762,22757,75778,2935752
"Huntington","2012",4362621.33,2847662,0,85516,22078,82793,3038049
"Huntington","2013",4537988.47,2918071,0,83747,23375,86127,3111320
"Ipswich","2003",34114302.19,17786152,0,890660,489346,171167,19337325
"Ipswich","2004",33346920.54,18553119,0,907959,522751,150049,20133878
"Ipswich","2005",35287475.54,19205070,0,886855,824632,142026,21058583
"Ipswich","2006",37429194.17,20248093,0,893447,1190338,139692,22471570
"Ipswich","2007",40937579.85,21199793,0,992678,1174797,125316,23492584
"Ipswich","2008",41645986.92,22330142,0,1122666,1248884,165490,24867182
"Ipswich","2009",43280069.75,24379016,0,1242080,1395851,308924,27325871
"Ipswich","2010",43182238.34,25105169,0,1313230,1481013,329165,28228577
"Ipswich","2011",44327217,25776441,0,1360148,1550024,369681,29056294
"Ipswich","2012",45852451.89,26718348,0,1462063,1652753,348924,30182088
"Ipswich","2013",47346102.3,27415218,0,1498744,1698704,416134,31028800
"Kingston","2003",30266024.53,12555996,0,2207601,211188,290969,15265754
"Kingston","2004",31523754.27,13922405,0,2288133,106390,255925,16572853
"Kingston","2005",34178287.31,15308757,0,2458945,118520,282806,18169028
"Kingston","2006",37718582.93,16331115,0,2468574,131309,276409,19207407
"Kingston","2007",37968698.75,17649927,0,2656114,151200,302596,20759837
"Kingston","2008",42954902.64,19527370,0,3081032,174225,416712,23199339
"Kingston","2009",42571232.22,19929761,0,3236047,179673,500931,23846412
"Kingston","2010",41331863.31,20575859,0,3206280,188002,555079,24525220
"Kingston","2011",43872326.39,21414320,0,3195485,197368,690428,25497601
"Kingston","2012",45842716.43,21886666,0,3206452,202824,650402,25946344
"Kingston","2013",48296192.43,23053081,0,3271239,372118,696099,27392537
"Lakeville","2003",16796630.44,9186289,0,865581,709567,141894,10903331
"Lakeville","2004",18523374.75,10184714,0,1013923,795336,172996,12166969
"Lakeville","2005",19458281.19,11121925,0,849274,689986,172114,12833299
"Lakeville","2006",20530140.18,11878842,0,808839,674763,152021,13514465
"Lakeville","2007",21748103.69,12212207,0,869851,707725,158415,13948198
"Lakeville","2008",22732024.74,12616418,0,1081147,721419,173179,14592163
"Lakeville","2009",24866223.29,13151071,0,1150994,821797,245762,15369624
"Lakeville","2010",23824699.79,13407280,0,1299016,843139,288075,15837510
"Lakeville","2011",23372944.51,14044735,0,1265660,849516,319593,16479504
"Lakeville","2012",21663281.86,14360881,0,1370469,911423,332498,16975271
"Lakeville","2013",22394362.55,14954852,0,1431688,883266,348956,17618762
"Lancaster","2003",12461138.54,6989652,36768,456309,335323,229301,8047353
"Lancaster","2004",12424019.84,8163052,36949,506670,417344,250683,9374698
"Lancaster","2005",14175129.33,8872866,36020,514688,323574,206298,9953446
"Lancaster","2006",14622473.49,9767396,35635,608902,317713,198743,10928389
"Lancaster","2007",15392142.58,10450258,36537,594529,310756,212043,11604123
"Lancaster","2008",15791456.3,10853739,0,694430,359894,216610,12124673
"Lancaster","2009",17921441.49,11192445,0,778989,437284,266621,12675339
"Lancaster","2010",17204591.81,11710695,0,776863,477393,309292,13274243
"Lancaster","2011",17471089.27,12124089,0,860493,477230,334879,13796691
"Lancaster","2012",17385984.85,12335833,0,909492,572491,329846,14147662
"Lancaster","2013",19094023.16,12422592,0,969915,622962,375796,14391265
"Lanesborough","2003",7739879.55,3439830,0,1332302,61289,121856,4955277
"Lanesborough","2004",7918498.06,3790150,0,1283561,65617,147068,5286396
"Lanesborough","2005",7924744.5,4066745,0,1140521,63493,151748,5422507
"Lanesborough","2006",8411925.38,4294679,0,1170399,65295,138717,5669090
"Lanesborough","2007",9106430.73,4593468,0,1175696,65804,154006,5988974
"Lanesborough","2008",9225496.02,4799564,0,1235870,67269,144546,6247249
"Lanesborough","2009",9726575.05,4710337,0,1276756,64858,160013,6211964
"Lanesborough","2010",9781783.14,5068879,0,1362460,70423,168401,6670163
"Lanesborough","2011",10061403.58,5296000,0,1320982,72308,132757,6822047
"Lanesborough","2012",10087107.93,5370819,0,1347058,72083,148220,6938180
"Lanesborough","2013",10389623.18,5679006,0,1188203,76456,157661,7101326
"Lawrence","2003",210625504.33,19939225,0,5699857,3564536,2572485,31776103
"Lawrence","2004",209169195.32,20007245,0,5751273,3642088,2645729,32046335
"Lawrence","2005",210435315.18,23359801,0,5501885,3357039,2108918,34327643
"Lawrence","2006",221622965.52,25211262,0,5758850,3269394,1944306,36183812
"Lawrence","2007",227980659.46,27919967,0,5766394,3399618,1929495,39015474
"Lawrence","2008",239102737.17,30573861,0,6096783,3806424,2397084,42874152
"Lawrence","2009",248915180.66,30298832,0,7330201,4528526,2855315,45012874
"Lawrence","2010",259536230.86,29302950,0,8615201,5417606,4002388,47338145
"Lawrence","2011",244471670.17,29498928,0,9378950,6184685,4537153,49599716
"Lawrence","2012",257945456.65,31113184,0,9961842,6430411,4751738,52257175
"Lawrence","2013",266485597.73,32441503,0,10476790,6673728,5169376,54761397
"Lee","2003",15440842.33,5422381,0,2220115,608427,405345,8656268
"Lee","2004",17019410.48,5726589,0,2081333,620901,440962,8869785
"Lee","2005",17917851.5,6258118,0,1929241,605422,383196,9175977
"Lee","2006",18079901.04,6499707,0,1873682,641330,376339,9391058
"Lee","2007",18863034.43,6709811,0,1900165,654331,418292,9682599
"Lee","2008",21035496.43,7226367,0,1850933,624410,488332,10190042
"Lee","2009",22121508.51,7639926,0,1962278,643219,570360,10815783
"Lee","2010",21942496.13,7937497,0,2018622,653545,602027,11211691
"Lee","2011",22503833.04,8298415,0,2151167,614958,634743,11699283
"Lee","2012",22279710.23,8451647,0,2243560,660890,672892,12028989
"Lee","2013",23346271.16,8662218,0,2307664,652163,757342,12379387
"Leicester","2003",21800645.51,6790986,0,358694,201592,172842,7524114
"Leicester","2004",22180265.53,7183090,0,377152,216249,175518,7952009
"Leicester","2005",25118402.97,8067124,0,351165,198113,130617,8747019
"Leicester","2006",24271679.44,8904180,0,357297,188614,130042,9580133
"Leicester","2007",26346926.61,9336075,0,412594,181766,115116,10045551
"Leicester","2008",26617304.47,9682037,0,542689,197604,128223,10550553
"Leicester","2009",27369423.19,9916316,0,600929,213934,274835,11006014
"Leicester","2010",27382243.88,10120399,0,678988,244117,315190,11358694
"Leicester","2011",26979023.21,10397509,0,705527,246490,340118,11689644
"Leicester","2012",26643151.93,10746429,0,759673,254943,272645,12033690
"Leicester","2013",27561490.06,11076367,0,781773,268220,290085,12416445
"Lenox","2003",18812446.48,6191249,0,1805229,108083,292666,8397227
"Lenox","2004",17429130.66,6805661,0,1836846,113842,294895,9051244
"Lenox","2005",17829835.42,7265695,0,1941795,116957,307117,9631564
"Lenox","2006",18290980.84,7716991,0,1956461,123467,310046,10106965
"Lenox","2007",19292822,8263664,0,2092242,141690,322346,10819942
"Lenox","2008",20571787.62,8928254,0,2122771,99991,341098,11492114
"Lenox","2009",23311550.85,9387352,0,2251332,101898,376410,12116992
"Lenox","2010",24768464.88,9621553,0,2352909,107085,413252,12494799
"Lenox","2011",25744453.69,9942414,0,2372773,107193,431160,12853540
"Lenox","2012",24072151.96,10282586,0,2401599,112543,432551,13229279
"Lenox","2013",24997854.45,10606660,0,2513161,102769,444748,13667338
"Leominster","2003",88792402.29,26451612,12327,3647987,2515233,665162,33292321
"Leominster","2004",90194634.11,29141764,12068,3821071,2479845,725475,36180223
"Leominster","2005",93852946.02,31571732,10738,3641103,2386695,677332,38287600
"Leominster","2006",100182685.21,32818082,7597,4345626,2610213,746104,40527622
"Leominster","2007",107503662.57,34446201,8650,4612283,2631710,746002,42444846
"Leominster","2008",109752837.42,35744631,8174,5016937,2710667,888207,44368616
"Leominster","2009",117936126.21,36920505,6060,5766173,2981457,1014372,46688567
"Leominster","2010",121219711.02,37967120,6229,6083813,3150458,1305136,48512756
"Leominster","2011",123698288.5,39508920,6520,6222947,3095727,1857004,50691118
"Leominster","2012",124111550.74,41204738,6238,6481750,3235490,2224457,53152673
"Leominster","2013",127156879.65,43063224,6701,6897052,3399180,1816760,55182917
"Leverett","2003",3879915.67,2928126,0,34739,10445,69889,3043199
"Leverett","2004",4134185.67,3019133,0,33380,10594,71936,3135043
"Leverett","2005",4637959.07,3158262,0,29463,10291,62736,3260752
"Leverett","2006",5022699.85,3229216,0,25492,10020,50164,3314892
"Leverett","2007",5114221.48,3512893,0,27788,10725,50642,3602048
"Leverett","2008",5538436.65,3695094,0,29000,11133,52865,3788092
"Leverett","2009",5824030.62,3871877,0,34384,11977,63864,3982102
"Leverett","2010",5619926.3,4008112,0,31476,12544,71414,4123546
"Leverett","2011",6120542.21,4139097,0,31075,13271,75040,4258483
"Leverett","2012",6337113.96,4274481,0,31420,13681,123213,4442795
"Leverett","2013",6252126.86,4509635,0,34752,14366,126972,4685725
"Lexington","2003",115583862.56,56788165,0,14158263,2685603,2163888,75795919
"Lexington","2004",117562735.56,63012732,0,13820678,2679033,2596598,82109041
"Lexington","2005",126855607.57,71162480,0,14723720,2702713,2567510,91156423
"Lexington","2006",132847790.6,75806588,0,13629890,2566585,2737597,94740660
"Lexington","2007",143176511.34,80914047,0,14591656,2687329,2881758,101074790
"Lexington","2008",155522617.2,86952013,0,16086595,3613736,3554315,110206659
"Lexington","2009",165097850,90677855,0,17299428,4078771,4282111,116338165
"Lexington","2010",174752947.18,95584766,0,16619899,4685221,4777575,121667461
"Lexington","2011",185082080.17,100137395,0,16975260,5822207,5020862,127955724
"Lexington","2012",187909591.58,104414313,0,17960001,6687542,5275692,134337548
"Lexington","2013",200687404.17,109386622,0,18507638,8184575,5507028,141585863
"Leyden","2003",1321617.38,1003594,0,40881,0,43241,1087716
"Leyden","2004",1452469.04,1010989,0,42118,0,40150,1093257
"Leyden","2005",1545358.08,1111042,0,23818,0,32818,1167678
"Leyden","2006",1562146.07,1223949,0,23525,0,34843,1282317
"Leyden","2007",1678017.38,1261259,0,23660,4249,31490,1320658
"Leyden","2008",1661792.25,1310555,0,22873,4063,37503,1374994
"Leyden","2009",1726792.45,1302675,0,24157,3943,43104,1373879
"Leyden","2010",1677592.04,1323380,0,22842,3991,45262,1395475
"Leyden","2011",1596173.76,1330193,0,23140,3692,44363,1401388
"Leyden","2012",1638127.88,1367675,0,22621,3748,46090,1440134
"Leyden","2013",1691138.04,1354838,0,21672,3660,43332,1423502
"Lincoln","2003",22275247.53,15091427,0,384282,11674,143548,15630931
"Lincoln","2004",23979969.68,16257277,0,392825,18645,154682,16823429
"Lincoln","2005",24787012.22,16827429,0,472545,23050,190528,17513552
"Lincoln","2006",27389439.97,18099792,0,512293,41113,206453,18859651
"Lincoln","2007",28634820.68,18843965,0,512626,36924,233052,19626567
"Lincoln","2008",29604265.29,19021180,0,495236,34419,278355,19829190
"Lincoln","2009",32229531.38,20093056,0,524487,34089,322239,20973871
"Lincoln","2010",30391741.25,20461835,0,635209,39791,366097,21502932
"Lincoln","2011",33033271.13,22176608,0,685632,45963,414946,23323149
"Lincoln","2012",34627198.64,23504500,0,692515,47993,497537,24742545
"Lincoln","2013",34624561.73,23533235,0,574342,47607,589686,24744870
"Littleton","2003",23671648.58,9707593,0,992148,3167763,729297,14596801
"Littleton","2004",28596230.26,11667470,0,1038449,3240889,452669,16399477
"Littleton","2005",27957576.26,12343338,0,1054336,3139133,411591,16948398
"Littleton","2006",28916314.75,14001739,0,1129283,3336031,464364,18931417
"Littleton","2007",31190888.41,15442118,0,1308941,3202657,442275,20395991
"Littleton","2008",32386444.41,15969676,0,1394571,3285228,453843,21103318
"Littleton","2009",34501944.92,16509406,0,1530393,3882616,659454,22581869
"Littleton","2010",35529263.24,16924928,0,1796882,4259388,750419,23731617
"Littleton","2011",37263110.51,17774750,0,1895765,5014300,1039156,25723971
"Littleton","2012",38674675.28,18755529,0,1859610,5312952,1087745,27015836
"Littleton","2013",40895642.96,19545864,0,1909734,5431996,1234855,28122449
"Longmeadow","2003",43197926.53,27595487,0,905214,40692,408060,28949453
"Longmeadow","2004",44228152.4,28918947,0,916953,42633,478368,30356901
"Longmeadow","2005",46419484.47,29974357,0,844680,39397,423421,31281855
"Longmeadow","2006",48241250.27,30925742,0,859751,46764,381014,32213271
"Longmeadow","2007",49957368.36,31467621,0,877812,43486,387775,32776694
"Longmeadow","2008",52934219.07,34479437,0,962470,47970,466510,35956387
"Longmeadow","2009",55452037.99,35399960,0,1129164,51251,523178,37103553
"Longmeadow","2010",55629457.83,36276609,0,1206520,54756,566168,38104053
"Longmeadow","2011",56130477.37,37336532,0,1414316,54791,608096,39413735
"Longmeadow","2012",58417244.95,39315285,0,1338972,73308,650771,41378336
"Longmeadow","2013",62878342.91,41680057,0,1338776,80237,750283,43849353
"Lowell","2003",270442216.61,44213627,0,10594170,6673027,2698859,64179683
"Lowell","2004",265982219.11,45077613,0,10744919,6749306,2814294,65386132
"Lowell","2005",272507119.41,53979232,0,8932502,6190171,1740915,70842820
"Lowell","2006",285160133.95,59432581,0,9396479,6384477,2066543,77280080
"Lowell","2007",296333425.18,65690730,0,10469890,6922399,2457643,85540662
"Lowell","2008",308711539.91,67722639,0,11898836,8362956,2871880,90856311
"Lowell","2009",318636487.75,69204501,0,13181640,9205523,3829145,95420809
"Lowell","2010",308847270.05,70331492,0,15011441,10169171,4768254,100280358
"Lowell","2011",311646472.13,72335831,0,15461676,10980423,5689401,104467331
"Lowell","2012",321111145.32,73935015,0,16272161,11166970,6210970,107585116
"Lowell","2013",328095925.98,75130596,0,16487622,10790651,6458014,108866883
"Ludlow","2003",42577688.86,16669595,0,1694980,805898,866601,20037074
"Ludlow","2004",43659749.52,17727464,0,1838598,809006,906393,21281461
"Ludlow","2005",47076689.98,18629650,0,1596557,698279,737468,21661954
"Ludlow","2006",48118327.61,20068159,0,1644908,717940,739441,23170448
"Ludlow","2007",50167160.19,20587768,0,1659505,726302,725996,23699571
"Ludlow","2008",53403783.54,21589435,0,1757590,716429,779938,24843392
"Ludlow","2009",57327040.55,23223112,0,1864825,757590,953444,26798971
"Ludlow","2010",54468681.02,22976604,0,1922522,782476,1015519,26697121
"Ludlow","2011",56182229.38,23975420,0,2121119,802515,1238612,28137666
"Ludlow","2012",58299021.6,25726342,0,2274896,863148,1389841,30254227
"Ludlow","2013",57626603.47,25728286,0,2210521,863732,1739849,30542388
"Lunenburg","2003",20676453,11037755,1773,688985,209871,194828,12133212
"Lunenburg","2004",22873737.26,12901697,1982,777545,232502,233667,14147393
"Lunenburg","2005",23003130.19,13537621,2205,746278,229875,211679,14727658
"Lunenburg","2006",26141530.55,14546461,0,771437,237086,211366,15766350
"Lunenburg","2007",27042285.63,14397525,397,754858,230761,215007,15598548
"Lunenburg","2008",28480017.6,14895843,0,787837,257139,235457,16176276
"Lunenburg","2009",28907804.53,15356243,0,967058,296265,295618,16915184
"Lunenburg","2010",28077986.14,15768237,0,1013952,318713,326394,17427296
"Lunenburg","2011",29626455.44,16160073,0,1042558,349297,454884,18006812
"Lunenburg","2012",29631259.6,16974174,0,1069770,343381,478542,18865867
"Lunenburg","2013",31341560.55,17579211,0,1128379,351033,508192,19566815
"Lynn","2003",229180668.41,54076178,0,8522391,3494784,2489188,68582541
"Lynn","2004",215638291.06,56151265,0,8897818,3474749,2687389,71211221
"Lynn","2005",221970913.66,56501157,0,9560049,3391168,2204252,71656626
"Lynn","2006",233610162.27,59882814,0,9791205,3269850,2898713,75842582
"Lynn","2007",248294526.23,64934475,0,10403722,3374348,2942364,81654909
"Lynn","2008",257673255.34,67911448,0,11358779,3433377,3599294,86302898
"Lynn","2009",263234523.38,68142978,0,12871579,3679489,5233378,89927424
"Lynn","2010",256998631.37,69876117,0,14422763,4164904,4619211,93082995
"Lynn","2011",252339763.17,73211939,0,14055324,4062282,6105021,97434566
"Lynn","2012",260556424.67,74607028,0,15118542,4837356,6478450,101041376
"Lynn","2013",277298882.91,75209844,0,15575199,5129618,8431288,104345949
"Lynnfield","2003",30288339.22,18866025,0,1393272,200058,147569,20606924
"Lynnfield","2004",33385251.72,19387230,0,1442309,205555,166261,21201355
"Lynnfield","2005",32654648.91,21029829,0,1487763,203481,145628,22866701
"Lynnfield","2006",34589290.32,21676680,0,1519980,206917,153578,23557155
"Lynnfield","2007",36862441.85,22382876,0,1539349,210004,186685,24318914
"Lynnfield","2008",39484681.41,23190626,0,1735194,215608,198081,25339509
"Lynnfield","2009",43165349.59,25571256,0,1886775,261433,317517,28036981
"Lynnfield","2010",41803520.49,28014895,0,1975548,271742,381918,30644103
"Lynnfield","2011",42905732.61,28799194,0,2065280,273555,415975,31554004
"Lynnfield","2012",43364143.67,29898053,0,2179622,291347,413479,32782501
"Lynnfield","2013",44500727.68,30863853,0,2385567,305172,444395,33998987
"Malden","2003",126454030.73,34787959,0,6455429,2958248,1875839,46077475
"Malden","2004",130757906.6,37352134,0,6574844,3096651,1283706,48307335
"Malden","2005",134941762.47,39270684,0,6794415,3061898,1231061,50358058
"Malden","2006",142805628.03,41463306,0,6948009,2985233,1241429,52637977
"Malden","2007",152054884.81,43435985,0,7296952,3135537,1273554,55142028
"Malden","2008",155263581.23,45708302,0,7266608,3122918,1381709,57479537
"Malden","2009",168933837.64,46957854,0,7989761,3480329,1639288,60067232
"Malden","2010",156141812.32,47659564,0,8829765,3651680,2170654,62311663
"Malden","2011",164686835.06,48295593,0,9819730,4097228,2656102,64868653
"Malden","2012",169542571.83,50050359,0,10194865,4156279,2820460,67221963
"Malden","2013",177075752.72,51790037,0,10542341,4242190,3410667,69985235
"Manchester-by-the-Sea","2003",17563858.12,11893530,0,592170,40963,156626,12683289
"Manchester-by-the-Sea","2004",18705178.91,12530724,0,615802,41803,138900,13327229
"Manchester-by-the-Sea","2005",19042119.66,13662236,0,640987,44781,144623,14492627
"Manchester-by-the-Sea","2006",19840978.88,13999998,0,635609,42912,186962,14865481
"Manchester-by-the-Sea","2007",21160470.04,14721905,0,651876,44196,192100,15610077
"Manchester-by-the-Sea","2008",22101707.4,15293365,0,666922,47756,204248,16212291
"Manchester-by-the-Sea","2009",24493169.5,16994798,0,751136,52025,326023,18123982
"Manchester-by-the-Sea","2010",24692842.16,17593690,0,722522,53689,404181,18774082
"Manchester-by-the-Sea","2011",25319906.52,18230307,0,776469,59017,472428,19538221
"Manchester-by-the-Sea","2012",26466301.78,19713448,0,854274,67513,482117,21117352
"Manchester-by-the-Sea","2013",27247511.36,20513759,0,885933,70308,491854,21961854
"Mansfield","2003",64205534.43,25134130,0,1857905,5205428,902970,33100433
"Mansfield","2004",65572491.23,25926825,0,1906142,5391251,1344419,34568637
"Mansfield","2005",68377082.19,28634787,0,2117901,4908041,828338,36489067
"Mansfield","2006",70671447.69,29780893,0,2219592,4964264,1011824,37976573
"Mansfield","2007",75980345.91,30529720,0,2355420,5102817,1294289,39282246
"Mansfield","2008",81097055.58,31601205,0,2868861,5362275,1344226,41176567
"Mansfield","2009",84303101.97,32174506,0,3277185,5936138,1628097,43015926
"Mansfield","2010",85576208.03,33159979,0,3689972,6556514,1820695,45227160
"Mansfield","2011",84776278.21,33736288,0,4444866,6420277,2043635,46645066
"Mansfield","2012",85265691.28,33552587,0,4715083,6357741,2458909,47084320
"Mansfield","2013",89348546,34709072,0,4962974,6696965,2950464,49319475
"Marblehead","2003",52025600.53,32852264,0,1308935,155002,181101,34497302
"Marblehead","2004",56114428.03,36145616,0,1377882,150824,195738,37870060
"Marblehead","2005",58338253.36,37965463,0,1445934,160166,298810,39870373
"Marblehead","2006",63390131.22,42211874,0,1556121,148336,283296,44199627
"Marblehead","2007",65586721.08,43294709,0,1632838,145274,274896,45347717
"Marblehead","2008",68646649.71,44620580,0,1714641,154905,285194,46775320
"Marblehead","2009",70879435.7,45743508,0,1780152,181111,393078,48097849
"Marblehead","2010",72572255.72,47786229,0,1843244,192262,415149,50236884
"Marblehead","2011",73802692.53,48646858,0,1963643,186750,579071,51376322
"Marblehead","2012",76752907.29,50730309,0,2141208,188673,591239,53651429
"Marblehead","2013",77917478.04,51791023,0,2202750,188440,603082,54785295
"Marion","2003",14625937.9,10237953,0,511771,153182,160023,11062929
"Marion","2004",15817371,10808298,0,543279,158961,171199,11681737
"Marion","2005",16922185.52,11159469,0,483185,137145,145414,11925213
"Marion","2006",18207314.52,11401204,0,536540,117666,109358,12164768
"Marion","2007",20605431.89,12555750,0,567898,126890,121001,13371539
"Marion","2008",21581782.52,12532174,0,580732,129422,142692,13385020
"Marion","2009",21669307,12866687,0,626664,135545,206004,13834900
"Marion","2010",22036780.82,13091065,0,680553,147203,213310,14132131
"Marion","2011",22715954.32,13562463,0,739259,162134,239217,14703073
"Marion","2012",23748148.57,13976861,0,736854,162100,253711,15129526
"Marion","2013",23920288.28,14517001,0,764758,169078,287938,15738775
"Marlborough","2003",98263886.66,32180472,5606,16637221,9305873,2827123,60956295
"Marlborough","2004",104162869.42,34816396,8637,16987087,9030496,3622468,64465084
"Marlborough","2005",105264905.15,39210497,5554,19575581,10137595,3224006,72153233
"Marlborough","2006",113464776.78,40262394,5848,18316583,10326822,3269913,72181560
"Marlborough","2007",118578391.87,43012735,6087,20407280,11628679,3964157,79018938
"Marlborough","2008",122318783.4,43653076,6223,19816480,11606566,4670752,79753097
"Marlborough","2009",131662670.62,43969103,0,22482611,10793004,4690619,81935337
"Marlborough","2010",126293789.2,41430296,0,22527197,11474132,5564425,80996050
"Marlborough","2011",129254865.52,42768021,0,21857032,11860864,7025961,83511878
"Marlborough","2012",132607451.86,44621918,0,22507036,11750387,6966526,85845867
"Marlborough","2013",138639124.25,45212902,0,22788367,11011642,7348449,86361360
"Marshfield","2003",68943263.97,30768244,0,1459529,283607,361086,32872466
"Marshfield","2004",72509579.14,32055044,0,1630304,285435,346025,34316808
"Marshfield","2005",76108371.94,33573074,0,1571532,266091,318471,35729168
"Marshfield","2006",78220111.68,35094202,0,1718759,294924,302328,37410213
"Marshfield","2007",82224333.83,36688025,0,1672633,297615,300859,38959132
"Marshfield","2008",84945178.19,39996775,0,1947425,380384,396096,42720680
"Marshfield","2009",90317014.09,40953862,0,2272804,429000,617033,44272699
"Marshfield","2010",86199817.66,42648138,0,2317274,440871,690843,46097126
"Marshfield","2011",84532680.74,44215437,0,2276753,464500,805505,47762195
"Marshfield","2012",84643594.79,45781402,0,2395298,480331,811823,49468854
"Marshfield","2013",89508229.29,47206437,0,2517249,499120,861531,51084337
"Mashpee","2003",38163142.74,23476508,21427,1686102,133654,690959,26008650
"Mashpee","2004",40209284.88,24751998,19517,1775255,140503,752009,27439282
"Mashpee","2005",41453569.87,26519589,24175,1694162,135347,344751,28718024
"Mashpee","2006",44884986.73,27618517,24742,1804094,140617,361512,29949482
"Mashpee","2007",48259383.77,27792947,25250,1787602,119408,332315,30057522
"Mashpee","2008",52820520.63,30743977,22023,2123497,159631,392284,33441412
"Mashpee","2009",51994766.4,31862022,22982,2342704,195501,442538,34865747
"Mashpee","2010",52368715.12,33309187,22007,2483246,209805,407258,36431503
"Mashpee","2011",51621684.81,34111206,15372,2472875,199744,486402,37285599
"Mashpee","2012",54080833.61,34666651,15291,2494763,208918,487615,37873238
"Mashpee","2013",55614284.57,36593522,16340,2582610,222416,502623,39917511
"Mattapoisett","2003",16656322.12,11274301,0,446196,118247,142774,11981518
"Mattapoisett","2004",17326240.29,11702844,0,493387,121650,170753,12488634
"Mattapoisett","2005",18032425.64,12306982,0,544735,79668,147521,13078906
"Mattapoisett","2006",20890435.52,14200626,0,551892,95645,115226,14963389
"Mattapoisett","2007",22816595.61,14751802,0,559342,97478,167744,15576366
"Mattapoisett","2008",24070875.49,15206685,0,573356,109002,194214,16083257
"Mattapoisett","2009",23926375.91,15736783,0,744285,153713,243069,16877850
"Mattapoisett","2010",25325206.78,16265494,0,771280,166940,272790,17476504
"Mattapoisett","2011",25332228.04,16691280,0,798950,172084,300382,17962696
"Mattapoisett","2012",26245159.65,17152662,0,831076,156745,310720,18451203
"Mattapoisett","2013",27162536.72,17703632,0,803843,162607,335356,19005438
"Maynard","2003",25639594.76,11906854,75270,1170881,1570227,433248,15156480
"Maynard","2004",27970159.64,12867197,95053,1297051,1842938,393933,16496172
"Maynard","2005",28713519.48,13249726,83748,1323521,1877051,385451,16919497
"Maynard","2006",29831035.83,14712793,82164,1361592,1976905,411813,18545267
"Maynard","2007",31936976.58,15387474,66016,1523729,1794015,374456,19145690
"Maynard","2008",33187016.99,16118644,68408,1562903,1877370,428087,20055412
"Maynard","2009",35435841.44,16845272,71138,1650762,1967193,735622,21269987
"Maynard","2010",34308598.91,17711760,0,1780763,2158385,751915,22402823
"Maynard","2011",37682292.4,18877827,0,1710391,1775422,784286,23147926
"Maynard","2012",38080586.94,19736718,0,1726090,1691754,755150,23909712
"Maynard","2013",40299945.1,20909106,0,1829998,1842292,821807,25403203
"Medfield","2003",38272038.01,22261966,61160,654891,515711,250436,23744164
"Medfield","2004",38607802.44,24154313,59314,630288,455768,251901,25551584
"Medfield","2005",43191081.75,26150285,58323,659175,465711,251226,27584720
"Medfield","2006",44237500.01,27073949,0,690484,330599,251646,28346678
"Medfield","2007",46568321.05,28377008,0,769853,311343,247870,29706074
"Medfield","2008",49126319.54,28642468,0,840197,333928,278168,30094761
"Medfield","2009",52994545.4,30188190,0,925103,360985,406788,31881066
"Medfield","2010",50255047.55,30822107,0,975265,381218,457983,32636573
"Medfield","2011",50803538.43,31808577,0,1016942,408765,502276,33736560
"Medfield","2012",52636740,33151469,0,1076660,424823,521352,35174304
"Medfield","2013",51837599.9,33397028,0,1122859,430160,509363,35459410
"Medford","2003",122923296.75,45648511,0,12622940,1454910,1794573,61520934
"Medford","2004",121803816.19,49444634,0,10832398,1887412,1589473,63753917
"Medford","2005",125475834.85,51987206,0,10977525,1952418,1581066,66498215
"Medford","2006",133583389.28,55621263,0,10151313,1760827,1632021,69165424
"Medford","2007",141749732.95,58133388,0,10821376,1629118,1698791,72282673
"Medford","2008",144352230.96,59625362,0,12163000,1773352,1811893,75373607
"Medford","2009",144468767.34,61046293,0,13405348,1939668,2109069,78500378
"Medford","2010",142548295.84,62715235,0,14505283,2030217,2328348,81579083
"Medford","2011",145869254.24,64616047,0,14954181,2143391,2630923,84344542
"Medford","2012",147344257.2,67145187,0,14820359,2196766,2843087,87005399
"Medford","2013",148749129.94,69317296,0,15236198,2275292,3099297,89928083
"Medway","2003",32137635.57,16401158,0,624670,868947,631175,18525950
"Medway","2004",35679709.12,17155405,0,646999,956691,647141,19406236
"Medway","2005",37774712.15,19410360,0,723466,1071659,761414,21966899
"Medway","2006",40821509.08,20840115,0,903054,909261,676448,23328878
"Medway","2007",41725444.04,21717413,0,935905,909418,721812,24284548
"Medway","2008",41657363.99,22093863,0,945816,930693,751025,24721397
"Medway","2009",45655979.63,22943700,0,1052982,935263,971729,25903674
"Medway","2010",45497207.62,23460897,0,1135808,952996,1143844,26693545
"Medway","2011",48800656.78,23996191,0,1193981,999977,1272679,27462828
"Medway","2012",48715155.23,24586940,0,1269861,980863,1564931,28402595
"Medway","2013",52302984.77,25579647,0,1328242,1029344,1659491,29596724
"Melrose","2003",61927036.86,29260900,0,1952393,425269,618552,32257114
"Melrose","2004",60827670.95,30420711,0,1919479,420166,597754,33358110
"Melrose","2005",62865165.36,31646603,0,2041482,309581,563083,34560749
"Melrose","2006",66329735.03,33012052,0,2024351,284706,578699,35899808
"Melrose","2007",69617253.46,35109668,0,2103295,296766,571944,38081673
"Melrose","2008",72399986.41,36662126,0,2232040,326813,644072,39865051
"Melrose","2009",77524773.39,38396244,0,2286274,336048,938868,41957434
"Melrose","2010",76169079.31,39942033,0,2378060,319975,1136149,43776217
"Melrose","2011",77696113.34,41174700,0,2437712,315936,1194253,45122601
"Melrose","2012",81657423.49,42424245,0,2453507,343896,1274775,46496423
"Melrose","2013",83708162.1,43742186,0,2557367,357485,1356301,48013339
"Mendon","2003",9635319.45,6349014,0,375203,63460,174023,6961700
"Mendon","2004",10260207.19,7117716,0,390057,65108,199633,7772514
"Mendon","2005",10291591.35,7140400,0,371668,61502,193415,7766985
"Mendon","2006",11663384.45,7841564,0,399572,65887,192492,8499515
"Mendon","2007",12493553.26,8040807,0,420861,66345,198776,8726789
"Mendon","2008",13198335.72,8967668,0,469440,71137,234823,9743068
"Mendon","2009",13896134.49,9277813,0,563127,57968,305588,10204496
"Mendon","2010",14608619.38,9354287,0,594522,58875,332247,10339931
"Mendon","2011",14943458.47,9792875,0,710512,63524,410190,10977101
"Mendon","2012",15039554.34,10269698,0,749098,66602,420257,11505655
"Mendon","2013",15226019.14,10621703,0,786811,69356,466204,11944074
"Merrimac","2003",10591823.81,5732439,0,197883,95789,59406,6085517
"Merrimac","2004",10783183.29,6383870,0,179793,86718,53897,6704278
"Merrimac","2005",11778208.52,6844170,0,191593,90547,52245,7178555
"Merrimac","2006",13158103.52,7563080,0,178463,84448,50828,7876819
"Merrimac","2007",13442053.54,7756875,0,193504,87450,46676,8084505
"Merrimac","2008",13859636.64,8170242,0,207899,94468,60900,8533509
"Merrimac","2009",14375327.95,8443033,0,229260,102613,82922,8857828
"Merrimac","2010",14350349.93,8980510,0,254592,104040,87896,9427038
"Merrimac","2011",14674358.66,9184153,0,271215,110273,112771,9678412
"Merrimac","2012",15440049.79,9442558,0,300199,119697,118887,9981341
"Merrimac","2013",15219339.24,9697804,0,303971,114743,131077,10247595
"Methuen","2003",100038288.66,33900029,0,5597469,2655350,1480287,43633135
"Methuen","2004",100168532.19,34304677,0,5541312,2781246,1521666,44148901
"Methuen","2005",104594004.43,37179286,0,5509349,2671906,1791045,47151586
"Methuen","2006",114287602.91,39601721,0,5963897,2582042,1698970,49846630
"Methuen","2007",118848063.18,41992417,0,6212047,2781531,1935861,52921856
"Methuen","2008",126809888.94,45159825,0,7084428,3096976,2140801,57482030
"Methuen","2009",130812408.86,45462614,0,8166527,3407601,2776408,59813150
"Methuen","2010",128436263.46,46269183,0,8311461,3420018,3296826,61297488
"Methuen","2011",132976265.1,46852257,0,8491270,3459230,3385461,62188218
"Methuen","2012",135428562.84,48646805,0,9156562,3312738,3452217,64568322
"Methuen","2013",138821410.53,51323140,0,9616011,3493630,3691129,68123910
"Middleborough","2003",50216640.12,16425378,0,3274661,632872,487887,20820798
"Middleborough","2004",53579404.02,18081560,0,2764153,615416,337319,21798448
"Middleborough","2005",56002145.79,19486049,0,2737645,567691,281526,23072911
"Middleborough","2006",60382004.47,20919381,0,2633091,515097,254082,24321651
"Middleborough","2007",64319397.43,21599566,0,3165018,551572,271542,25587698
"Middleborough","2008",65166443.81,22432119,0,3461351,598194,365800,26857464
"Middleborough","2009",67397210.25,23410840,0,3684038,650503,664783,28410164
"Middleborough","2010",71226744.59,24214238,0,4032433,740175,677296,29664142
"Middleborough","2011",67680318.74,24742452,0,4386535,873571,829671,30832229
"Middleborough","2012",68771252.51,25400753,0,4764021,933415,850778,31948967
"Middleborough","2013",71945284.24,26016922,0,5235625,999619,927111,33179277
"Middlefield","2003",975278.02,676101,0,25645,267,30634,732647
"Middlefield","2004",981003.6,681355,0,32124,271,34549,748299
"Middlefield","2005",985437.04,717143,0,34900,325,30336,782704
"Middlefield","2006",1099343.86,775069,0,35898,330,28886,840183
"Middlefield","2007",1272137.89,819798,0,38171,357,27058,885384
"Middlefield","2008",1584829.93,950291,0,26747,463,30089,1007590
"Middlefield","2009",1519123.36,924250,0,31818,402,43201,999671
"Middlefield","2010",1433299.71,972559,0,41575,426,46292,1060852
"Middlefield","2011",1406652.38,907521,0,44334,376,42446,994677
"Middlefield","2012",1375785.38,937029,0,48499,390,45563,1031481
"Middlefield","2013",1412232.51,958250,0,49409,399,46701,1054759
"Middleton","2003",17985283.47,10263995,0,1543577,459483,185018,12452073
"Middleton","2004",18084358.8,11093916,0,1494163,441532,204302,13233913
"Middleton","2005",19312858.18,11804803,0,1535958,459065,327510,14127336
"Middleton","2006",20856264,12728513,0,1416729,444448,319299,14908989
"Middleton","2007",22861365.31,13692798,0,1569157,456627,342200,16060782
"Middleton","2008",23763136.63,14213132,0,1855609,525560,367264,16961565
"Middleton","2009",25988597.97,15083493,0,2178274,592731,489985,18344483
"Middleton","2010",25371253.32,15018148,0,2330695,705417,599004,18653264
"Middleton","2011",25999236.02,15744678,0,2347635,694856,561650,19348819
"Middleton","2012",27051043.31,16611064,0,2269806,744435,593715,20219020
"Middleton","2013",28283838.04,17647251,0,2302688,779357,598634,21327930
"Milford","2003",65098327.09,22464817,0,6277767,3872186,3226628,35841398
"Milford","2004",62583813.63,25561470,0,5965408,3952414,2681174,38160466
"Milford","2005",63705719.08,26984410,0,6278459,4006822,2508270,39777961
"Milford","2006",67806950.93,28683568,0,6401138,3897207,2333637,41315550
"Milford","2007",71758201.83,30743885,0,6980874,4308655,1903558,43936972
"Milford","2008",76328298.95,32344548,0,7682707,4281478,1937771,46246504
"Milford","2009",78593494.24,32827222,0,8324552,4680203,2329014,48160991
"Milford","2010",79537851.69,34117175,0,8773569,4767565,2363835,50022144
"Milford","2011",81263915.89,34523141,0,9131048,4816831,2728153,51199173
"Milford","2012",84107985.39,35250937,0,9592288,5311057,2863381,53017663
"Milford","2013",89969385.58,36369065,0,9885697,5453360,3117611,54825733
"Millbury","2003",25401146.64,10643343,0,609897,635784,805971,12694995
"Millbury","2004",26219271.81,10827678,0,630282,639673,831225,12928858
"Millbury","2005",30240140.55,11360828,0,909430,583754,665463,13519475
"Millbury","2006",31923049.75,13037985,0,1565328,649105,661598,15914016
"Millbury","2007",35708246.58,13345366,0,1592050,649117,660262,16246795
"Millbury","2008",34551613.62,13903990,0,1647899,652020,701105,16905014
"Millbury","2009",37165813.43,14071204,0,1860597,705107,928573,17565481
"Millbury","2010",37005220.41,14680820,0,2129538,818505,1012209,18641072
"Millbury","2011",35845197.76,14802822,0,2299704,877039,1104735,19084300
"Millbury","2012",36874889.12,15157451,0,2314979,899069,1279141,19650640
"Millbury","2013",37897053.23,15704133,0,2409885,911896,1421286,20447200
"Millis","2003",19926101.68,9634506,0,729928,216957,182599,10763990
"Millis","2004",19114829.79,9958250,0,731145,221857,211018,11122270
"Millis","2005",20312141.26,10506334,0,612037,183549,172211,11474131
"Millis","2006",21238870.76,10790584,0,612178,184095,173082,11759939
"Millis","2007",22838371.14,12283625,0,726101,212144,192648,13414518
"Millis","2008",23872871.14,12637462,0,809110,225238,208041,13879851
"Millis","2009",26107514.83,13370196,0,885695,240969,320389,14817249
"Millis","2010",25867641.12,13113180,0,894758,233102,301320,14542360
"Millis","2011",26062486.58,13754797,0,981509,262353,343999,15342658
"Millis","2012",26886192.07,13814260,0,991341,263007,350525,15419133
"Millis","2013",27821332.55,14616843,0,1056961,278072,376461,16328337
"Millville","2003",3912271.9,2490434,0,45256,18484,74751,2628925
"Millville","2004",4316329.54,2849102,0,47718,20357,91510,3008687
"Millville","2005",4589082.65,2991588,0,40393,20348,88700,3141029
"Millville","2006",4782823.78,3134269,0,42684,21085,96071,3294109
"Millville","2007",5049872.3,3275433,0,41355,23892,92581,3433261
"Millville","2008",5135873.88,3387734,0,48045,26658,94129,3556566
"Millville","2009",4932587.21,3463369,0,48286,28030,123004,3662689
"Millville","2010",5262047.05,3575527,0,50246,28770,126448,3780991
"Millville","2011",5168340.1,3493179,0,54851,30817,150407,3729254
"Millville","2012",5113632.69,3596978,0,60659,30262,161129,3849028
"Millville","2013",5513835.48,3781477,0,69041,32227,174667,4057412
"Milton","2003",64874605.42,38003889,0,1671415,142801,575369,40393474
"Milton","2004",64957247.41,39447591,0,1685274,129262,663906,41926033
"Milton","2005",69300247.6,41341706,0,1831049,111356,655746,43939857
"Milton","2006",75968786.85,44979742,0,1880703,113150,672443,47646038
"Milton","2007",80251632.23,48581740,0,1913214,122673,699235,51316862
"Milton","2008",81898152.28,49450728,0,1836201,105749,842209,52234887
"Milton","2009",83694061.47,50891493,0,1840024,90560,993669,53815746
"Milton","2010",86785708.5,56597486,0,2116074,99020,1306901,60119481
"Milton","2011",88343671.47,58031519,0,2161611,94040,1514489,61801659
"Milton","2012",91600313.3,59654558,0,2193808,91432,1590539,63530337
"Milton","2013",93844387.03,60899835,0,2330708,91810,1642024,64964377
"Monroe","2003",579171.44,93342,0,12971,236490,19951,362754
"Monroe","2004",541673.89,98608,0,13399,241486,19509,373002
"Monroe","2005",730710.67,96792,0,12937,233149,39307,382185
"Monroe","2006",612639.42,94695,0,12668,219495,47126,373984
"Monroe","2007",622480.96,101902,0,12312,213331,74835,402380
"Monroe","2008",715013.58,119867,0,14710,254886,83923,473386
"Monroe","2009",885914.77,119910,0,10766,296840,67658,495174
"Monroe","2010",684318.87,113602,0,12025,269533,74078,469238
"Monroe","2011",701367.53,113425,0,12131,262410,72377,460343
"Monroe","2012",731385.38,117852,0,12601,279184,77079,486716
"Monroe","2013",881517.03,129949,0,14045,302444,90391,536829
"Monson","2003",21154622.22,7038787,0,371990,187078,337958,7935813
"Monson","2004",21947193.14,7533766,0,345986,160906,325633,8366291
"Monson","2005",22681945.72,7173150,0,312703,139072,243717,7868642
"Monson","2006",23610625.07,7348764,0,304338,135017,227692,8015811
"Monson","2007",24801478.02,7911696,0,306586,135355,212997,8566634
"Monson","2008",25712062.35,8728538,0,290678,138326,232381,9389923
"Monson","2009",26809818.35,9295716,0,318554,117980,320540,10052790
"Monson","2010",27188042.11,9574997,0,332732,124784,339003,10371516
"Monson","2011",26346951.67,9859028,0,344498,130964,383685,10718175
"Monson","2012",25374126.03,10020269,0,342419,137381,410157,10910226
"Monson","2013",24961258.19,10340884,0,356404,140007,452924,11290219
"Montague","2003",14324019.64,6010491,39534,541220,2180793,637133,9409171
"Montague","2004",14342115.65,6479152,45951,601562,2190562,628686,9945913
"Montague","2005",14418943.72,6381481,49787,581685,2158388,618490,9789831
"Montague","2006",16753369.05,6686634,48932,610119,2042066,648674,10036425
"Montague","2007",17180762.45,7263988,59767,650086,1557901,616516,10148258
"Montague","2008",17513021,7537977,58489,677453,1573260,663058,10510237
"Montague","2009",17535580.94,7948201,57391,724215,1711742,805737,11247286
"Montague","2010",18342073.72,8079102,0,737225,2368506,687330,11872163
"Montague","2011",17975567.11,8505402,0,805776,2531962,881568,12724708
"Montague","2012",19171783.75,8736800,0,844765,2643173,921396,13146134
"Montague","2013",18841913.23,9042581,0,871030,2797555,907028,13618194
"Monterey","2003",2640022.61,1830409,0,47632,2169,44448,1924658
"Monterey","2004",2352795.4,1893539,0,44159,2224,46319,1986241
"Monterey","2005",2564469.21,1965735,0,41788,2239,36440,2046202
"Monterey","2006",2722242.72,2183608,0,42086,990,40065,2266749
"Monterey","2007",2968875.92,2239030,0,40160,1010,39796,2319996
"Monterey","2008",2943043.88,2298180,0,43987,989,38709,2381865
"Monterey","2009",3272877.16,2451005,0,45876,1013,35813,2533707
"Monterey","2010",3257274.07,2542188,0,53485,1040,37853,2634566
"Monterey","2011",3302807.44,2517523,0,54208,1026,37312,2610069
"Monterey","2012",3439929.93,2542325,0,54173,910,38603,2636011
"Monterey","2013",3403692.85,2699771,0,58416,965,44243,2803395
"Montgomery","2003",1337435.77,825637,0,18306,5297,18251,867491
"Montgomery","2004",1388424.71,866390,0,20072,5221,17089,908772
"Montgomery","2005",1455192.16,931436,0,20651,5205,16925,974217
"Montgomery","2006",1454318.01,964197,0,22658,5659,14148,1006662
"Montgomery","2007",1771084.61,1076309,0,20779,5108,14853,1117049
"Montgomery","2008",1705830.4,1170149,0,22633,5499,16395,1214676
"Montgomery","2009",1848776.15,1213628,0,24449,6011,22505,1266593
"Montgomery","2010",1784487.97,1228679,0,23921,8013,22696,1283309
"Montgomery","2011",1845473.77,1312352,0,21161,7051,25204,1365768
"Montgomery","2012",1944576.58,1357288,0,20943,7129,30771,1416131
"Montgomery","2013",2037646.77,1390974,0,21960,8793,31684,1453411
"Mount Washington","2003",455374.11,240665,0,533,3533,5654,250385
"Mount Washington","2004",566248.76,298351,0,460,3871,6436,309118
"Mount Washington","2005",472097.06,290530,0,436,3665,5790,300421
"Mount Washington","2006",569566.13,332902,0,492,4226,6403,344023
"Mount Washington","2007",668879.97,373372,0,602,4826,6102,384902
"Mount Washington","2008",762690.52,408211,0,94,5193,6624,420122
"Mount Washington","2009",959079.28,423417,0,97,4676,8491,436681
"Mount Washington","2010",975354.01,434736,0,236,4087,9027,448086
"Mount Washington","2011",829522.64,435121,0,160,3523,8811,447615
"Mount Washington","2012",1191620.38,459404,0,144,3814,9895,473257
"Mount Washington","2013",1150776.1,478367,0,136,3943,10036,492482
"Nahant","2003",9045189.16,5041058,0,106506,2403,39213,5189180
"Nahant","2004",9056374.45,5209430,0,103718,2592,35265,5351005
"Nahant","2005",9628297.38,5380355,0,105054,2690,94344,5582443
"Nahant","2006",10121007.88,5559839,0,105480,2790,88893,5757002
"Nahant","2007",10836392.35,5809514,0,106901,2955,94369,6013739
"Nahant","2008",12002599.41,6973534,0,133747,2975,104912,7215168
"Nahant","2009",12186156.46,6937860,0,130741,2899,140881,7212381
"Nahant","2010",11742660,7037732,0,137064,2584,156271,7333651
"Nahant","2011",11899128.46,7197259,0,129246,2608,179649,7508762
"Nahant","2012",12117778.44,7392568,0,133739,2751,185234,7714292
"Nahant","2013",12557154.75,7551064,0,137771,2801,202833,7894469
"Nantucket","2003",65937983.51,32936553,38963,3831566,151236,763939,37722257
"Nantucket","2004",72175812.78,35111054,30292,4349486,223156,631026,40345014
"Nantucket","2005",80145220.29,37721706,31907,4442769,222109,898971,43317462
"Nantucket","2006",89059885.84,41633341,73445,4673890,242909,997297,47620882
"Nantucket","2007",99500180.07,45061618,67275,5693987,292435,803956,51919271
"Nantucket","2008",103113729.37,48898998,72060,5954890,342639,951420,56220007
"Nantucket","2009",108918865.41,51085440,74593,5964360,364053,1021696,58510142
"Nantucket","2010",111657023.59,53597537,44065,6269759,327458,1094777,61333596
"Nantucket","2011",104528150.64,54127313,41562,7167045,359950,1344280,63040150
"Nantucket","2012",108229933.52,53660910,76032,6835572,346955,1355275,62274744
"Nantucket","2013",112148715.47,55805960,78723,6069084,327931,1336576,63618274
"Natick","2003",89671308.95,40877621,0,11682409,735555,843249,54138834
"Natick","2004",92586900.53,43554556,0,10742523,769825,856926,55923830
"Natick","2005",96456188.63,45662661,0,11765021,622290,800734,58850706
"Natick","2006",100785887.65,48312860,0,11449836,601908,804658,61169262
"Natick","2007",109651561.51,50120567,0,11333194,603579,782174,62839514
"Natick","2008",111634235.45,51612195,0,12002486,619826,952153,65186660
"Natick","2009",114250149.4,56446713,0,14612120,700975,1268159,73027967
"Natick","2010",115702630.2,58645346,0,16238181,757916,1329630,76971073
"Natick","2011",119367560.32,60902611,0,16590019,739657,1412910,79645197
"Natick","2012",131040458,66253864,0,17848195,786706,1566553,86455318
"Natick","2013",134164537,68531970,0,18516957,576654,1697864,89323445
"Needham","2003",89285786.38,43678907,0,9153215,2490062,1363081,56685265
"Needham","2004",93174836.32,47831181,0,9345317,2751624,1528463,61456585
"Needham","2005",96649089.65,50398379,0,9494675,2793982,1754424,64441460
"Needham","2006",104294153.95,54568162,0,10018642,2641893,1753223,68981920
"Needham","2007",125517445.21,58789954,0,10674387,2520319,1943045,73927705
"Needham","2008",117827098.22,61486288,0,11453493,2627651,2383913,77951345
"Needham","2009",125744963.75,63779919,0,12914270,2597144,2634318,81925651
"Needham","2010",134191732.63,68322324,0,13723527,2694575,3091700,87832126
"Needham","2011",133119697.91,71793779,0,14946375,2744847,3586745,93071746
"Needham","2012",136706999.61,74902426,0,15283199,2606690,3454136,96246451
"Needham","2013",144990958.02,78219084,0,15594044,2686193,3942950,100442271
"New Ashford","2003",399623.48,118856,3544,61380,0,21416,205196
"New Ashford","2004",464023.29,142978,4226,73873,0,32917,253994
"New Ashford","2005",476588.56,157937,3640,72716,0,28704,262997
"New Ashford","2006",521367.63,173488,2187,78089,0,17612,271376
"New Ashford","2007",532458.35,175044,2131,74424,2834,19060,273493
"New Ashford","2008",535346.17,173265,2082,67732,2754,18729,264562
"New Ashford","2009",690152.45,221245,4257,86753,2998,21024,336277
"New Ashford","2010",606952.02,232759,4168,96702,3373,23867,360869
"New Ashford","2011",681099.27,248377,4386,88578,3098,21554,365993
"New Ashford","2012",698762.81,281379,4955,65406,3665,24166,379571
"New Ashford","2013",719535.81,291279,5134,68275,3797,24634,393119
"New Bedford","2003",245359532.97,42750143,0,11629090,6134303,3714153,64227689
"New Bedford","2004",239478519.15,46085275,0,12678670,6211794,3636007,68611746
"New Bedford","2005",252606639.54,49065023,0,13887687,6555113,3430150,72937973
"New Bedford","2006",261645724.85,52925445,0,14564519,6516963,3157525,77164452
"New Bedford","2007",275719162.22,57970084,0,13998703,6543698,3033140,81545625
"New Bedford","2008",294021554.77,59683448,0,13543966,6232742,3217719,82677875
"New Bedford","2009",298618880.29,62948451,0,15021400,6882397,3945061,88797309
"New Bedford","2010",292017375.64,64766528,0,16056629,6972203,4353368,92148728
"New Bedford","2011",281808527.11,63123965,0,17369164,7525097,5141972,93160198
"New Bedford","2012",296641776.78,62818432,0,18302897,7844582,5427581,94393492
"New Bedford","2013",296561069.32,62791954,0,18777451,8216217,5432881,95218503
"New Braintree","2003",1447685.89,938973,0,50802,3744,28785,1022304
"New Braintree","2004",1405555.49,983635,0,47074,1803,27356,1059868
"New Braintree","2005",1600851.28,1107796,0,47996,2842,23570,1182204
"New Braintree","2006",1762438.46,1182277,0,49710,2943,22775,1257705
"New Braintree","2007",1821865.4,1278337,0,49297,755,22311,1350700
"New Braintree","2008",1971410.7,1369192,0,50249,792,25500,1445733
"New Braintree","2009",2022955.51,1459757,0,56090,834,33601,1550282
"New Braintree","2010",1977052.4,1497992,0,59393,603,34588,1592576
"New Braintree","2011",2084981.63,1546339,0,69770,0,37437,1653546
"New Braintree","2012",2104726.39,1566997,0,62389,60,40809,1670255
"New Braintree","2013",2171714.66,1653161,0,67795,57,40335,1761348
"New Marlborough","2003",2864024.37,2140941,874,106605,10532,52853,2311805
"New Marlborough","2004",3172763.32,2329189,0,113956,10848,29823,2483816
"New Marlborough","2005",3307786.86,2434340,0,121419,11190,32345,2599294
"New Marlborough","2006",3467921.29,2789618,0,138930,13460,30997,2973005
"New Marlborough","2007",3576629.19,2717268,0,131794,11686,27660,2888408
"New Marlborough","2008",4123650.33,3017951,0,144662,12861,31115,3206589
"New Marlborough","2009",4540376.22,3391560,0,156842,15539,46448,3610389
"New Marlborough","2010",4425559.91,3484376,0,161550,15825,48257,3710008
"New Marlborough","2011",4298779.96,3614349,0,163862,16278,50542,3845031
"New Marlborough","2012",4546423.94,3763747,0,167084,16912,51242,3998985
"New Marlborough","2013",4909724.89,3982368,0,175809,18526,50671,4227374
"New Salem","2003",1667076.51,883005,0,24105,2413,17683,927206
"New Salem","2004",1733792.65,1009459,0,25945,2702,30299,1068405
"New Salem","2005",1902245.49,1039924,0,26637,2530,24897,1093988
"New Salem","2006",1956117.58,1103154,0,19635,2573,18666,1144028
"New Salem","2007",2076300.16,1258994,0,21286,2855,19278,1302413
"New Salem","2008",2152599.81,1319822,0,27055,3435,22838,1373150
"New Salem","2009",2248407.21,1366572,3773,21506,5656,37356,1434863
"New Salem","2010",2291050.38,1407391,3245,22827,5816,42454,1481733
"New Salem","2011",2388988.75,1461744,3358,24014,6249,58500,1553865
"New Salem","2012",2579857.9,1478923,3537,24373,6543,98504,1611880
"New Salem","2013",2597028.29,1533577,4120,27658,14274,89922,1669551
"Newbury","2003",12845229.97,8746622,0,280644,27069,129530,9183865
"Newbury","2004",12941008.25,9004997,0,283515,23333,120494,9432339
"Newbury","2005",13525120.37,9476279,0,286181,23092,107275,9892827
"Newbury","2006",14812745.96,10725183,0,314892,26104,115440,11181619
"Newbury","2007",15393150.21,11355585,0,338325,27893,112734,11834537
"Newbury","2008",17656621.78,11644675,0,347310,29668,125824,12147477
"Newbury","2009",16687406.96,11901382,0,362516,30228,151171,12445297
"Newbury","2010",17641831.41,12445180,0,378184,28948,166693,13019005
"Newbury","2011",17032259.66,12522419,0,393892,30510,172814,13119635
"Newbury","2012",18004073.76,12678391,0,409668,32821,199722,13320602
"Newbury","2013",18011343.45,13005529,0,416887,32281,202681,13657378
"Newburyport","2003",46224139.53,24316100,4999,2367067,1660228,453528,28801922
"Newburyport","2004",51366073.52,25812201,5835,2515966,1760941,505231,30600174
"Newburyport","2005",52699214.79,27881549,5156,2450821,1492514,417726,32247766
"Newburyport","2006",56600213.38,29312640,5323,2441206,1507639,414333,33681141
"Newburyport","2007",59700592.59,30932404,4859,2538781,1550234,392948,35419226
"Newburyport","2008",60360480.35,31630324,3398,2785527,1821483,472448,36713180
"Newburyport","2009",61063524.42,32597425,3666,2961034,1849486,596902,38008513
"Newburyport","2010",60894966.78,33446659,3911,3231576,1934525,673933,39290604
"Newburyport","2011",63968039.98,34700578,2744,3212179,1936975,722822,40575298
"Newburyport","2012",66223196.11,35927774,2811,3371513,2045322,759582,42107002
"Newburyport","2013",65799938.28,37078857,2817,3472036,2063416,737342,43354468
"Newton","2003",265985159.42,145785983,0,27843021,2648151,3893065,180170220
"Newton","2004",276569321.84,154074872,0,26633994,2515954,4159905,187384725
"Newton","2005",284263988.78,161600544,0,26515410,2572997,3500971,194189922
"Newton","2006",296654581.47,168840600,0,26293350,2601812,3502280,201238042
"Newton","2007",304305025.85,175221741,0,27193831,2635958,3452598,208504128
"Newton","2008",325448862.61,179245608,0,29939010,2684235,3903572,215772425
"Newton","2009",334466112.59,185846467,0,31211463,2772712,5065867,224896509
"Newton","2010",350445656.63,191384572,0,33298008,2974046,5643658,233300284
"Newton","2011",348955881.96,197438985,0,35164961,3064699,6039209,241707854
"Newton","2012",361603797.35,204153075,0,36236017,3228846,7163902,250781840
"Newton","2013",375735689.48,211944528,0,37209039,3310792,7710976,260175335
"Norfolk","2003",23487290.65,12980005,1785,391851,107051,130826,13611518
"Norfolk","2004",24591704.4,13547503,1690,531113,126074,129554,14335934
"Norfolk","2005",26582154.81,14632291,1933,561175,128981,166946,15491326
"Norfolk","2006",28572400.03,16920601,6848,604886,154923,171436,17858694
"Norfolk","2007",31862358.86,17886999,4460,636816,162928,183735,18874938
"Norfolk","2008",31928288.31,18230153,4692,716085,164626,213546,19329102
"Norfolk","2009",31826370.56,19091950,5092,793586,165828,303910,20360366
"Norfolk","2010",32626042.13,19715615,5437,835181,171287,394400,21121920
"Norfolk","2011",32666799.78,20335891,5835,925681,188854,417576,21873837
"Norfolk","2012",34396408.72,22294162,6364,1013625,210801,449771,23974723
"Norfolk","2013",37500447.95,23346123,7796,1033241,212462,459056,25058678
"North Adams","2003",35815188.17,4791527,12030,2055665,639589,656569,8155380
"North Adams","2004",34955590.55,5024837,11307,2139277,614828,760260,8550509
"North Adams","2005",36154947.2,5204345,10438,2230975,659187,751475,8856420
"North Adams","2006",39316877.13,5406095,10761,2364385,681782,736359,9199382
"North Adams","2007",39774044.15,5672106,0,2568753,731398,680305,9652562
"North Adams","2008",40762533.16,6439137,0,2654806,748015,712443,10554401
"North Adams","2009",40385718.36,6674574,0,2760581,748117,868877,11052149
"North Adams","2010",40330549.84,6992577,0,2958561,724256,926195,11601589
"North Adams","2011",41527662.87,7717133,0,3306662,798788,1031582,12854165
"North Adams","2012",40093739.8,8172331,0,3362345,819329,887147,13241152
"North Adams","2013",41156019.12,8422559,0,3423227,810450,1030149,13686385
"North Andover","2003",70761978.81,34961897,0,3088916,2511304,823030,41385147
"North Andover","2004",74594184.77,38158222,0,3441456,2637449,804409,45041536
"North Andover","2005",76621769.33,39603439,0,3019317,2216637,977316,45816709
"North Andover","2006",81745554.6,41704830,0,3237622,2366656,1091294,48400402
"North Andover","2007",81968146.81,42983411,0,3613257,2202311,984272,49783251
"North Andover","2008",87933438.97,45618066,0,3910625,2302481,1129991,52961163
"North Andover","2009",88950415.65,45993084,0,4683072,2732839,1665903,55074898
"North Andover","2010",86904594.9,46758072,0,5068096,2976298,1912966,56715432
"North Andover","2011",89712389.09,48179307,0,5274914,3018522,2101981,58574724
"North Andover","2012",90488873.1,49921745,0,5342557,3036032,2326024,60626358
"North Andover","2013",93421866.03,50943262,0,5242642,3043268,2205407,61434579
"North Attleborough","2003",65238360.26,20705688,0,6068466,751229,489848,28015231
"North Attleborough","2004",69195239.66,22351786,0,6459715,807030,676914,30295445
"North Attleborough","2005",71983443.68,25095878,0,5783973,757639,501015,32138505
"North Attleborough","2006",75459608.4,26268344,0,6184848,839251,509341,33801784
"North Attleborough","2007",81905001.21,27794981,0,6331256,873564,504886,35504687
"North Attleborough","2008",85798504.08,29125095,0,6262300,1003666,485478,36876539
"North Attleborough","2009",86700671.02,29692543,0,6718459,1085823,589119,38085944
"North Attleborough","2010",86992072.64,30418072,0,6975403,1125657,621275,39140407
"North Attleborough","2011",84719564.22,31245611,0,7185029,1170973,797926,40399539
"North Attleborough","2012",86862292.89,32549977,0,7098312,1185940,804415,41638644
"North Attleborough","2013",89211165.72,33883386,0,7033992,1198947,763615,42879940
"North Brookfield","2003",11168009.35,2730136,0,169218,120326,89636,3109316
"North Brookfield","2004",11414877.77,3062995,0,153147,103744,68197,3388083
"North Brookfield","2005",12231677.77,3174155,0,155222,104939,62828,3497144
"North Brookfield","2006",13398461.02,3586452,0,150037,106863,60997,3904349
"North Brookfield","2007",13764430.68,3818135,0,145353,105274,50267,4119029
"North Brookfield","2008",14012674.97,4129303,0,155932,111816,55474,4452525
"North Brookfield","2009",14487683.36,4391265,0,169165,117334,86644,4764408
"North Brookfield","2010",13900686.13,4540757,0,172514,123493,99886,4936650
"North Brookfield","2011",13960009.84,4902348,0,194945,133217,112822,5343332
"North Brookfield","2012",13990635.41,4884650,0,189804,132600,110540,5317594
"North Brookfield","2013",14124485.93,5139794,0,201142,130802,122747,5594485
"North Reading","2003",37452661.71,19040067,0,1536240,1542145,176866,22295318
"North Reading","2004",39396787.1,20013449,0,1525475,1467172,242275,23248371
"North Reading","2005",41635019.03,22787074,0,1629730,1193719,210224,25820747
"North Reading","2006",44883408.63,23927602,0,1666502,1170957,199587,26964648
"North Reading","2007",49011759.64,25968969,0,1787832,1204204,224795,29185800
"North Reading","2008",51262018.91,27249678,0,1983967,1260183,355451,30849279
"North Reading","2009",54104554.73,28380862,0,2089880,1400409,551683,32422834
"North Reading","2010",54871884.27,29164094,0,2318563,1494412,754127,33731196
"North Reading","2011",54729786.04,30356441,0,2352462,1520911,661287,34891101
"North Reading","2012",57300687.88,31405922,0,2448468,1573105,614879,36042374
"North Reading","2013",62509067.46,35240271,0,2755575,1759176,704210,40459232
"Northampton","2003",66712201.39,22234474,0,4635353,1109428,1039024,29018279
"Northampton","2004",71340503.14,23858305,0,4886676,1033609,735286,30513876
"Northampton","2005",70633201.33,25258916,0,4792902,1003082,721871,31776771
"Northampton","2006",76365337.71,26561687,0,4466692,925551,689579,32643509
"Northampton","2007",83664116.95,27789052,0,4976264,954198,693850,34413364
"Northampton","2008",87286459.83,28942969,0,4984671,977913,862616,35768169
"Northampton","2009",90069639.11,29856224,0,5253743,1020745,1066659,37197371
"Northampton","2010",91303542.48,32494563,0,5707666,1061927,1102381,40366537
"Northampton","2011",91673463.7,33469556,0,5850598,1137507,1179342,41637003
"Northampton","2012",95370225.96,34667579,0,5999515,1313405,1245463,43225962
"Northampton","2013",97841314.1,36299783,0,6328257,1513350,1247043,45388433
"Northborough","2003",35079122.87,18572684,23204,2018184,2515449,678875,23808396
"Northborough","2004",38553877.48,21795725,29591,1993773,2672134,725797,27217020
"Northborough","2005",39210734.3,21942249,24701,2059930,2864241,685441,27576562
"Northborough","2006",40909482.27,22996770,28123,2061972,2979344,634440,28700649
"Northborough","2007",44520820.8,24679890,32636,2238889,3156519,631792,30739726
"Northborough","2008",47093262.64,25783048,31997,2433468,3540583,811120,32600216
"Northborough","2009",48298027.02,26799983,33024,2529067,3729117,1148422,34239613
"Northborough","2010",48663321.66,28070518,1447,2632580,3846922,1088724,35640191
"Northborough","2011",49430534.53,28568015,1520,2733033,4253312,1139754,36695634
"Northborough","2012",52558749.3,29469457,883,3598685,4213286,1120427,38402738
"Northborough","2013",55949515.21,29930872,0,4678642,4314737,1219257,40143508
"Northbridge","2003",34112603.11,9720535,180160,706491,249932,306918,11164036
"Northbridge","2004",36672389.83,10338012,161447,713740,263379,379637,11856215
"Northbridge","2005",38829601.01,11144901,0,834704,309144,245123,12533872
"Northbridge","2006",38751599.52,12141671,0,785252,296524,247615,13471062
"Northbridge","2007",43013704.18,12616588,0,818734,301243,240942,13977507
"Northbridge","2008",41939901.17,13044111,0,1176035,396363,269660,14886169
"Northbridge","2009",44024622.93,14087707,0,1320313,426598,416461,16251079
"Northbridge","2010",44239435.51,13746027,0,1316773,419606,491344,15973750
"Northbridge","2011",42152425.33,14365622,0,1293489,407364,558432,16624907
"Northbridge","2012",44851829.91,15519363,0,1416525,448458,571925,17956271
"Northbridge","2013",44548438.27,15008090,0,1377121,428079,538811,17352101
"Northfield","2003",5825223.34,2141529,0,146231,988671,243451,3519882
"Northfield","2004",5756568.32,2519174,0,140052,890934,158772,3708932
"Northfield","2005",5848357.8,2965268,0,165334,973548,168993,4273143
"Northfield","2006",6057170.19,3178730,0,179334,644572,490944,4493580
"Northfield","2007",6317208.78,3371470,0,177529,650698,497571,4697268
"Northfield","2008",6750214.31,3770439,0,195693,616950,513185,5096267
"Northfield","2009",7085622.74,3975826,0,197617,987999,221263,5382705
"Northfield","2010",6757951.74,4048357,0,196048,1002994,234787,5482186
"Northfield","2011",7232817.16,4009342,0,554647,988587,279499,5832075
"Northfield","2012",7488299.43,4118271,0,592712,1015968,262733,5989684
"Northfield","2013",7780166.15,4113287,0,608663,1076807,339182,6137939
"Norton","2003",41357919.54,15718656,0,1183558,872890,344480,18119584
"Norton","2004",40901924.36,16750091,0,1281396,900976,376339,19308802
"Norton","2005",44195491.03,17955486,0,1206820,816957,384692,20363955
"Norton","2006",47821566.75,18649643,0,1378604,995883,332299,21356429
"Norton","2007",49520515.76,19552660,0,1424842,1019835,352375,22349712
"Norton","2008",51948526.23,20364599,0,1491427,1091948,407941,23355915
"Norton","2009",51952375.59,20773607,0,1747762,1349938,629292,24500599
"Norton","2010",52455952.55,21488471,0,1827416,1430516,816826,25563229
"Norton","2011",52537827.1,22192472,0,1905239,1641014,809049,26547774
"Norton","2012",53203055.12,22952572,0,2003138,1695219,800606,27451535
"Norton","2013",55201082.13,24382754,0,2093444,1736046,841514,29053758
"Norwell","2003",33090940.79,18102295,0,2697481,673507,426378,21899661
"Norwell","2004",34326089.25,19200282,0,2777199,698763,431368,23107612
"Norwell","2005",35900150.14,19758965,0,2246919,549221,259491,22814596
"Norwell","2006",38088326.02,21943720,0,2693731,612574,296884,25546909
"Norwell","2007",39931679.19,23136739,0,2718237,639739,256581,26751296
"Norwell","2008",42807258.87,23854303,0,2967319,670813,253885,27746320
"Norwell","2009",42452976.41,25027054,0,3204127,683405,417262,29331848
"Norwell","2010",43375376.45,25557668,0,3495568,740955,427872,30222063
"Norwell","2011",43855475.68,25978995,0,3765643,805133,490899,31040670
"Norwell","2012",46081358.44,27016589,0,3709764,755580,470398,31952331
"Norwell","2013",48795870.69,30181634,0,4162332,853636,556526,35754128
"Norwood","2003",100446153.45,21042073,0,10641765,4242799,901343,36827980
"Norwood","2004",103949024.1,22284372,0,10628163,4211519,1157779,38281833
"Norwood","2005",104671680.93,23624285,0,11094739,4231186,1112908,40063118
"Norwood","2006",112110406.26,23671843,0,12602774,4534933,1100010,41909560
"Norwood","2007",122977033.24,24663440,0,13571012,4416004,1336191,43986647
"Norwood","2008",137320053.48,25818391,0,14278365,4564042,1544015,46204813
"Norwood","2009",146326800.36,27029124,0,14747750,5016924,1852598,48646396
"Norwood","2010",157916768.37,28511850,0,15554366,5213300,2079665,51359181
"Norwood","2011",154938705.28,29826638,0,16688486,5530599,2626019,54671742
"Norwood","2012",154414440.24,31302673,0,17797395,5824439,2565214,57489721
"Norwood","2013",161281400.98,32658111,0,18571117,5932564,2752569,59914361
"Oak Bluffs","2003",16536930.24,11204663,9387,642605,27571,207234,12091460
"Oak Bluffs","2004",18783753.38,13043971,9044,688476,28189,210440,13980120
"Oak Bluffs","2005",20172432.36,13409831,9907,716608,28091,235030,14399467
"Oak Bluffs","2006",22757693.46,14165153,10060,748476,31060,222282,15177031
"Oak Bluffs","2007",23543142.72,14746770,10182,725564,31330,230239,15744085
"Oak Bluffs","2008",24225111.51,15112341,11420,908680,27720,262668,16322829
"Oak Bluffs","2009",26336567.17,16296038,12251,960911,29739,323642,17622581
"Oak Bluffs","2010",25835482.11,16735278,12584,977633,28427,350445,18104367
"Oak Bluffs","2011",26220611.86,17119578,13318,1074155,30798,374863,18612712
"Oak Bluffs","2012",27494627.69,17701590,13513,944977,29205,385297,19074582
"Oak Bluffs","2013",27030901.77,17968078,13117,971248,30469,389623,19372535
"Oakham","2003",2150758.95,1295469,0,56493,10247,43137,1405346
"Oakham","2004",2177324.03,1300835,0,43894,8898,41462,1395089
"Oakham","2005",2389586.99,1444073,0,45031,8272,34120,1531496
"Oakham","2006",2397804.12,1545477,0,47891,8626,34817,1636811
"Oakham","2007",2840509.24,1700051,0,51513,9463,31353,1792380
"Oakham","2008",2896982.54,1828691,0,58259,8277,30618,1925845
"Oakham","2009",2911689.61,1799617,0,53776,7255,41595,1902243
"Oakham","2010",2911453.27,1981854,0,61906,8293,46755,2098808
"Oakham","2011",3214961.8,2047683,0,66495,8581,57589,2180348
"Oakham","2012",3252690.07,2133569,0,59034,8911,70228,2271742
"Oakham","2013",3364696.46,2247075,0,64458,9728,92356,2413617
"Orange","2003",18360252.07,4681608,0,600841,330031,137051,5749531
"Orange","2004",18376077.91,4908210,0,614331,337490,128746,5988777
"Orange","2005",17182234,5124813,0,526205,276263,126394,6053675
"Orange","2006",17488636.76,5435898,0,516710,272565,90954,6316127
"Orange","2007",18852936.58,5635983,0,527132,273938,92481,6529534
"Orange","2008",18938376.46,6115853,0,524763,256088,118494,7015198
"Orange","2009",19855705.82,6266198,0,543044,254016,163714,7226972
"Orange","2010",18888277.31,6303911,0,590487,277213,188027,7359638
"Orange","2011",19614987.01,7223418,0,697789,320488,221830,8463525
"Orange","2012",19394091.8,7414429,0,741622,344526,227646,8728223
"Orange","2013",19855968.59,7652900,0,771667,293334,272868,8990769
"Orleans","2003",20149653.45,11745339,0,892579,51475,174347,12863740
"Orleans","2004",22638693.52,12696866,0,873242,52109,173987,13796204
"Orleans","2005",22901946.05,13541525,0,941660,44631,117817,14645633
"Orleans","2006",25374710.61,14821108,0,900986,36676,112501,15871271
"Orleans","2007",25697437.46,15239154,0,1021158,42047,125139,16427498
"Orleans","2008",28772832.41,16455475,0,1105313,43346,147928,17752062
"Orleans","2009",29222422.53,17537687,0,1182206,42419,207303,18969615
"Orleans","2010",28577702.11,17990355,0,1228830,42238,225462,19486885
"Orleans","2011",28163802,18500103,0,1298402,43294,248608,20090407
"Orleans","2012",29768953.99,19613503,0,1363232,45503,256012,21278250
"Orleans","2013",31533368.85,19949260,0,1397171,48852,265939,21661222
"Otis","2003",3255468.01,2271357,0,74767,20184,107772,2474080
"Otis","2004",3162599.52,2461382,0,71955,17899,104176,2655412
"Otis","2005",3357042.86,2656909,0,77473,18947,104483,2857812
"Otis","2006",3816211.97,2857942,0,75620,16384,83005,3032951
"Otis","2007",4405004.13,3043190,0,97255,18440,78084,3236969
"Otis","2008",4395194.09,3178958,0,99153,18929,81777,3378817
"Otis","2009",4900679.69,3606938,0,106380,20279,99055,3832652
"Otis","2010",4664172.41,3619463,0,100428,19626,96771,3836288
"Otis","2011",5236437.91,3844055,0,116464,20527,108891,4089937
"Otis","2012",5139955.61,3954578,0,118041,24458,116895,4213972
"Otis","2013",5933322.95,4053012,0,116759,23459,138927,4332157
"Oxford","2003",26736311.92,9111529,0,819424,679418,451814,11062185
"Oxford","2004",27476345.85,10531489,0,909841,732785,599351,12773466
"Oxford","2005",29098622.82,11281109,0,989449,781589,469380,13521527
"Oxford","2006",28917091.97,11977684,0,951965,794181,526694,14250524
"Oxford","2007",34951797.33,12194312,0,914587,772928,471431,14353258
"Oxford","2008",34276016.17,12416213,0,1040335,821949,528415,14806912
"Oxford","2009",34791763.15,13073723,0,1070170,926996,616512,15687401
"Oxford","2010",35696613.78,13589915,0,1155877,1114845,680847,16541484
"Oxford","2011",36200115.72,13817765,0,1469803,1134655,736834,17159057
"Oxford","2012",39450584.71,14246709,0,1578639,1237846,709210,17772404
"Oxford","2013",37755642.91,14596758,0,1652458,1332352,769666,18351234
"Palmer","2003",30016992.31,8700728,0,974405,676534,672429,11024096
"Palmer","2004",29853993.58,9240101,0,1017572,687548,617733,11562954
"Palmer","2005",31083746.62,9803066,0,971046,652923,541491,11968526
"Palmer","2006",32321282.43,10388642,0,979149,689914,514212,12571917
"Palmer","2007",34635669.97,10927360,0,985399,680484,542555,13135798
"Palmer","2008",33959570.13,11363373,0,1077056,685601,540492,13666522
"Palmer","2009",34864347.05,11790168,0,1110700,699663,618560,14219091
"Palmer","2010",34739649.71,12189913,0,1073649,726925,640914,14631401
"Palmer","2011",33442525.94,12535255,0,1122287,734765,701733,15094040
"Palmer","2012",32047765.45,12338633,0,1109034,723761,695278,14866706
"Palmer","2013",32886919.15,12741286,0,1136205,743242,744196,15364929
"Paxton","2003",7845600.87,5065414,72912,157510,45058,65439,5406333
"Paxton","2004",8376313.72,5491098,60024,144054,44044,61860,5801080
"Paxton","2005",9131845.86,5893764,79976,174359,48660,55417,6252176
"Paxton","2006",9728771.83,6089380,85465,179129,45474,56179,6455627
"Paxton","2007",9934227.05,6349869,0,168095,46393,44944,6609301
"Paxton","2008",10355741.3,6658357,0,175933,48461,60163,6942914
"Paxton","2009",10589696.49,6845155,0,187044,47191,76551,7155941
"Paxton","2010",11422228.92,7863265,0,179058,72000,76065,8190388
"Paxton","2011",11240508.33,7741188,0,183518,73449,144693,8142848
"Paxton","2012",11653864.22,7933618,0,193491,76893,180432,8384434
"Paxton","2013",11785584.2,8197518,0,205673,83665,165129,8651985
"Peabody","2003",121186964.92,35893317,0,16976349,5200828,1222217,59292711
"Peabody","2004",121723646.41,39439159,0,16198173,5558204,1028977,62224513
"Peabody","2005",124551413.91,41004772,0,17306191,5986187,1365260,65662410
"Peabody","2006",131557057.02,43370848,0,17552747,5789132,1365350,68078077
"Peabody","2007",142186700.87,46550066,0,17721450,5900467,1437459,71609442
"Peabody","2008",143564569.21,48407127,0,19490044,6404168,1751617,76052956
"Peabody","2009",146540026.4,49778122,0,20514207,6880863,2035902,79209094
"Peabody","2010",146957020.36,50866065,0,22549665,6926838,2348903,82691471
"Peabody","2011",148699190.76,53748658,0,23619724,6785833,2751974,86906189
"Peabody","2012",150520556.81,54701729,0,24936093,5744823,2899220,88281865
"Peabody","2013",151781283.52,56653072,0,25720454,5595009,2647922,90616457
"Pelham","2003",2975674.89,1994501,0,17292,14843,77637,2104273
"Pelham","2004",3198405.25,2185860,0,18603,16349,80579,2301391
"Pelham","2005",2902369.88,2067300,0,12658,14494,59032,2153484
"Pelham","2006",3819272.71,2765489,0,16138,19019,65425,2866071
"Pelham","2007",3782257.77,2741893,0,16932,18435,56989,2834249
"Pelham","2008",4061638.51,2797465,0,24459,14089,54990,2891003
"Pelham","2009",4550739.83,3066198,0,24419,15161,67208,3172986
"Pelham","2010",4852610.6,3135982,0,24701,15396,86418,3262497
"Pelham","2011",4943234.06,3106264,0,24622,15279,94589,3240754
"Pelham","2012",5204209.81,3159857,0,23789,15934,136325,3335905
"Pelham","2013",5562725.39,3221262,0,24952,16250,132138,3394602
"Pembroke","2003",40957845.82,18200637,0,1683538,658393,262745,20805313
"Pembroke","2004",42133085.66,19987418,0,1678792,664645,281725,22612580
"Pembroke","2005",42386516.19,20625773,0,1738555,611659,233916,23209903
"Pembroke","2006",45698537.41,22328289,0,1892762,623583,238782,25083416
"Pembroke","2007",49876327.41,24502797,0,1962820,618606,244765,27328988
"Pembroke","2008",51350415.6,25294424,0,2193146,686811,275345,28449726
"Pembroke","2009",53993248.46,25902646,0,2365519,760352,356568,29385085
"Pembroke","2010",54533751.69,26359496,0,2590352,827684,436894,30214426
"Pembroke","2011",54908438.4,26962235,0,2723211,894371,529331,31109148
"Pembroke","2012",56827292.08,27857219,0,2785156,926038,461991,32030404
"Pembroke","2013",57680412.04,28252660,0,2896612,972579,473300,32595151
"Pepperell","2003",17425568.31,10015395,0,281609,178868,297825,10773697
"Pepperell","2004",18360567.78,10319561,0,304847,190428,322042,11136878
"Pepperell","2005",19775605.42,11023308,0,293270,175037,156537,11648152
"Pepperell","2006",21147362.92,11643051,0,307913,191887,171339,12314190
"Pepperell","2007",20994120.43,12216475,0,301068,189124,156924,12863591
"Pepperell","2008",22492375.62,12554954,0,307424,250535,137179,13250092
"Pepperell","2009",22842894.18,12921585,0,322317,270156,172982,13687040
"Pepperell","2010",22909010.37,13864278,0,373714,336626,233765,14808383
"Pepperell","2011",22841606.45,14307348,0,363582,321929,243304,15236163
"Pepperell","2012",24300043.07,14753215,0,367193,335328,242187,15697923
"Pepperell","2013",24800343.77,15441429,0,396368,351771,263690,16453258
"Peru","2003",1205530.54,752673,0,42160,5706,24998,825537
"Peru","2004",1282600.29,836900,0,49553,6156,28982,921591
"Peru","2005",1411545.22,857036,0,52669,5656,25073,940434
"Peru","2006",1468994.74,1037384,0,73020,6246,26442,1143092
"Peru","2007",1700871.75,1062560,0,73170,6296,28108,1170134
"Peru","2008",1731966.47,1132174,0,69503,5589,25446,1232712
"Peru","2009",1860258.2,1143230,0,77177,5702,31825,1257934
"Peru","2010",1972463.46,1207090,0,61732,6032,38458,1313312
"Peru","2011",1925151.86,1295428,0,51350,5800,38665,1391243
"Peru","2012",1948004.28,1270416,0,53292,5886,42356,1371950
"Peru","2013",2099149.05,1330176,0,58550,7082,45506,1441314
"Petersham","2003",2772362.51,1476023,0,78807,7632,54076,1616538
"Petersham","2004",3109010.42,1570778,0,69251,2911,44875,1687815
"Petersham","2005",2879881.76,1674988,0,72796,3051,44686,1795521
"Petersham","2006",3038294.77,1359449,0,57676,2450,35222,1454797
"Petersham","2007",3169078.29,1581667,0,66236,2046,32231,1682180
"Petersham","2008",3370785.78,1712214,0,76975,2164,37887,1829240
"Petersham","2009",3591796.62,1810609,0,66484,2215,57412,1936720
"Petersham","2010",3560344.58,1926094,0,56889,2131,63446,2048560
"Petersham","2011",4080667.03,1979611,0,59261,2270,85184,2126326
"Petersham","2012",3855165.84,2033831,0,63143,2337,139164,2238475
"Petersham","2013",4296104.52,2107017,0,68240,2243,178507,2356007
"Phillipston","2003",2237935.63,1376188,6883,58451,4132,32352,1478006
"Phillipston","2004",2363631.37,1515432,6722,60210,3347,25581,1611292
"Phillipston","2005",2273341.34,1586162,4882,58086,3035,29342,1681507
"Phillipston","2006",2355978.46,1586006,4893,53433,2912,24494,1671738
"Phillipston","2007",2582256.48,1717025,5,65428,4287,26468,1813213
"Phillipston","2008",3387565.95,2269775,7,82433,5760,39646,2397621
"Phillipston","2009",3398690.49,2288817,7,82697,5770,57878,2435169
"Phillipston","2010",3500095.94,2426568,0,87994,6218,60221,2581001
"Phillipston","2011",3454959.39,2542993,0,95314,6810,69013,2714130
"Phillipston","2012",3527088.83,2562485,0,99961,7276,71615,2741337
"Phillipston","2013",3838547.78,2692786,0,102523,5440,69846,2870595
"Pittsfield","2003",104757531.22,29906860,257795,8375676,3269537,5332827,47142695
"Pittsfield","2004",104667169.22,30423932,267836,8540540,3186727,5642303,48061338
"Pittsfield","2005",110146433.86,31800721,341061,9968509,3470933,4441141,50022365
"Pittsfield","2006",114193254.7,33257168,339031,10893715,3638927,4027695,52156536
"Pittsfield","2007",120851952.32,34205566,330163,10971410,3968257,3992556,53467952
"Pittsfield","2008",128018375.25,35775276,317662,11711568,4001096,3835153,55640755
"Pittsfield","2009",131197996.24,37354522,331149,12021964,3650641,4478046,57836322
"Pittsfield","2010",128032502.22,38757819,331640,12451035,3792189,4926308,60258991
"Pittsfield","2011",132351062.13,41053799,190084,13155652,3917253,5405671,63722459
"Pittsfield","2012",136285259.98,42502212,8791,13592361,4399012,5848981,66351357
"Pittsfield","2013",143183567.52,43810945,6221,14178869,5043481,5527845,68567361
"Plainfield","2003",1197280.76,654839,0,70760,10021,27479,763099
"Plainfield","2004",1162984.76,698688,0,80964,10853,30364,820869
"Plainfield","2005",1315528.25,795651,0,74908,16380,25903,912842
"Plainfield","2006",1548643.52,790939,0,104576,13939,22014,931468
"Plainfield","2007",1348971.57,856547,0,86123,16437,20368,979475
"Plainfield","2008",1446961.71,969278,0,106103,12957,24139,1112477
"Plainfield","2009",1530283.43,1031856,0,109960,15020,34887,1191723
"Plainfield","2010",1570888.84,1055941,0,120052,15052,37075,1228120
"Plainfield","2011",1633466.85,1111590,0,119732,12471,48995,1292788
"Plainfield","2012",1610028.07,1099558,0,131281,15896,79610,1326345
"Plainfield","2013",1732615.09,1133469,0,139485,16877,79073,1368904
"Plainville","2003",17761918.72,7359571,0,1003860,509400,184392,9057223
"Plainville","2004",19106619.12,7841432,0,1054321,540502,192017,9628272
"Plainville","2005",20866656.95,8665444,0,979412,471902,189132,10305890
"Plainville","2006",23467988.59,9589523,0,1347080,541248,234495,11712346
"Plainville","2007",24391840.48,10245772,0,1547528,533121,239651,12566072
"Plainville","2008",24304935.75,10364099,0,1630447,534823,262734,12792103
"Plainville","2009",25462057.2,11179172,0,2185103,670063,312479,14346817
"Plainville","2010",25011508.18,11499477,0,2270111,706825,333744,14810157
"Plainville","2011",25025998.32,11671748,0,2468591,756110,367759,15264208
"Plainville","2012",26831515.9,12080346,0,2558210,770741,419981,15829278
"Plainville","2013",27490524.69,11950385,0,2935534,841203,1041957,16769079
"Plymouth","2003",139814531.61,56129220,9009,5578403,4606431,12380047,78703110
"Plymouth","2004",143041853.01,64289603,119,5222862,4452461,12622161,86587206
"Plymouth","2005",142372295.68,65620843,0,5014408,4098605,12792358,87526214
"Plymouth","2006",156930103.32,71275046,0,6273739,4041691,11879031,93469507
"Plymouth","2007",170687652.9,74427548,0,7102099,4169295,10943659,96642601
"Plymouth","2008",174374819.56,78826176,0,8258893,11172717,2635401,100893187
"Plymouth","2009",183707602.35,83270233,0,9102753,11157440,2952561,106482987
"Plymouth","2010",184998847.1,86006118,0,10170885,12197483,3251805,111626291
"Plymouth","2011",177489904.46,88738082,0,10318236,12334893,3746097,115137308
"Plymouth","2012",185753001.73,94995600,0,11207291,12148412,3801370,122152673
"Plymouth","2013",197398451,96797107,0,11647091,12657576,3172624,124274398
"Plympton","2003",6012833.46,3726327,0,129660,119447,111382,4086816
"Plympton","2004",6259256.4,3992285,0,127227,123444,121657,4364613
"Plympton","2005",6554180.14,4272897,0,117327,108769,107661,4606654
"Plympton","2006",6410675.41,4241278,0,90196,98552,106063,4536089
"Plympton","2007",6498061.4,4578880,0,116941,101295,114471,4911587
"Plympton","2008",7582491.37,4891286,0,147290,181434,119251,5339261
"Plympton","2009",7294534.89,4970207,0,148273,185016,145997,5449493
"Plympton","2010",7428687.55,5078479,0,185402,196972,231482,5692335
"Plympton","2011",7589519.31,5174634,0,197572,214388,271535,5858129
"Plympton","2012",8164177.72,5289252,0,202496,207108,278091,5976947
"Plympton","2013",8915004.01,5364695,0,232464,722345,280693,6600197
"Princeton","2003",7239212.95,4813752,804,96294,19929,54190,4984969
"Princeton","2004",7529764.12,5013977,524,92996,20860,50070,5178427
"Princeton","2005",7843079.36,5382297,536,97929,23225,51610,5555597
"Princeton","2006",7977132.13,5729948,0,75721,22192,51499,5879360
"Princeton","2007",8312204.07,5941231,0,77313,22603,56225,6097372
"Princeton","2008",8742598.95,6389653,0,83686,22902,61453,6557694
"Princeton","2009",9267467.95,6762520,0,89140,25460,108659,6985779
"Princeton","2010",9197550.68,7025487,0,91139,27561,129119,7273306
"Princeton","2011",9003339.84,6676944,0,87078,26456,146622,6937100
"Princeton","2012",9258418.39,7040636,0,90982,27185,181606,7340409
"Princeton","2013",9864792.59,7327667,0,95047,28250,211263,7662227
"Provincetown","2003",23431452.02,7352744,0,2065828,7779,164949,9591300
"Provincetown","2004",25321147.6,8263936,0,2241466,8555,174209,10688166
"Provincetown","2005",25814108.51,9097697,0,2283213,9115,170747,11560772
"Provincetown","2006",27762846.06,9954890,0,2325196,9349,98458,12387893
"Provincetown","2007",24697338.87,10480388,0,2290790,9622,102735,12883535
"Provincetown","2008",25621488.88,10886558,0,2347879,9933,111738,13356108
"Provincetown","2009",27243930.68,11550362,0,2448795,10525,125732,14135414
"Provincetown","2010",27888232.23,12136819,0,2549233,10929,139762,14836743
"Provincetown","2011",29036169.12,12622686,0,2615017,10949,156118,15404770
"Provincetown","2012",30136689.96,13417186,0,2735478,11466,161374,16325504
"Provincetown","2013",32263673.95,13861069,0,2798113,11824,182818,16853824
"Quincy","2003",222710031.96,80424912,0,34984498,3731968,5466104,124607482
"Quincy","2004",214038533.14,90491418,0,32114874,2314965,6412311,131333568
"Quincy","2005",227260037.09,95372795,0,31889809,2381249,4882911,134526764
"Quincy","2006",234077627.04,98853701,0,32836654,2573880,5087818,139352053
"Quincy","2007",259067399.45,105935733,0,32422424,2332314,5669153,146359624
"Quincy","2008",268476726.34,106311231,0,35221997,2241505,5296872,149071605
"Quincy","2009",288945040.04,119893593,0,40043115,2565219,6654149,169156076
"Quincy","2010",275993422.88,118581053,0,40860930,2769499,7985022,170196504
"Quincy","2011",276625237.04,117848330,0,41138236,2553942,7406061,168946569
"Quincy","2012",294437893.25,120172750,0,43281123,2478204,7806132,173738209
"Quincy","2013",303333213.88,125430566,0,49832901,2562844,7953912,185780223
"Randolph","2003",64370522.76,23726763,0,4694104,2031449,1042726,31495042
"Randolph","2004",63977680.63,26025452,0,3892114,1742420,1016382,32676368
"Randolph","2005",67175955.94,26925461,0,4221105,1827875,961811,33936252
"Randolph","2006",68988092.2,27960541,0,4331371,1737003,1038038,35066953
"Randolph","2007",72466109.56,28926101,0,4527180,1689792,963829,36106902
"Randolph","2008",76768844.79,29931704,0,4806725,1725905,1038299,37502633
"Randolph","2009",86089424.3,34884055,0,6207861,2256010,1524993,44872919
"Randolph","2010",84476362.67,36250892,0,6348539,2411855,1576352,46587638
"Randolph","2011",87544622.12,37239262,0,6542516,2509205,1838116,48129099
"Randolph","2012",88304632.31,38270065,0,6763512,2607965,1969297,49610839
"Randolph","2013",93673867.69,39285567,0,6901441,2863741,2278576,51329325
"Raynham","2003",23599184.06,10581536,0,3418682,965302,300691,15266211
"Raynham","2004",24686441.01,10535187,0,3201473,1082815,483420,15302895
"Raynham","2005",26870310.07,12367929,0,3416833,1138456,465509,17388727
"Raynham","2006",30210931.55,13240369,0,3837270,1251246,525466,18854351
"Raynham","2007",31325876.51,15044471,0,4303901,1458530,506375,21313277
"Raynham","2008",32898072.61,16141045,0,4824080,1613761,609809,23188695
"Raynham","2009",33577016.36,16466367,0,5244970,1828755,724486,24264578
"Raynham","2010",34229825.08,16569969,0,5677733,2082350,772037,25102089
"Raynham","2011",35529840.35,17702872,0,5999392,2212827,872026,26787117
"Raynham","2012",37088953.29,18240665,0,6366100,2303394,712292,27622451
"Raynham","2013",37391873.45,18148445,0,6887435,2480854,706532,28223266
"Reading","2003",59534425.34,30367828,0,1799604,268298,171960,32607690
"Reading","2004",63939404.89,35756697,0,1902499,283324,214714,38157234
"Reading","2005",70805056.12,39459259,0,2342293,292856,168872,42263280
"Reading","2006",73844994.61,40774729,0,2645583,271082,191870,43883264
"Reading","2007",81947780.4,42363975,0,2854758,254355,213786,45686874
"Reading","2008",84383285.36,43708273,0,3232938,219002,280182,47440395
"Reading","2009",85765713.24,44933399,0,3473166,279542,453084,49139191
"Reading","2010",85668383.02,45486588,0,3723720,289444,629458,50129210
"Reading","2011",87556059.1,46548589,0,4409188,133283,625073,51716133
"Reading","2012",88769085.53,47964617,0,4534807,136529,624839,53260792
"Reading","2013",91205743.66,49504230,0,4740834,144220,689079,55078363
"Rehoboth","2003",14980424.15,10095322,0,475950,121777,385736,11078785
"Rehoboth","2004",15814176.96,11224853,0,564652,108388,324635,12222528
"Rehoboth","2005",17103895.36,11828179,0,547437,117050,357182,12849848
"Rehoboth","2006",18516197.69,12548551,0,521814,110378,360289,13541032
"Rehoboth","2007",19379198.56,13361334,0,608551,132782,346820,14449487
"Rehoboth","2008",20033333.58,14194799,0,644993,140613,363889,15344294
"Rehoboth","2009",20593857.73,14704641,0,726385,146754,457839,16035619
"Rehoboth","2010",20481399.33,15295455,0,689917,157697,500119,16643188
"Rehoboth","2011",20936283.11,15756860,0,759285,171222,549392,17236759
"Rehoboth","2012",21737488.98,16247870,0,805914,174237,565270,17793291
"Rehoboth","2013",22795359.44,16782199,0,797197,174601,594411,18348408
"Revere","2003",99008817.48,31340802,0,8393520,1134840,1146407,42015569
"Revere","2004",102620472.35,32967404,0,9175898,1204701,1267958,44615961
"Revere","2005",107613781.91,37538114,0,8297068,1722718,932526,48490426
"Revere","2006",113343444.06,40831805,0,7947503,1628467,893551,51301326
"Revere","2007",122887852.79,43109059,0,8319324,1639592,916762,53984737
"Revere","2008",134526869.42,45753941,0,8765664,1733300,943256,57196161
"Revere","2009",137413696.8,46639498,0,9935676,1918134,1214007,59707315
"Revere","2010",138182377.24,46090402,0,11860658,2280020,1662084,61893164
"Revere","2011",146269148.16,46514040,0,12897305,2496208,1932331,63839884
"Revere","2012",147037350.61,48324456,0,12807345,2617717,2078700,65828218
"Revere","2013",158052273,49597314,0,13357367,2779680,2240893,67975254
"Richmond","2003",4425709.13,2609400,0,50411,4026,125865,2789702
"Richmond","2004",4347181.46,2703800,0,57993,4055,141054,2906902
"Richmond","2005",4621181.02,2832820,0,45368,4403,119000,3001591
"Richmond","2006",4849628.17,2996627,0,53735,4797,111584,3166743
"Richmond","2007",5285606.81,3222790,0,56894,5039,102184,3386907
"Richmond","2008",5352236.4,3404901,0,48254,7092,112280,3572527
"Richmond","2009",5552104.25,3635433,0,49583,7585,122333,3814934
"Richmond","2010",5706153.87,3735107,0,47926,7724,119729,3910486
"Richmond","2011",5928747.65,3797642,0,49514,7828,124364,3979348
"Richmond","2012",5773473.24,3820095,0,52197,7467,136186,4015945
"Richmond","2013",5970881.96,3937804,0,44538,7660,178106,4168108
"Rochester","2003",12891759.7,4832011,0,492232,223529,188683,5736455
"Rochester","2004",12937417.61,5323531,0,420058,235557,212248,6191394
"Rochester","2005",14387307.67,5938513,0,355709,327788,167907,6789917
"Rochester","2006",14968785.72,6587274,0,371919,344911,186913,7491017
"Rochester","2007",15885387.37,6955782,0,372196,349966,183570,7861514
"Rochester","2008",16322122.74,7122228,0,396950,368581,207688,8095447
"Rochester","2009",16393013.98,7182972,0,389725,344281,287427,8204405
"Rochester","2010",16410735.21,7709967,0,427761,386481,363940,8888149
"Rochester","2011",17548179.16,8539534,0,452635,479187,452352,9923708
"Rochester","2012",18135736.36,8872260,0,463460,486650,425358,10247728
"Rochester","2013",18311318.53,9137764,0,472367,463343,446227,10519701
"Rockland","2003",39939153.01,14405744,0,2100837,1202048,398954,18107583
"Rockland","2004",40134109.89,14730189,0,2141483,1277398,420838,18569908
"Rockland","2005",41287577.83,15455046,0,1853201,1089171,342615,18740033
"Rockland","2006",44902828.82,15970654,0,1899398,1209819,308074,19387945
"Rockland","2007",45976363.48,16361947,0,1949282,1161713,302754,19775696
"Rockland","2008",44171778.87,16585299,0,2085924,1271587,352788,20295598
"Rockland","2009",46790016.61,16356511,0,2262638,1455189,490352,20564690
"Rockland","2010",48462375.22,19294762,0,2702892,1806765,623084,24427503
"Rockland","2011",48688014.91,20211742,0,2934641,1652711,671552,25470646
"Rockland","2012",50684439.96,21459032,0,3242492,1698532,671788,27071844
"Rockland","2013",52988946.24,22970329,0,3487542,1855708,747449,29061028
"Rockport","2003",22611734.83,12077771,0,771732,44561,124360,13018424
"Rockport","2004",23025896.09,13042006,0,759249,41445,99631,13942331
"Rockport","2005",25606699.11,14024711,0,799491,43004,89767,14956973
"Rockport","2006",26860489.91,14366212,0,828528,43421,90329,15328490
"Rockport","2007",27088146.72,14688190,0,918224,48956,91337,15746707
"Rockport","2008",28773398.7,15114123,0,1002727,47345,117185,16281380
"Rockport","2009",29515964.86,15117754,0,973062,46905,137887,16275608
"Rockport","2010",29363833.97,15487592,0,1013440,49617,129462,16680111
"Rockport","2011",30082081.57,16784283,0,1090122,54182,146940,18075527
"Rockport","2012",29478495.71,16776009,0,1040573,53303,142890,18012775
"Rockport","2013",30117142.09,17623471,0,1039224,55562,158049,18876306
"Rowe","2003",3160493.71,105654,0,744,1719368,439875,2265641
"Rowe","2004",3146864.17,109966,0,837,1765759,452758,2329320
"Rowe","2005",3174612.11,121885,0,940,1804609,461380,2388814
"Rowe","2006",2992334.03,174261,0,2553,1353271,920706,2450791
"Rowe","2007",3220427.05,195320,0,2799,1383692,940886,2522697
"Rowe","2008",4442191.63,217611,0,3088,1510618,1018893,2750210
"Rowe","2009",3524026.26,223782,0,4158,1472321,1124724,2824985
"Rowe","2010",4048728.09,257549,0,3846,1492049,1147808,2901252
"Rowe","2011",3833174.14,272342,0,3834,1527731,1186597,2990504
"Rowe","2012",4247215.27,276090,0,3598,2086273,719120,3085081
"Rowe","2013",4456925.26,331406,0,4424,2300788,846440,3483058
"Rowley","2003",11759028,6328638,4089,610835,338567,102675,7384804
"Rowley","2004",12249050.53,6744621,3523,606612,338415,111398,7804569
"Rowley","2005",12598049,7080440,6064,658077,348171,107730,8200482
"Rowley","2006",13675169.44,7683813,5931,638354,358665,113457,8800220
"Rowley","2007",14515394.56,8001075,5880,644633,353535,111658,9116781
"Rowley","2008",15084819,8605703,2711,811409,441375,125080,9986278
"Rowley","2009",14748191.88,8964016,1624,850197,467264,217017,10500118
"Rowley","2010",14972710.63,9347838,1730,886381,518738,221738,10976425
"Rowley","2011",15516366,9646412,1701,908183,564508,257393,11378197
"Rowley","2012",15703641,9906500,1782,1082511,459253,248214,11698260
"Rowley","2013",17054028.39,10191941,1726,1119330,482453,255256,12050706
"Royalston","2003",1580436.5,941704,0,11425,6299,42708,1002136
"Royalston","2004",1533201.11,981520,0,12553,5678,43724,1043475
"Royalston","2005",2066223.66,1042813,0,10443,4720,27433,1085409
"Royalston","2006",2033027.02,1011778,0,9834,4482,28968,1055062
"Royalston","2007",1984125.04,1176191,0,11440,4508,31797,1223936
"Royalston","2008",2069913.95,1208682,0,11842,4665,31134,1256323
"Royalston","2009",2219278.05,1211056,0,13451,1411,44240,1270158
"Royalston","2010",2008790.12,1238281,0,13142,1441,46499,1299363
"Royalston","2011",2001939.14,1275175,0,12077,1440,47939,1336631
"Royalston","2012",2125735.37,1300721,0,11606,1468,52520,1366315
"Royalston","2013",2107795.86,1283455,0,11143,685,55063,1350346
"Russell","2003",3097668,1251919,14542,64993,129806,92977,1554237
"Russell","2004",3034070.93,1329651,0,58279,112847,111653,1612430
"Russell","2005",3333843.27,1371048,0,60583,107599,100912,1640142
"Russell","2006",4153491.69,1540887,0,50187,104853,104692,1800619
"Russell","2007",4205437.16,1707175,0,44683,68822,76545,1897225
"Russell","2008",4671234.04,1979102,0,51349,79193,97344,2206988
"Russell","2009",5702772.8,2113036,0,59822,123482,114367,2410707
"Russell","2010",4910121.72,2170928,0,61692,121069,115783,2469472
"Russell","2011",4900705.02,2214133,0,65625,126179,122209,2528146
"Russell","2012",4955906.21,2237974,0,61533,99906,116897,2516310
"Russell","2013",5109064.74,2270531,0,72519,141295,152959,2637304
"Rutland","2003",11706662.13,5308207,0,142661,37683,102373,5590924
"Rutland","2004",11665806.93,5792781,0,131434,35641,102568,6062424
"Rutland","2005",13370910.02,6862234,0,158502,38664,99464,7158864
"Rutland","2006",13440073.12,7017778,0,154671,33644,102443,7308536
"Rutland","2007",16031695.08,8217704,0,168150,39090,102628,8527572
"Rutland","2008",15660650.09,8902583,0,194460,36147,112653,9245843
"Rutland","2009",15746510.92,9320367,0,203000,38439,151478,9713284
"Rutland","2010",15916330.21,9752213,0,211099,39835,178423,10181570
"Rutland","2011",16588133.58,10142771,0,231521,32915,247344,10654551
"Rutland","2012",17705320.89,10660121,0,246502,35150,299771,11241544
"Rutland","2013",18498231.6,11239647,0,263528,38848,316963,11858986
"Salem","2003",102374665.39,33142855,0,8887063,3531878,6635048,52196844
"Salem","2004",102885928.95,38033259,0,8354881,3165363,4820719,54374222
"Salem","2005",105024556.35,40242911,0,8376051,3107959,5112407,56839328
"Salem","2006",113268028.23,42680920,0,8392261,3058466,5160590,59292237
"Salem","2007",113594665.32,44555724,0,8923960,3077231,5228599,61785514
"Salem","2008",120756252.68,46780076,0,9930234,2982029,4707326,64399665
"Salem","2009",125133648.97,48500251,0,10956077,3271628,4367958,67095914
"Salem","2010",124161501.88,49414819,0,11653891,3421772,5591843,70082325
"Salem","2011",128166683.85,50588803,0,12145788,3586800,6210845,72532236
"Salem","2012",133463815.68,51442526,0,12243097,3518893,4583851,71788367
"Salem","2013",136792744.1,52867347,0,13226941,3650295,5134633,74879216
"Salisbury","2003",16087855.46,7863467,0,1626226,226067,189238,9904998
"Salisbury","2004",16484690.63,8447281,0,1572487,221615,199566,10440949
"Salisbury","2005",17198978.86,8988430,0,1639480,209188,197724,11034822
"Salisbury","2006",19656185.64,9776885,0,1653460,200612,163114,11794071
"Salisbury","2007",19959946.9,10451547,0,1806510,199484,164712,12622253
"Salisbury","2008",21521467.09,10953497,0,2003256,258605,185480,13400838
"Salisbury","2009",22307172.84,11519359,0,2098350,283228,239823,14140760
"Salisbury","2010",22722318.87,12011350,0,2232612,302839,260558,14807359
"Salisbury","2011",23179923.27,12462216,0,2427713,332392,296443,15518764
"Salisbury","2012",23762121.67,12827272,0,2431784,325692,358234,15942982
"Salisbury","2013",24474911.07,13269205,0,2464079,323063,353091,16409438
"Sandisfield","2003",1824862.81,1250215,0,48428,3105,89022,1390770
"Sandisfield","2004",1757375.34,1335719,0,45827,3389,86978,1471913
"Sandisfield","2005",1895100.35,1424264,0,49082,3595,89512,1566453
"Sandisfield","2006",2260021.79,1592307,0,54164,4108,92545,1743124
"Sandisfield","2007",2222132.26,1645414,0,52994,3965,85588,1787961
"Sandisfield","2008",2283178.59,1743048,0,55635,4133,91689,1894505
"Sandisfield","2009",2769434.91,1970983,0,58452,4565,110032,2144032
"Sandisfield","2010",2492116.34,1926190,0,50512,5365,106658,2088725
"Sandisfield","2011",2651574.25,2110595,0,53428,5850,119714,2289587
"Sandisfield","2012",3105778.01,2184368,0,58170,6279,128525,2377342
"Sandisfield","2013",3087480.64,2349531,0,66590,2762,191859,2610742
"Sandwich","2003",53039686.6,27961134,0,1909277,649921,2743830,33264162
"Sandwich","2004",53517671.66,29496382,0,1872629,607362,2410070,34386443
"Sandwich","2005",56244021.79,32414050,0,1791678,592195,2192375,36990298
"Sandwich","2006",62194312.14,35380161,0,1897210,674366,2593151,40544888
"Sandwich","2007",65068976.78,36737554,0,1991106,710837,2604248,42043745
"Sandwich","2008",67518250.21,37932491,0,2113289,772715,2757004,43575499
"Sandwich","2009",69113281.09,38699061,0,2198899,780376,2970147,44648483
"Sandwich","2010",68397779.73,39193221,0,2245847,774615,3093010,45306693
"Sandwich","2011",68170690.82,40327380,0,2326136,732444,3254997,46640957
"Sandwich","2012",69914187.62,41564324,0,2425368,718573,3302460,48010725
"Sandwich","2013",72036589.46,43501114,0,2490328,729232,3363742,50084416
"Saugus","2003",60406603.3,21787448,0,9540493,2431553,1020532,34780026
"Saugus","2004",59447891.95,22704731,0,9890667,2520359,1127856,36243613
"Saugus","2005",61985529.24,25041992,0,10865906,2596622,1079941,39584461
"Saugus","2006",65757241.07,26787052,0,10302214,2474076,1006579,40569921
"Saugus","2007",70141187.74,28920761,0,10091757,2539903,1138778,42691199
"Saugus","2008",69436033.12,30111675,0,10838011,2315868,1182384,44447938
"Saugus","2009",71571598.31,30129340,0,11919005,2854852,1484174,46387371
"Saugus","2010",71868317.57,30192238,0,13076147,3108196,1723188,48099769
"Saugus","2011",76202022.43,31042339,0,13557137,3096211,1933066,49628753
"Saugus","2012",79049826.63,32314591,0,13488977,3307970,2083893,51195431
"Saugus","2013",78812219.29,32989841,0,14283216,3746242,2099430,53118729
"Savoy","2003",1454110.12,603178,0,10703,1526,21146,636553
"Savoy","2004",1593716.12,628145,0,9448,2449,20740,660782
"Savoy","2005",1518102.41,651719,0,10292,2440,18112,682563
"Savoy","2006",1735979.3,689821,0,10463,2693,19837,722814
"Savoy","2007",1954552.58,708049,0,10135,2477,18411,739072
"Savoy","2008",1878409.36,765228,0,10588,2426,20659,798901
"Savoy","2009",2026778.06,944101,0,13310,3050,34018,994479
"Savoy","2010",2006394.04,979963,0,14511,3224,39672,1037370
"Savoy","2011",2069940.72,1002848,0,14579,3293,40150,1060870
"Savoy","2012",2070304.14,967068,0,17198,7058,48360,1039684
"Savoy","2013",1998643.28,955812,0,16911,7223,52611,1032557
"Scituate","2003",47540466.54,27578590,0,846432,53188,260966,28739176
"Scituate","2004",50709992.97,29720151,0,877249,54133,281189,30932722
"Scituate","2005",51595311.88,30585489,0,880035,51663,243466,31760653
"Scituate","2006",54207788.4,31643787,0,1089293,48155,247674,33028909
"Scituate","2007",57603200.9,33649546,0,1088276,50266,253441,35041529
"Scituate","2008",62589498.19,37545727,0,1211935,54191,311418,39123271
"Scituate","2009",65605573.19,39005448,0,1344050,59559,391227,40800284
"Scituate","2010",66048402.5,40180590,0,1373221,58982,441115,42053908
"Scituate","2011",67671834.49,41351582,0,1436200,62836,481029,43331647
"Scituate","2012",72181466.89,44556048,0,1567273,63935,485071,46672327
"Scituate","2013",72615728.99,45902669,0,1603674,65904,509909,48082156
"Seekonk","2003",32992192.16,13332887,0,5940677,588786,645742,20508092
"Seekonk","2004",33144926.11,14264668,0,6452221,628531,866245,22211665
"Seekonk","2005",33849612.12,14784806,0,7481781,723664,1195971,24186222
"Seekonk","2006",35826998.07,15147576,0,7422933,704080,1025350,24299939
"Seekonk","2007",40426885.47,16058090,0,8004032,729593,1080523,25872238
"Seekonk","2008",41369011.52,16334367,0,8623471,809852,1180014,26947704
"Seekonk","2009",42505606.11,16866815,0,9199349,855141,1507733,28429038
"Seekonk","2010",42957458.53,17367621,0,9449100,878516,1633736,29328973
"Seekonk","2011",44749306.97,18067498,0,9545296,890995,1896471,30400260
"Seekonk","2012",45915598.8,18800677,0,9843913,915773,1812959,31373322
"Seekonk","2013",47070754.56,19471325,0,10170063,937164,1804550,32383102
"Sharon","2003",52734334.04,34489026,0,1014401,470278,593781,36567486
"Sharon","2004",55611762.63,36767867,0,1215381,674170,577287,39234705
"Sharon","2005",58254212.7,37543658,0,1157430,706841,589359,39997288
"Sharon","2006",60270520.85,38756172,0,1166468,707326,604391,41234357
"Sharon","2007",62025086.35,39934091,0,1226485,703106,600136,42463818
"Sharon","2008",68084589.76,43607999,0,1513736,967920,728770,46818425
"Sharon","2009",71445795.19,45263610,0,1976174,933578,918102,49091464
"Sharon","2010",71900523,44743077,0,1862417,860033,971246,48436773
"Sharon","2011",70125999.73,46758283,0,1939301,835240,1102327,50635151
"Sharon","2012",71927849.42,48178861,0,2280606,817827,1172906,52450200
"Sharon","2013",74623234.58,49849200,0,2265165,790814,1236736,54141915
"Sheffield","2003",6291408.48,4289180,0,509273,101226,119530,5019209
"Sheffield","2004",6602899.41,4638608,0,455205,104386,131175,5329374
"Sheffield","2005",6908448.86,5026230,0,505981,137770,145431,5815412
"Sheffield","2006",7283223.15,5264421,0,509209,134626,119828,6028084
"Sheffield","2007",7883580.47,5575009,0,528701,158911,138873,6401494
"Sheffield","2008",7898398.35,5776786,0,517303,165647,160261,6619997
"Sheffield","2009",9269652.94,6227027,0,540075,181400,216361,7164863
"Sheffield","2010",8823361.07,6560253,0,622137,183483,221978,7587851
"Sheffield","2011",9032017.82,6698151,0,625018,194191,225775,7743135
"Sheffield","2012",9282680.16,6909340,0,654664,203510,233994,8001508
"Sheffield","2013",9696623.2,6955706,0,674917,207021,349654,8187298
"Shelburne","2003",3057358.73,1398680,0,236886,73029,103211,1811806
"Shelburne","2004",2884693.27,1446440,0,237081,73205,128746,1885472
"Shelburne","2005",3218188.68,1726539,0,258657,82582,118787,2186565
"Shelburne","2006",3490793.05,2007645,0,291393,78985,119330,2497353
"Shelburne","2007",3678305.8,2068089,0,286720,78677,119279,2552765
"Shelburne","2008",3801334.93,2120247,0,297366,80455,127002,2625070
"Shelburne","2009",4035635.67,2218915,0,311853,80186,150615,2761569
"Shelburne","2010",3811666.38,2278852,0,314621,86784,165500,2845757
"Shelburne","2011",3749299.16,2291069,0,310892,93768,167077,2862806
"Shelburne","2012",3972955.33,2326333,0,317761,98415,177099,2919608
"Shelburne","2013",4077497.77,2382176,0,319725,101995,180172,2984068
"Sherborn","2003",16455464.71,13039115,0,224687,25783,181173,13470758
"Sherborn","2004",16971231.78,13897192,0,242875,27221,242562,14409850
"Sherborn","2005",17574505.41,14428645,0,259754,28119,234346,14950864
"Sherborn","2006",19278981.03,15848139,0,328993,28590,220357,16426079
"Sherborn","2007",20880766.48,17209018,0,360784,33310,251479,17854591
"Sherborn","2008",21542679.19,17721466,0,368005,33494,274633,18397598
"Sherborn","2009",22819705.31,18291507,0,398515,38852,381638,19110512
"Sherborn","2010",22776157.67,18565242,0,396156,40654,433392,19435444
"Sherborn","2011",23581370.95,19278051,0,423233,43313,467644,20212241
"Sherborn","2012",24181856.38,19839224,0,434228,53275,473810,20800537
"Sherborn","2013",24834089.53,20352505,0,467364,56823,534171,21410863
"Shirley","2003",14097569.23,4745118,0,182670,225662,228512,5381962
"Shirley","2004",15110778.72,5101382,0,166911,224697,172654,5665644
"Shirley","2005",15749509.05,5334468,0,172491,245294,167702,5919955
"Shirley","2006",16000554.76,5798009,0,184371,287730,165161,6435271
"Shirley","2007",16586623.19,6070718,0,209185,282452,160213,6722568
"Shirley","2008",17153854.74,6343902,0,218795,288891,176236,7027824
"Shirley","2009",17430984.96,6671973,0,246108,323939,210243,7452263
"Shirley","2010",17026520.21,6899586,0,258674,312961,235070,7706291
"Shirley","2011",16661233.6,7102828,0,278542,341570,292718,8015658
"Shirley","2012",13334183.5,7724155,0,296072,370114,288365,8678706
"Shirley","2013",13950109.51,7951336,0,300723,386929,289039,8928027
"Shrewsbury","2003",68973191.81,31669588,23373,3155765,1584456,594120,37027302
"Shrewsbury","2004",77050051.7,34417527,28748,3093957,1624559,384343,39549134
"Shrewsbury","2005",78714491.32,36287392,31000,3116629,1601200,363043,41399264
"Shrewsbury","2006",84716869.76,38039674,24760,3101144,1688763,360174,43214515
"Shrewsbury","2007",89449667.51,39398448,27101,3171601,1687643,359927,44644720
"Shrewsbury","2008",91249858.89,40508943,27512,3324985,1577782,425283,45864505
"Shrewsbury","2009",98682255.72,42274362,27940,3577203,1651273,529977,48060755
"Shrewsbury","2010",97483424.28,43134738,0,3642583,1622709,702698,49102728
"Shrewsbury","2011",97532515.43,43876145,0,3766063,1653054,783186,50078448
"Shrewsbury","2012",104377203.9,46033042,0,4454083,1775298,746562,53008985
"Shrewsbury","2013",108159022.86,48497865,0,4684806,1846915,789117,55818703
"Shutesbury","2003",4444148.79,2743006,0,23350,9649,73335,2849340
"Shutesbury","2004",4589500.2,2846246,0,23841,11130,76468,2957685
"Shutesbury","2005",4893010.28,3060140,0,25981,0,62972,3149093
"Shutesbury","2006",4869093.96,3236896,0,25239,0,56268,3318403
"Shutesbury","2007",5269647.2,3364838,0,25721,0,56470,3447029
"Shutesbury","2008",5353957.82,3504007,0,23989,8979,47201,3584176
"Shutesbury","2009",5764024.99,3826080,0,29836,9814,61096,3926826
"Shutesbury","2010",5669146.51,3882760,0,31959,10594,69425,3994738
"Shutesbury","2011",5841467.83,4008560,0,31206,10938,72763,4123467
"Shutesbury","2012",5947315.82,4082556,0,29412,10312,89974,4212254
"Shutesbury","2013",5942933.32,4231004,0,34224,10686,88592,4364506
"Somerset","2003",46735235.09,12146153,0,2579793,5128345,9566882,29421173
"Somerset","2004",48388106.14,13760495,0,2922068,5098731,9889942,31671236
"Somerset","2005",49560778.56,16486959,0,2835272,4768231,10241708,34332170
"Somerset","2006",50278882.55,18141257,0,3041955,4589914,10593393,36366519
"Somerset","2007",55322127.82,18684151,0,3473563,4431235,10734892,37323841
"Somerset","2008",54265327.76,18290788,0,3304521,4607449,11132585,37335343
"Somerset","2009",56217306.17,18070624,0,3640333,4775794,11265853,37752604
"Somerset","2010",59752387.7,18358314,0,3792922,5106544,11152320,38410100
"Somerset","2011",57595951.74,18321957,0,4067554,5515045,11426659,39331215
"Somerset","2012",62120410.16,18953351,0,3361000,3184749,15304131,40803231
"Somerset","2013",62664557.13,22229968,0,4417142,2933346,12905661,42486117
"Somerville","2003",168520385.08,48489611,0,12016883,4232861,2041732,66781087
"Somerville","2004",161052076.8,51722563,0,12214903,4613327,2532676,71083469
"Somerville","2005",166358777.1,54985326,0,12693489,4769378,2288385,74736578
"Somerville","2006",177242350.73,59209269,0,12240249,4482439,2596856,78528813
"Somerville","2007",187912099.61,62727297,0,14061391,4261105,2150745,83200538
"Somerville","2008",196549628.62,65791448,0,15293724,4659590,2485840,88230602
"Somerville","2009",206194568.97,68804287,0,15903872,5010904,2783629,92502692
"Somerville","2010",203520519.21,71077474,0,16760922,5606739,3047897,96493032
"Somerville","2011",207906671.8,73608827,0,17625791,5805565,3508809,100548992
"Somerville","2012",215010417.44,76545901,0,18287462,6031004,3900920,104765287
"Somerville","2013",220859301.19,80782294,0,18871776,6109908,4159058,109923036
"South Hadley","2003",34188704.13,13785964,4286,984327,620056,246720,15641353
"South Hadley","2004",35046050.15,14620402,3053,871449,513637,216387,16224928
"South Hadley","2005",34693892.39,15278641,3129,916377,527213,198068,16923428
"South Hadley","2006",37205405.13,15933267,2782,898666,520499,182476,17537690
"South Hadley","2007",38817714.97,16651975,2691,928049,481898,190930,18255543
"South Hadley","2008",40950221.39,17424272,2784,962880,499637,248057,19137630
"South Hadley","2009",42671406.9,17996905,2852,976795,521543,389612,19887707
"South Hadley","2010",41585199.49,18502096,5523,1020101,548693,393186,20469599
"South Hadley","2011",42340703.23,19120339,5669,1047256,561388,363436,21098088
"South Hadley","2012",42711520.12,19722985,5815,1077334,559544,395412,21761090
"South Hadley","2013",43653357.42,20048234,5886,1092287,601831,412283,22160521
"Southampton","2003",10722268.19,5020753,14704,263787,81003,94178,5474425
"Southampton","2004",12003458.64,5641918,0,277323,79561,100968,6099770
"Southampton","2005",12204953.9,5938672,0,296418,75105,100214,6410409
"Southampton","2006",13246159.3,6209408,0,292951,76558,85813,6664730
"Southampton","2007",14177936.73,6645419,0,282846,68968,74841,7072074
"Southampton","2008",14657315.64,6892660,0,283826,65525,86033,7328044
"Southampton","2009",15857900.58,7294092,0,294402,67254,118702,7774450
"Southampton","2010",15355022.28,7640262,0,313025,76851,132931,8163069
"Southampton","2011",15643898.87,8204294,0,322675,74274,134369,8735612
"Southampton","2012",16292439.66,8544784,0,337386,76014,143364,9101548
"Southampton","2013",16825946.3,8955668,0,351741,76616,148445,9532470
"Southborough","2003",30138332.6,16642914,0,1907520,1368744,662054,20581232
"Southborough","2004",34936446.1,19866384,0,2107174,1449470,1225178,24648206
"Southborough","2005",36819704.56,21285490,0,2133607,1428198,794803,25642098
"Southborough","2006",38611926.81,22212878,0,2075465,1377340,967795,26633478
"Southborough","2007",42335743.3,23512845,0,2529081,1330712,1073153,28445791
"Southborough","2008",43563764.28,23364979,0,2597222,1326886,1131672,28420759
"Southborough","2009",45792509.83,25444032,0,3111170,1552924,1100658,31208784
"Southborough","2010",45642031.88,24804547,0,3314070,1591527,1229630,30939774
"Southborough","2011",45452228.79,25589304,0,3731952,1768983,1227279,32317518
"Southborough","2012",46692401.74,26795509,0,3533822,1755934,1139531,33224796
"Southborough","2013",47916550.48,27598776,0,3635628,1821828,1153192,34209424
"Southbridge","2003",40040621.64,6832860,0,1682600,625096,408495,9549051
"Southbridge","2004",42828036.9,7697567,0,1269998,505091,321734,9794390
"Southbridge","2005",51178001.37,8568376,0,1240722,487497,302832,10599427
"Southbridge","2006",46790891.88,9995498,0,1291936,504275,307962,12099671
"Southbridge","2007",48230007,10778737,0,1380266,486781,274970,12920754
"Southbridge","2008",50144657,11051171,0,1426513,517626,317692,13313002
"Southbridge","2009",53274126.39,11458975,0,1540714,552276,453344,14005309
"Southbridge","2010",54028635.1,11746808,0,1757509,620268,662942,14787527
"Southbridge","2011",52469805.75,12188674,0,1975890,702137,738308,15605009
"Southbridge","2012",53471097.17,12588621,0,2027732,734739,833932,16185024
"Southbridge","2013",56002231.71,13038039,0,2194746,821097,851497,16905379
"Southwick","2003",14071299.21,7971944,0,763681,171722,293771,9201118
"Southwick","2004",14906470.95,9022224,0,680426,174307,262816,10139773
"Southwick","2005",15483423.98,9529807,0,706790,190334,288773,10715704
"Southwick","2006",17165476.13,10201461,0,651528,202586,256604,11312179
"Southwick","2007",18775825.52,10808807,0,656085,203419,248466,11916777
"Southwick","2008",19810474.3,11270364,0,673279,213221,283748,12440612
"Southwick","2009",21675880.07,11690754,0,699731,265824,335919,12992228
"Southwick","2010",21485025.11,12163604,0,730415,282579,342220,13518818
"Southwick","2011",21099059.15,12202332,0,727917,294229,358479,13582957
"Southwick","2012",21256843.53,12966902,0,777679,311945,436723,14493249
"Southwick","2013",22328160.47,13319692,0,767664,308317,602093,14997766
"Spencer","2003",13722124.65,6223543,0,608248,270542,226980,7329313
"Spencer","2004",13735665.25,6296695,0,501315,234846,166321,7199177
"Spencer","2005",14219670.51,7083060,0,532743,243339,169199,8028341
"Spencer","2006",15974078.32,7943125,0,575513,255773,150556,8924967
"Spencer","2007",16888811.19,7897588,0,543538,274148,133760,8849034
"Spencer","2008",16524928.02,8195906,0,561222,280819,159466,9197413
"Spencer","2009",18760885.17,8983881,0,627188,309163,179668,10099900
"Spencer","2010",18210259.27,9160336,0,628321,323113,213008,10324778
"Spencer","2011",18882433.58,9531936,0,720953,361598,253968,10868455
"Spencer","2012",19655535.56,9871130,0,767969,392429,290817,11322345
"Spencer","2013",19781945.52,10263784,0,787016,426894,307242,11784936
"Springfield","2003",434196245.22,71128696,0,27591557,7659611,9494917,115874781
"Springfield","2004",430652521.46,75614591,0,28309438,7725439,13941985,125591453
"Springfield","2005",486933220.13,79229094,0,30577883,7732424,13488038,131027439
"Springfield","2006",467939549.42,85265909,0,31890343,7719736,13610202,138486190
"Springfield","2007",504968397.84,92662511,0,32029911,7489098,13345841,145527361
"Springfield","2008",562487917.73,96772411,0,34581488,7892323,14242951,153489173
"Springfield","2009",604225598.38,98121692,0,39678022,8985811,16293449,163078974
"Springfield","2010",579405261.28,102416999,0,41291657,8999581,18108366,170816603
"Springfield","2011",550576556.32,100485032,0,40746253,7203647,18049935,166484867
"Springfield","2012",587699524.94,99920518,0,40388752,6671232,22408714,169389216
"Springfield","2013",578583679.86,95758191,0,40821680,6226104,24597362,167403337
"Sterling","2003",15719963.12,8587855,0,502329,476992,336117,9903293
"Sterling","2004",18440096.52,9353932,0,601891,506887,381840,10844550
"Sterling","2005",18166353.97,10250140,0,636042,530544,352972,11769698
"Sterling","2006",18533030.72,11424804,0,597205,528045,301778,12851832
"Sterling","2007",19981209.03,11503224,0,526308,662113,307747,12999392
"Sterling","2008",20865622.55,12113732,0,589685,757489,372160,13833066
"Sterling","2009",21984290.52,12690604,0,628190,797877,422388,14539059
"Sterling","2010",21329728.92,12585550,0,640051,855014,455690,14536305
"Sterling","2011",21241638.96,12528881,0,678117,870263,538893,14616154
"Sterling","2012",21568114.02,12866087,0,621800,847299,592766,14927952
"Sterling","2013",22256997.11,13088383,0,651057,846852,604838,15191130
"Stockbridge","2003",5929510.24,3203186,29214,204726,22545,245096,3704767
"Stockbridge","2004",6260383.73,3658344,33462,225705,25455,286330,4229296
"Stockbridge","2005",7326429.44,4211262,0,239978,23893,181186,4656319
"Stockbridge","2006",8349153.86,4513161,0,290652,24567,193346,5021726
"Stockbridge","2007",7710913.26,5028394,0,303239,24893,209912,5566438
"Stockbridge","2008",9020718.03,5415518,0,399964,26888,217130,6059500
"Stockbridge","2009",8898988.66,5352019,0,330119,26213,226766,5935117
"Stockbridge","2010",9667822.17,5429595,0,336911,26889,237272,6030667
"Stockbridge","2011",9274758,5603782,0,346503,28628,254059,6232972
"Stockbridge","2012",9055339.01,5698584,0,335737,27333,225021,6286675
"Stockbridge","2013",9563617.31,6022004,0,360914,29643,275857,6688418
"Stoneham","2003",55133317.89,24555606,0,4225601,379955,496298,29657460
"Stoneham","2004",58082417.93,25631048,0,4445772,386551,580575,31043946
"Stoneham","2005",56487551.25,26705487,0,4452064,380279,567302,32105132
"Stoneham","2006",58728326.35,27484202,0,4743762,410745,534328,33173037
"Stoneham","2007",61168681.02,28355831,0,4921259,429506,549790,34256386
"Stoneham","2008",63798154.55,29199943,0,5018266,440521,636917,35295647
"Stoneham","2009",65439193.31,30402187,0,5074716,468703,854793,36800399
"Stoneham","2010",64267247.44,31249349,0,5261632,480134,827732,37818847
"Stoneham","2011",63858078.94,31865091,0,5479345,469663,889563,38703662
"Stoneham","2012",66836318.65,32885917,0,5552944,459335,944639,39842835
"Stoneham","2013",68917023.85,33600292,0,5816094,472779,987253,40876418
"Stoughton","2003",65050725.78,24478105,0,5570109,2719463,834124,33601801
"Stoughton","2004",67130428.43,26303650,0,5859988,2839930,862013,35865581
"Stoughton","2005",71676293.64,27628659,0,6177407,3111689,736346,37654101
"Stoughton","2006",73618272.76,28225944,0,6611387,3127927,773623,38738881
"Stoughton","2007",77024404.84,28994016,0,7683698,3255509,832210,40765433
"Stoughton","2008",80259852.84,30123262,0,8329500,3550338,1256988,43260088
"Stoughton","2009",84006852.34,31185451,0,8552870,3467550,1582218,44788089
"Stoughton","2010",85018512.6,32048903,0,9398174,3793712,2173072,47413861
"Stoughton","2011",85354588.68,32798740,0,9683258,3811235,2519559,48812792
"Stoughton","2012",89361980.01,34000464,0,9808001,3886085,2660214,50354764
"Stoughton","2013",96086345.04,35278105,0,9986207,4044721,2786859,52095892
"Stow","2003",15984451.29,11398801,0,596162,327423,143574,12465960
"Stow","2004",17339611.05,12632950,0,678419,326435,170085,13807889
"Stow","2005",18198920.54,13600174,0,673946,299257,172570,14745947
"Stow","2006",19820190.02,14622511,0,721398,356728,211392,15912029
"Stow","2007",20649660.5,15491492,0,777023,348326,217540,16834381
"Stow","2008",21487592.31,16292782,0,844528,377907,262260,17777477
"Stow","2009",22502977.6,16841558,0,878620,403936,349443,18473557
"Stow","2010",24662097.55,17698621,0,919565,417504,364708,19400398
"Stow","2011",22611312.82,17722977,0,915836,384996,387270,19411079
"Stow","2012",23864503.56,18658641,0,1003062,408116,415379,20485198
"Stow","2013",24381623.58,19017119,0,1033515,420109,390809,20861552
"Sturbridge","2003",20227594.32,9161055,0,2164891,462895,431160,12220001
"Sturbridge","2004",22163438.33,10318156,0,2311512,510646,516532,13656846
"Sturbridge","2005",22551174.55,10651364,0,2412316,555673,455156,14074509
"Sturbridge","2006",24361934.26,11344563,0,2588160,553962,519106,15005791
"Sturbridge","2007",26661506.18,11666552,0,2778379,573713,540975,15559619
"Sturbridge","2008",27729043.34,12555847,0,2649131,517844,598498,16321320
"Sturbridge","2009",28560186.81,13538366,0,2449691,453794,702750,17144601
"Sturbridge","2010",27657172.72,14249488,9351,2161508,422122,698700,17541169
"Sturbridge","2011",29235440.42,15368737,8998,2258176,465398,708371,18809680
"Sturbridge","2012",31361970.36,16140201,10412,2482035,499996,698977,19831621
"Sturbridge","2013",34062700.54,16150067,12027,2965422,606695,865646,20599857
"Sudbury","2003",63612885.04,44658930,0,2263541,1048332,658085,48628888
"Sudbury","2004",65778790.08,45033904,0,2422845,1052241,691867,49200857
"Sudbury","2005",67448080.89,45627621,0,2541822,1038225,753948,49961616
"Sudbury","2006",73212060.69,50599997,0,2786008,1133134,913796,55432935
"Sudbury","2007",77054417.17,52353764,0,2848866,1152068,892060,57246758
"Sudbury","2008",80265288.1,55551348,0,2953701,1145866,888871,60539786
"Sudbury","2009",81471699.5,57882646,0,3029560,1197306,1153611,63263123
"Sudbury","2010",81095370.73,59811853,0,3158019,1294359,1264922,65529153
"Sudbury","2011",82296930.07,61300688,0,3241074,1355624,1521120,67418506
"Sudbury","2012",84143828.35,62775313,0,3336139,1371604,1524477,69007533
"Sudbury","2013",90448698.88,64597519,0,3457322,1397166,1574403,71026410
"Sunderland","2003",6247829.75,2691329,0,264406,50440,77260,3083435
"Sunderland","2004",7195757.73,2897431,0,293043,52301,83041,3325816
"Sunderland","2005",7157805.81,3562293,0,315080,55882,79327,4012582
"Sunderland","2006",7481909.3,3673937,0,328167,53554,70845,4126503
"Sunderland","2007",7938776.85,3812943,0,317951,53730,68130,4252754
"Sunderland","2008",7881676.19,3771227,0,310864,61640,77033,4220764
"Sunderland","2009",8148311.86,3800136,0,305385,61872,91660,4259053
"Sunderland","2010",7480801.26,3854533,0,308189,64108,97959,4324789
"Sunderland","2011",7513115.88,3895922,0,312780,66883,107793,4383378
"Sunderland","2012",7535195.22,3949534,0,316711,71386,166040,4503671
"Sunderland","2013",7960055.66,4079995,0,326202,73891,154701,4634789
"Sutton","2003",19062764.46,8978686,0,437683,239852,234909,9891130
"Sutton","2004",19885947,9642203,0,446445,270180,274305,10633133
"Sutton","2005",20966937.99,10243096,0,408584,230493,230911,11113084
"Sutton","2006",23312229.71,11526913,0,502500,293886,278940,12602239
"Sutton","2007",24266976.76,11687360,0,509463,310277,269299,12776399
"Sutton","2008",26320644.46,12947812,0,592937,397634,346997,14285380
"Sutton","2009",27184837.07,13491272,0,649267,411434,386852,14938825
"Sutton","2010",27264748.52,14024682,0,742517,445531,418120,15630850
"Sutton","2011",26091809.82,14388635,0,763369,541712,470155,16163871
"Sutton","2012",28289453.31,15324858,0,805396,581509,547810,17259573
"Sutton","2013",28879915.45,16241735,0,866515,635574,645014,18388838
"Swampscott","2003",40155052.2,23798403,0,2633566,243750,339721,27015440
"Swampscott","2004",40754345.73,24798332,0,2590455,263675,320416,27972878
"Swampscott","2005",43516899.41,25624800,0,2643374,288968,440063,28997205
"Swampscott","2006",48300538.77,28950788,0,2894106,313880,484230,32643004
"Swampscott","2007",50667842.4,31385981,0,3120052,327090,561819,35394942
"Swampscott","2008",51840005.05,32804588,0,3418025,360079,592730,37175422
"Swampscott","2009",53904989.46,33874527,0,3681593,377688,790670,38724478
"Swampscott","2010",54534259.3,35219129,0,3595121,397549,951998,40163797
"Swampscott","2011",54886432.44,35149326,0,3562092,344781,1031909,40088108
"Swampscott","2012",58201105.09,36951660,0,3795674,370918,1122282,42240534
"Swampscott","2013",58783541.39,37882266,0,3959523,375225,1175160,43392174
"Swansea","2003",27828530.41,11309071,1141,4232957,307644,605788,16456601
"Swansea","2004",27069289.68,11942531,1174,4328346,315491,781082,17368624
"Swansea","2005",29207459.01,13324947,0,3807364,261881,757732,18151924
"Swansea","2006",29676420.15,14471737,0,3849262,266163,737592,19324754
"Swansea","2007",32830074.32,15206647,0,4061135,258168,768114,20294064
"Swansea","2008",34021679.71,16157835,0,4070174,246763,749843,21224615
"Swansea","2009",34583710.48,16449410,0,4443055,258715,927568,22078748
"Swansea","2010",33715953.3,16655605,0,4827350,264614,1055661,22803230
"Swansea","2011",34633865.2,17965342,0,4402295,190206,1188518,23746361
"Swansea","2012",36946872.13,18558838,0,5277743,212883,1178101,25227565
"Swansea","2013",37887668.14,19245723,0,5271499,210765,1435258,26163245
"Taunton","2003",130798530.13,27314487,0,11197008,4318732,1193848,44024075
"Taunton","2004",136102608.97,31567364,0,10405280,3901547,2149923,48024114
"Taunton","2005",141944718.46,34868895,0,11140080,3814410,1086816,50910201
"Taunton","2006",149776993.56,36561541,0,11676686,4190843,1029363,53458433
"Taunton","2007",157237147.63,38839939,0,11957103,4211429,1292041,56300512
"Taunton","2008",167711099.34,38993885,0,13347397,4549233,2407659,59298174
"Taunton","2009",172267280.67,40648411,0,15275374,5065182,2767096,63756063
"Taunton","2010",178469703.96,41835715,0,16175500,5452411,3096297,66559923
"Taunton","2011",175172019.64,42746381,0,17040763,5796052,4003191,69586387
"Taunton","2012",180166147.51,44899826,0,17601012,5985400,4297407,72783645
"Taunton","2013",188210067.31,47568210,0,19070652,5973543,4809820,77422225
"Templeton","2003",9440661.14,4099357,0,226994,164796,62833,4553980
"Templeton","2004",10322248.79,4699369,0,256895,171999,67978,5196241
"Templeton","2005",10218167.68,4695936,0,221736,155519,41729,5114920
"Templeton","2006",12587020.99,5190894,0,257489,152555,40251,5641189
"Templeton","2007",15034749.96,5592702,0,320818,189195,42742,6145457
"Templeton","2008",13510621.8,6256536,0,350879,199106,57822,6864343
"Templeton","2009",14063838.64,6331714,0,431003,230396,102564,7095677
"Templeton","2010",14508348.95,6462752,0,433427,226344,120841,7243364
"Templeton","2011",14089354.11,6708971,0,461205,236187,138268,7544631
"Templeton","2012",14892496.57,7514376,0,532172,271173,170084,8487805
"Templeton","2013",13596073.87,6772370,0,482338,257190,153012,7664910
"Tewksbury","2003",74720835.19,26828927,62129,5918090,5628978,2181797,40619921
"Tewksbury","2004",72185523.71,28968692,51506,5812802,5432675,2008584,42274259
"Tewksbury","2005",73795811.61,31068283,44596,6220201,4730487,1890001,43953568
"Tewksbury","2006",79515484.87,33485133,46908,5837752,4378115,1864534,45612442
"Tewksbury","2007",83935863.97,35082931,47947,6051860,4293113,2059125,47534976
"Tewksbury","2008",91333153.49,36461825,50711,6231762,4479778,2429641,49653717
"Tewksbury","2009",93951698.39,37701187,8083,6468885,4542114,3055557,51775826
"Tewksbury","2010",95749509.76,38863808,0,6697727,4913798,3314475,53789808
"Tewksbury","2011",100095069.48,40514786,0,7023315,4962612,3609565,56110278
"Tewksbury","2012",101340016.4,46061748,0,8004527,5540221,4099140,63705636
"Tewksbury","2013",109147737.79,47306664,0,9605251,5298203,4024278,66234396
"Tisbury","2003",16617962.54,10124730,0,1818763,43165,503850,12490508
"Tisbury","2004",18066442.67,10725342,0,1913360,46109,561797,13246608
"Tisbury","2005",18698259.45,10852680,0,1835464,37375,399327,13124846
"Tisbury","2006",20747205.99,11140288,0,2208433,40395,382282,13771398
"Tisbury","2007",21401001.61,12499239,0,2117871,41393,404783,15063286
"Tisbury","2008",22664905.4,13254169,0,2326172,43505,434448,16058294
"Tisbury","2009",26298342.99,14002314,0,2139397,38646,419459,16599816
"Tisbury","2010",25021192.47,14689018,0,2166629,38833,395615,17290095
"Tisbury","2011",25845986.23,15753694,0,2456369,38341,429052,18677456
"Tisbury","2012",25965953.83,16967733,0,1743347,29797,293197,19034074
"Tisbury","2013",26789962.34,17295618,0,1833949,31537,301783,19462887
"Tolland","2003",988109.4,540444,0,11424,1300,31435,584603
"Tolland","2004",822102.11,567407,0,12200,1708,33911,615226
"Tolland","2005",1013426.63,593906,0,12684,1759,32519,640868
"Tolland","2006",998958.85,749096,0,18440,1731,31868,801135
"Tolland","2007",1053832.12,778099,0,19482,1616,30736,829933
"Tolland","2008",1174716.6,816114,0,18376,1669,33714,869873
"Tolland","2009",1263883.75,842847,0,19650,1619,34560,898676
"Tolland","2010",1192026.98,871941,0,20064,1774,33686,927465
"Tolland","2011",1288857.93,986623,0,22578,1818,40563,1051582
"Tolland","2012",1356576.52,1016680,0,24304,3894,49456,1094334
"Tolland","2013",1491880.01,1103579,0,29260,6309,64778,1203926
"Topsfield","2003",17443650.53,11309529,0,601602,146313,137181,12194625
"Topsfield","2004",17602659.62,12047579,0,622464,165493,139317,12974853
"Topsfield","2005",18478745.71,12925064,0,645648,169081,127728,13867521
"Topsfield","2006",19581128.81,13028332,0,646339,165244,123164,13963079
"Topsfield","2007",20905611.12,13771685,0,695165,193934,130249,14791033
"Topsfield","2008",21657018.84,14384345,0,731709,223097,157028,15496179
"Topsfield","2009",22357039.53,14827465,0,793642,240249,260107,16121463
"Topsfield","2010",22812281.81,15244653,0,855611,261983,273637,16635884
"Topsfield","2011",22476419.4,15756331,0,908212,278693,303496,17246732
"Topsfield","2012",23457518.01,16256985,0,933887,285774,325794,17802440
"Topsfield","2013",24398947.94,16811521,0,896564,284550,337581,18330216
"Townsend","2003",13517437.94,8628066,0,437544,262140,143969,9471719
"Townsend","2004",13832962.73,9042733,0,438378,267608,161883,9910602
"Townsend","2005",14187766.78,9840451,0,456479,262833,154954,10714717
"Townsend","2006",16024594.94,10045077,0,482000,277174,192288,10996539
"Townsend","2007",16321012.12,10416501,0,503445,274339,205001,11399286
"Townsend","2008",17298004.79,11387672,0,539705,297007,223290,12447674
"Townsend","2009",17986621.52,11859407,0,543920,276198,258861,12938386
"Townsend","2010",17508931.24,12074589,0,559799,290518,294366,13219272
"Townsend","2011",18486436.24,12289766,0,572213,290625,325499,13478103
"Townsend","2012",18500590.98,12491861,0,604065,314462,365869,13776257
"Townsend","2013",19195522.35,12681408,0,640880,334956,403357,14060601
"Truro","2003",10266945.2,6962800,0,404184,7227,138579,7512790
"Truro","2004",11223618.49,7314432,0,412091,7582,153251,7887356
"Truro","2005",11778847.13,7732665,0,453532,8119,69981,8264297
"Truro","2006",13938031.71,8563299,0,475007,6316,74928,9119550
"Truro","2007",13714947.93,8743602,0,483896,7500,76474,9311472
"Truro","2008",15349119.93,9490131,0,511773,8066,94750,10104720
"Truro","2009",15990617.31,9972772,0,523945,8484,110569,10615770
"Truro","2010",16835667.02,10863403,0,559777,9608,127778,11560566
"Truro","2011",17291905.44,10689780,0,563969,9589,141320,11404658
"Truro","2012",17133154.05,11139924,0,588017,10026,144228,11882195
"Truro","2013",17110629.97,11328054,0,615962,9832,146185,12100033
"Tyngsborough","2003",28630683.74,12906842,0,1239206,742514,302705,15191267
"Tyngsborough","2004",29805313.4,13521847,0,1084144,670660,252045,15528696
"Tyngsborough","2005",30094308.3,13979610,0,1027185,623818,240596,15871209
"Tyngsborough","2006",31537552.73,14807950,0,1026367,619990,262605,16716912
"Tyngsborough","2007",34039689.61,15099744,0,1193108,680464,302065,17275381
"Tyngsborough","2008",34702120,15667148,0,1240957,713229,316913,17938247
"Tyngsborough","2009",35160964.13,16124057,0,1368940,782422,400515,18675934
"Tyngsborough","2010",34849468.5,16558973,0,1428195,780758,586030,19353956
"Tyngsborough","2011",35942197.49,16751132,0,1452998,778953,564518,19547601
"Tyngsborough","2012",35883473.21,18112453,0,1566576,837404,612126,21128559
"Tyngsborough","2013",37234110.26,18973096,0,1636028,841250,630434,22080808
"Tyringham","2003",984788.34,721019,0,10908,0,73775,805702
"Tyringham","2004",1090028.3,772515,0,11588,0,78213,862316
"Tyringham","2005",996295.28,779772,0,6662,0,46966,833400
"Tyringham","2006",1076099.84,819743,0,6922,0,46579,873244
"Tyringham","2007",1203640.08,892230,0,7537,0,51430,951197
"Tyringham","2008",1228855.92,959901,0,7769,0,46926,1014596
"Tyringham","2009",1416405.76,1001949,0,8248,0,48632,1058829
"Tyringham","2010",1331032.2,1010833,0,8265,0,47795,1066893
"Tyringham","2011",1314117.88,1048113,0,6923,0,51787,1106823
"Tyringham","2012",1397348.68,1047427,0,6018,0,52971,1106416
"Tyringham","2013",1528360.5,1056219,0,3903,0,70871,1130993
"Upton","2003",11557363.12,7906058,0,223090,66668,212597,8408413
"Upton","2004",12556443.77,9243840,0,255887,76630,253257,9829614
"Upton","2005",14109274.05,9831265,0,208964,78645,211073,10329947
"Upton","2006",15990398.58,10564827,0,220934,83010,228632,11097403
"Upton","2007",15773585.52,10962132,0,236389,92415,234608,11525544
"Upton","2008",16772518.41,11839596,0,247786,97233,253079,12437694
"Upton","2009",17062148.8,12243062,0,289439,109932,335877,12978310
"Upton","2010",16906128.91,12694496,0,300351,113536,343004,13451387
"Upton","2011",19842294.28,13806157,0,358678,117576,366053,14648464
"Upton","2012",20658128.62,14242673,0,376467,123457,380474,15123071
"Upton","2013",20693101.9,14707033,0,392574,123210,468448,15691265
"Uxbridge","2003",30292132.43,11086293,0,756481,485277,465169,12793220
"Uxbridge","2004",31358486.13,12097606,0,682675,460016,426174,13666471
"Uxbridge","2005",33924404.78,13936599,0,700913,477981,466401,15581894
"Uxbridge","2006",36163995,14704020,0,763590,545703,422803,16436116
"Uxbridge","2007",40813903.72,15015542,0,828961,812014,430375,17086892
"Uxbridge","2008",41123894.27,15780041,0,894546,816985,453779,17945351
"Uxbridge","2009",41596663.02,16721053,0,947116,919056,611885,19199110
"Uxbridge","2010",41288313.79,17318417,0,996105,963816,664315,19942653
"Uxbridge","2011",38868973.7,17782357,0,1069559,1050442,765222,20667580
"Uxbridge","2012",41452372.2,19570505,0,1188233,1186987,842116,22787841
"Uxbridge","2013",43610366.6,20076593,0,1291925,1230350,925919,23524787
"Wakefield","2003",64677121.17,24284001,0,9065459,1951425,521745,35822630
"Wakefield","2004",65191914.59,25006718,0,10008286,2018354,800534,37833892
"Wakefield","2005",66462947.67,27830323,0,8900913,1877438,683579,39292253
"Wakefield","2006",68259516.69,30254930,0,8196549,1726572,566051,40744102
"Wakefield","2007",71691765.55,31882419,0,8420122,1650264,495547,42448352
"Wakefield","2008",72587342.92,32987285,0,8606313,1774126,527522,43895246
"Wakefield","2009",75784279.4,33672292,0,9240578,1942518,873571,45728959
"Wakefield","2010",74897302.33,34962375,0,9555398,2020062,983219,47521054
"Wakefield","2011",78122569.96,36943172,0,9074590,1920519,3078205,51016486
"Wakefield","2012",80895683.01,38540054,0,9437799,1979106,3072251,53029210
"Wakefield","2013",84041607.29,39763808,0,9582958,1958829,3397808,54703403
"Wales","2003",3442081.47,1590933,0,34784,10899,110037,1746653
"Wales","2004",3315346.33,1675917,0,33478,11234,112062,1832691
"Wales","2005",3079697.77,1767237,0,36312,12960,90843,1907352
"Wales","2006",3331328.9,1860443,0,38074,13477,88783,2000777
"Wales","2007",3606477.94,2010143,0,35788,13994,87611,2147536
"Wales","2008",3762499.89,2119855,0,38034,12026,87196,2257111
"Wales","2009",3866867.42,2209109,0,39584,12383,101721,2362797
"Wales","2010",3845973.2,2289499,0,41181,12918,112132,2455730
"Wales","2011",3878060.11,2337356,0,45821,13206,115814,2512197
"Wales","2012",3982106.03,2442105,0,48125,14007,121353,2625590
"Wales","2013",4202562.49,2501408,0,50295,15034,156037,2722774
"Walpole","2003",56962648.42,29440043,0,2624307,1756172,856175,34676697
"Walpole","2004",60030900.48,31084081,0,2848984,1847759,1718790,37499614
"Walpole","2005",61983824.76,33095121,0,2830225,1943267,1031789,38900402
"Walpole","2006",66454910.15,35292229,0,2986166,2080035,1082364,41440794
"Walpole","2007",71349114.59,36876026,0,3193913,2190727,1314890,43575556
"Walpole","2008",73792338.67,37413988,0,3525701,2522801,1375421,44837911
"Walpole","2009",76880755.66,38963344,0,3593716,2756820,1257156,46571036
"Walpole","2010",77211691.98,40005057,0,3881420,2849608,1738534,48474619
"Walpole","2011",77166380.56,42042359,0,3998276,2916439,1901424,50858498
"Walpole","2012",80495650.56,43626817,0,4076866,2976045,1922651,52602379
"Walpole","2013",86310417.57,47464369,0,4522416,3300095,2359702,57646582
"Waltham","2003",159169845.77,40290564,0,44827702,11042486,5519352,101680104
"Waltham","2004",168467693.18,42245288,0,43847100,13257799,7247555,106597742
"Waltham","2005",168831183.44,45775180,0,43206140,13598061,7943340,110522721
"Waltham","2006",181721712.27,51681399,0,41035118,12896078,7219017,112831612
"Waltham","2007",188302732.52,53055675,0,43750799,12779377,6174199,115760050
"Waltham","2008",196138500.3,55554304,0,45884743,12137987,5961270,119538304
"Waltham","2009",208696124.5,58242655,0,50846623,13314110,6662379,129065767
"Waltham","2010",214244101.1,61192348,0,58095993,13323731,7352816,139964888
"Waltham","2011",216188727.38,62062192,0,62230796,13412801,8270352,145976141
"Waltham","2012",220823508.02,63569895,0,63306765,14692083,9302250,150870993
"Waltham","2013",224671907.56,64838451,0,65262945,14691695,10094747,154887838
"Ware","2003",22284013.64,6807209,0,805980,315800,228808,8157797
"Ware","2004",23164812.8,7136414,0,826266,324404,349603,8636687
"Ware","2005",23795578.15,7803778,0,735942,293078,211791,9044589
"Ware","2006",25103766.01,8312643,0,713543,287578,270504,9584268
"Ware","2007",27200831,8764112,0,714979,293207,271213,10043511
"Ware","2008",27044699.45,9140056,0,754301,328500,283423,10506280
"Ware","2009",28413739.59,9436088,0,819497,342193,373004,10970782
"Ware","2010",26741637.58,9658641,0,873366,365787,392284,11290078
"Ware","2011",27750415.38,9934411,0,896864,379833,412990,11624098
"Ware","2012",27898515.69,10238897,0,937008,394978,369956,11940839
"Ware","2013",28417216.55,10443092,0,1012017,422992,382675,12260776
"Wareham","2003",48888921.16,18470669,0,2000190,451362,437439,21359660
"Wareham","2004",50562145.56,19693095,0,2149449,485856,557132,22885532
"Wareham","2005",52578654.62,20871097,0,1917058,436552,456192,23680899
"Wareham","2006",55857083.29,22658520,0,1892608,389732,446928,25387788
"Wareham","2007",59046662.15,23399790,0,1926945,399485,463258,26189478
"Wareham","2008",59251946.44,23924506,0,2431755,446756,541481,27344498
"Wareham","2009",59455869.4,24378071,0,3101241,520127,727734,28727173
"Wareham","2010",58547153.14,25010247,0,3277788,546000,881863,29715898
"Wareham","2011",59950976.62,25636862,0,3515864,590526,1012123,30755375
"Wareham","2012",60624438.36,26273633,0,3650850,611258,1030462,31566203
"Wareham","2013",61962995.38,26756475,0,4024947,682176,1166891,32630489
"Warren","2003",6062283.92,3005249,0,139217,161542,179416,3485424
"Warren","2004",6865065.3,3596245,0,145575,175273,236803,4153896
"Warren","2005",7571755.51,3885449,0,151082,179425,177376,4393332
"Warren","2006",7934781.79,4053468,0,146428,173859,217880,4591635
"Warren","2007",8551545.76,4391844,0,154561,173745,203870,4924020
"Warren","2008",8414273.05,4474575,0,155601,172301,214774,5017251
"Warren","2009",8610535.52,4879265,0,165416,139681,268947,5453309
"Warren","2010",8606158.44,5119800,0,162978,141252,309266,5733296
"Warren","2011",8471141.74,4801924,0,160149,134179,328607,5424859
"Warren","2012",8806624.02,5092170,0,167308,141193,344487,5745158
"Warren","2013",8893523.78,5116495,0,166792,146701,375984,5805972
"Warwick","2003",1394754.7,898236,0,9195,2184,35412,945027
"Warwick","2004",1573237.13,1017467,0,8573,2202,35002,1063244
"Warwick","2005",1624664.88,1063959,0,9301,2279,31112,1106651
"Warwick","2006",1766845.41,1212678,0,10641,2513,31061,1256893
"Warwick","2007",1837287.18,1243894,0,10631,1934,24279,1280738
"Warwick","2008",1848080.86,1313751,0,15503,2039,26014,1357307
"Warwick","2009",1811350.94,1240264,0,17149,1916,31793,1291122
"Warwick","2010",1896155.16,1264979,0,25675,1923,35277,1327854
"Warwick","2011",1908234.27,1299243,0,24580,1987,37622,1363432
"Warwick","2012",1994548.23,1274402,0,23605,1955,38947,1338909
"Warwick","2013",1927641.62,1282851,0,24166,0,44106,1351123
"Washington","2003",937871.62,549435,0,35491,451,18775,604152
"Washington","2004",1111713.68,582818,0,29212,473,17576,630079
"Washington","2005",1031052.09,624980,0,30226,503,16634,672343
"Washington","2006",1166059.42,620213,0,28592,3470,16813,669088
"Washington","2007",1180879.98,656779,0,30102,2680,15697,705258
"Washington","2008",1314605,690965,0,30882,2743,16521,741111
"Washington","2009",1366214.86,773136,0,33233,2896,25080,834345
"Washington","2010",1324355.87,818688,0,26673,2845,29476,877682
"Washington","2011",1335507.57,834934,0,27449,2919,30204,895506
"Washington","2012",1364217.23,844120,0,29767,3004,27707,904598
"Washington","2013",1483978.72,845805,0,29265,2958,26259,904287
"Watertown","2003",84472546.27,31168157,0,13091726,4814555,1819919,50894357
"Watertown","2004",86597453.36,33921103,0,12828955,4980203,2615485,54345746
"Watertown","2005",89684769.04,38174193,0,12564023,4387775,1759852,56885843
"Watertown","2006",97457872.52,40620826,0,12709809,4418163,1836439,59585237
"Watertown","2007",98962834.17,42058624,0,13681649,4811187,1672666,62224126
"Watertown","2008",103339562.94,43344788,0,14910892,4864692,1915343,65035715
"Watertown","2009",107474514.31,45441089,0,14838197,5185529,2082963,67547778
"Watertown","2010",109706116.9,46645795,0,15231466,5560391,2352234,69789886
"Watertown","2011",109307497.77,47754211,0,16051145,5935242,2591136,72331734
"Watertown","2012",112953941.54,50001136,0,16149609,6131944,2800055,75082744
"Watertown","2013",115702857.86,52560739,0,16442779,6535738,2832163,78371419
"Wayland","2003",48866003.82,33528304,0,876734,531622,217246,35153906
"Wayland","2004",52739978.32,35339251,0,901186,560365,254549,37055351
"Wayland","2005",54149051.89,36433104,0,972097,372415,267409,38045025
"Wayland","2006",56516949.8,40388072,0,1146314,342729,258103,42135218
"Wayland","2007",58663130.39,44100339,0,1298236,391913,290572,46081060
"Wayland","2008",62320691.65,45553663,0,1464012,435244,327731,47780650
"Wayland","2009",66282120.65,49133609,0,1586369,483008,548556,51751542
"Wayland","2010",68817165.19,51051938,0,1582930,507601,565902,53708371
"Wayland","2011",69073563.88,53254019,0,1679814,537108,657072,56128013
"Wayland","2012",75546930.63,52655113,0,1666057,530645,662384,55514199
"Wayland","2013",74356000.54,49286642,0,1979102,80088,670358,52016190
"Webster","2003",29453333.5,9166023,0,2268864,435954,484524,12355365
"Webster","2004",31341262.2,8957038,0,2307463,413256,470450,12148207
"Webster","2005",32909589.59,10072970,0,2198985,363908,395969,13031832
"Webster","2006",34709065.45,11544008,0,2413923,386625,365887,14710443
"Webster","2007",36674492.01,12158023,0,2438398,365684,358688,15320793
"Webster","2008",40154082.36,12151861,0,2517527,350192,349710,15369290
"Webster","2009",39408566.07,12636744,0,2568456,369242,410424,15984866
"Webster","2010",38683999.67,12907086,0,2758610,391157,476370,16533223
"Webster","2011",39466596.21,13586667,0,2925052,417018,578100,17506837
"Webster","2012",40257044.34,14021055,0,3094390,424187,568313,18107945
"Webster","2013",42245407.55,14258910,0,3191863,457652,567163,18475588
"Wellesley","2003",79680882.88,52021145,0,5857606,43012,455136,58376899
"Wellesley","2004",82279124.45,57243964,0,5896393,46464,531781,63718602
"Wellesley","2005",95987510.54,59417627,0,6332382,49526,526764,66326299
"Wellesley","2006",105013986.02,64422675,0,6784120,54113,522733,71783641
"Wellesley","2007",116624704.04,70487247,0,8154918,62507,610224,79314896
"Wellesley","2008",118866109.46,74076605,0,9427704,68235,659895,84232439
"Wellesley","2009",133372977.64,77907521,0,10379470,70911,858134,89216036
"Wellesley","2010",133034779.88,83175820,0,9935019,69399,950400,94130638
"Wellesley","2011",138350803.71,88618847,0,10341178,75689,1109648,100145362
"Wellesley","2012",143434059.86,93275333,0,10574446,81623,1106486,105037888
"Wellesley","2013",152651170.89,96339929,0,11769206,87025,1264445,109460605
"Wellfleet","2003",11614782.9,7930666,0,395662,693,230533,8557554
"Wellfleet","2004",12802905.98,8387631,0,355705,2360,200009,8945705
"Wellfleet","2005",13220920.32,9290407,0,374325,3087,215529,9883348
"Wellfleet","2006",15235045.02,9927013,0,376322,3356,214636,10521327
"Wellfleet","2007",16065130.02,10787819,0,383268,4658,92190,11267935
"Wellfleet","2008",17203635.06,11097022,0,408521,4683,107306,11617532
"Wellfleet","2009",18515872.37,11373629,0,418590,4850,127967,11925036
"Wellfleet","2010",18596768.44,12679319,0,492592,6983,157589,13336483
"Wellfleet","2011",18431282.46,12682358,0,491781,6983,163022,13344144
"Wellfleet","2012",18829475.57,12728657,0,483991,7018,163064,13382730
"Wellfleet","2013",19619376.74,13196083,0,504244,7350,199067,13906744
"Wendell","2003",1846802.35,878670,0,47009,5928,63859,995466
"Wendell","2004",2012930.77,878173,0,46116,5803,66861,996953
"Wendell","2005",1912015.27,937362,0,50708,6421,63784,1058275
"Wendell","2006",3372879.06,1078754,0,109024,10151,52427,1250356
"Wendell","2007",2460357.75,1181218,0,115787,10964,53964,1361933
"Wendell","2008",2484311.23,1220480,0,112203,11345,57746,1401774
"Wendell","2009",2313437.49,1238197,0,107116,8999,77565,1431877
"Wendell","2010",2229329.5,1313885,0,112478,9534,83040,1518937
"Wendell","2011",2943731.73,1396937,0,80830,10227,131941,1619935
"Wendell","2012",2717734.32,1433606,0,54827,18491,195509,1702433
"Wendell","2013",2598010.4,1337326,0,51396,18211,195736,1602669
"Wenham","2003",10234629.72,7258840,5076,251746,8364,60404,7584430
"Wenham","2004",10615580.91,7678921,5334,262015,8789,68068,8023127
"Wenham","2005",11683065.2,8515214,11485,269162,9031,69185,8874077
"Wenham","2006",12458879.48,8792939,11893,280790,8103,68083,9161808
"Wenham","2007",13032905.31,9218840,15530,289867,8443,66911,9599591
"Wenham","2008",14571009.46,10348151,12242,320712,9348,77815,10768268
"Wenham","2009",16560748.96,11230772,0,351726,10572,112080,11705150
"Wenham","2010",15732492.78,11496871,0,354377,11029,122828,11985105
"Wenham","2011",15709250.59,11676231,0,379477,11834,142374,12209916
"Wenham","2012",15910790.53,11939605,0,382497,19595,139842,12481539
"Wenham","2013",16017427.67,11803462,0,357990,18916,160548,12340916
"West Boylston","2003",16936611.04,7230980,0,822647,634248,241681,8929556
"West Boylston","2004",18489249.99,7746575,0,810053,606413,251939,9414980
"West Boylston","2005",18369047.58,8285088,0,763433,570841,213574,9832936
"West Boylston","2006",19718825.52,8886594,0,744690,524358,189491,10345133
"West Boylston","2007",21262235.36,9464500,0,795938,572268,206738,11039444
"West Boylston","2008",21965312.73,9874277,0,878081,685803,236004,11674165
"West Boylston","2009",23331046.09,10129574,0,1012671,738891,844061,12725197
"West Boylston","2010",23115380.39,10341623,0,1030153,777196,868591,13017563
"West Boylston","2011",23829028.49,10603324,0,1090511,790638,917981,13402454
"West Boylston","2012",25875249.36,10951165,0,1120471,798391,913666,13783693
"West Boylston","2013",25188975.87,11155032,0,1174390,821272,916053,14066747
"West Bridgewater","2003",18085990.5,7071162,0,2152546,1843280,437212,11504200
"West Bridgewater","2004",18425807.39,7179982,0,2286212,1964972,499257,11930423
"West Bridgewater","2005",19131157.4,7760386,0,2221443,2139356,449394,12570579
"West Bridgewater","2006",20996815.7,8085671,0,2330754,2380812,514182,13311419
"West Bridgewater","2007",21644784.98,8624781,0,2513784,2293307,606817,14038689
"West Bridgewater","2008",23158923.64,9048591,0,2999275,2458177,583900,15089943
"West Bridgewater","2009",23710883.33,9253409,0,3225692,2588793,691830,15759724
"West Bridgewater","2010",24943660.19,9583604,0,3565969,2814988,776247,16740808
"West Bridgewater","2011",24869200.53,9937663,0,3677218,2874943,787244,17277068
"West Bridgewater","2012",26392505.57,10300255,0,3819148,2923106,770722,17813231
"West Bridgewater","2013",26734057.67,10670804,0,4062580,3054773,706154,18494311
"West Brookfield","2003",5091764.66,2819021,0,159154,66169,77253,3121597
"West Brookfield","2004",7017880.33,3059042,0,179195,71958,86140,3396335
"West Brookfield","2005",6264789.91,3378521,0,152554,71894,63384,3666353
"West Brookfield","2006",5913814.86,3609796,0,148337,69779,56425,3884337
"West Brookfield","2007",8528425.7,3810232,0,154736,71777,47666,4084411
"West Brookfield","2008",6873875.63,3788718,0,148578,63651,49130,4050077
"West Brookfield","2009",6957476.86,3904515,0,151847,65119,59596,4181077
"West Brookfield","2010",9259550.88,3982867,0,154875,72785,69961,4280488
"West Brookfield","2011",7578399.32,3717364,0,143306,68424,73806,4002900
"West Brookfield","2012",7390914.41,3960210,0,192485,72740,81434,4306869
"West Brookfield","2013",8993665.74,4091707,0,199040,76461,91756,4458964
"West Newbury","2003",9180288.83,6386233,1371,100647,21032,84230,6593513
"West Newbury","2004",9934853.13,6961139,0,55574,19415,65620,7101748
"West Newbury","2005",10349544.36,7635837,0,58500,20854,66384,7781575
"West Newbury","2006",11824897.71,7896710,0,59234,21210,65129,8042283
"West Newbury","2007",12194697.01,8672539,0,66183,22906,80004,8841632
"West Newbury","2008",13820004.78,9042713,0,67848,23740,85271,9219572
"West Newbury","2009",13553962.12,9347303,0,70898,24650,132124,9574975
"West Newbury","2010",13041494.22,9611467,0,81888,25399,151540,9870294
"West Newbury","2011",13282848.38,9961141,0,85158,25220,173905,10245424
"West Newbury","2012",14424229.71,10404506,0,92838,25067,186603,10709014
"West Newbury","2013",15259965.18,11124432,0,96872,25005,284294,11530603
"West Springfield","2003",67059261.34,19748854,0,10721318,3084557,1901569,35456298
"West Springfield","2004",71029966.3,20507085,0,11587474,4291167,2131929,38517655
"West Springfield","2005",72933078.56,22652704,0,12461807,4366087,1980181,41460779
"West Springfield","2006",76284304.45,24375507,0,13833171,4646876,2131246,44986800
"West Springfield","2007",81680258.39,26010975,0,15019496,4761161,2231735,48023367
"West Springfield","2008",86471869.81,27701764,0,15327957,4654641,2399467,50083829
"West Springfield","2009",89251753.56,28499798,0,16400731,4830507,2829349,52560385
"West Springfield","2010",90580324.12,29459234,0,17404108,5055537,2978595,54897474
"West Springfield","2011",94514809.81,30170920,0,18003108,5426429,3111522,56711979
"West Springfield","2012",96793375.29,30632372,0,18805737,5064398,3879313,58381820
"West Springfield","2013",100059411.73,29211617,0,17165091,4667444,4008558,55052710
"West Stockbridge","2003",3492780.24,2495902,0,152688,21398,82561,2752549
"West Stockbridge","2004",3784152.11,2852488,0,170491,17566,95486,3136031
"West Stockbridge","2005",4312284.38,3161954,0,183090,26440,105094,3476578
"West Stockbridge","2006",4205309.5,3315381,0,132310,21389,84017,3553097
"West Stockbridge","2007",4426440.5,3336775,0,128316,18681,80746,3564518
"West Stockbridge","2008",5016350.42,3478700,0,129192,18893,92468,3719253
"West Stockbridge","2009",5243257.03,3589831,0,134077,18741,107163,3849812
"West Stockbridge","2010",4921510.76,3679636,0,137129,19044,105317,3941126
"West Stockbridge","2011",4956963.51,3792453,0,144659,20562,118686,4076360
"West Stockbridge","2012",4876570.57,3854428,0,146287,24426,83446,4108587
"West Stockbridge","2013",4970446.4,3947919,0,151267,25129,110563,4234878
"West Tisbury","2003",10070369.51,7833129,0,203670,12845,103010,8152654
"West Tisbury","2004",10560552.73,8547448,0,222659,14344,125174,8909625
"West Tisbury","2005",12022042.41,9609343,0,238122,14732,97257,9959454
"West Tisbury","2006",13343141.8,10276711,0,256716,16441,106800,10656668
"West Tisbury","2007",14258906.5,10457397,0,262652,18816,101780,10840645
"West Tisbury","2008",15014619.98,10753521,0,245515,17770,111176,11127982
"West Tisbury","2009",16204676.16,10783143,0,251998,17715,126785,11179641
"West Tisbury","2010",15535217.14,10896298,0,291577,18422,133492,11339789
"West Tisbury","2011",15902378.35,11039381,0,302896,16992,149570,11508839
"West Tisbury","2012",16177225.34,11353443,0,326749,21666,163636,11865494
"West Tisbury","2013",16446335.31,11973915,0,349248,23892,174470,12521525
"Westborough","2003",62214644.24,23338840,0,6755835,6211066,2204002,38509743
"Westborough","2004",65795236.68,25865877,0,6786309,6149463,3508592,42310241
"Westborough","2005",69076568.46,28377680,0,7002849,6361259,4852111,46593899
"Westborough","2006",75116115.2,30116450,0,7023430,6367657,5081870,48589407
"Westborough","2007",78370206.47,30233439,0,7417501,6779269,6377175,50807384
"Westborough","2008",82695793.07,32708305,0,8470847,7483817,4874574,53537543
"Westborough","2009",87648166.19,33504324,0,9450016,8057589,4802608,55814537
"Westborough","2010",88259020.71,34906587,0,9871957,8154409,4670726,57603679
"Westborough","2011",88260613.84,36460409,0,9991613,8117058,4418607,58987687
"Westborough","2012",93689488.65,38181817,0,10397725,6874762,5551554,61005858
"Westborough","2013",96308277.81,38785310,0,10620165,6504891,6464742,62375108
"Westfield","2003",98992111.65,27062805,0,8837089,2404958,1321188,39626040
"Westfield","2004",102102716.6,29420822,0,8236744,2364457,1207861,41229884
"Westfield","2005",105475589.94,30562961,0,9037072,2529500,1277433,43406966
"Westfield","2006",114247972.58,32337369,0,8925849,2816316,1490111,45569645
"Westfield","2007",119255478.79,34828578,0,8695608,2863737,1377713,47765636
"Westfield","2008",122368600.08,36547913,0,8920795,2932746,1658362,50059816
"Westfield","2009",127266483.45,37921588,0,9358325,3012229,2085672,52377814
"Westfield","2010",126350830.75,39554892,0,9557864,3350862,1891504,54355122
"Westfield","2011",127481098.73,40498111,0,9968486,3797264,2072914,56336775
"Westfield","2012",133624847.8,42536410,0,10256278,4174961,2131544,59099193
"Westfield","2013",137828214.97,44552807,0,10123709,4109842,2014739,60801097
"Westford","2003",73360114.99,35699412,0,3060396,3320593,641887,42722288
"Westford","2004",77782912.22,38374550,0,2697241,3206463,640624,44918878
"Westford","2005",79700392.18,40825441,0,2708063,3120565,826211,47480280
"Westford","2006",80842756.39,42760940,0,2692259,2803790,760352,49017341
"Westford","2007",84756537.76,44341929,0,2885385,3044637,745294,51017245
"Westford","2008",89966979.81,45287906,0,3034462,3206151,828880,52357399
"Westford","2009",94514916.6,46797054,0,3145019,3363985,976747,54282805
"Westford","2010",94036469.11,47940063,0,3297328,3618276,1072015,55927682
"Westford","2011",95079861.48,49369256,0,3163177,3372064,1343257,57247754
"Westford","2012",97191298.35,51103910,0,3719824,3295001,1356017,59474752
"Westford","2013",100474580.24,52962417,0,3876953,3562018,1527896,61929284
"Westhampton","2003",3258471.88,1977602,0,51390,8941,49461,2087394
"Westhampton","2004",3563609.34,2285056,0,47272,8671,61943,2402942
"Westhampton","2005",3731283.91,2488139,0,51208,16083,46434,2601864
"Westhampton","2006",3574736.34,2641013,0,48431,13754,34444,2737642
"Westhampton","2007",3914908.56,2842762,0,62013,15766,35158,2955699
"Westhampton","2008",4068180,2935002,0,64630,16569,36586,3052787
"Westhampton","2009",4462310.23,3135681,0,68314,17720,59529,3281244
"Westhampton","2010",4392191.76,3213711,0,82134,17227,72416,3385488
"Westhampton","2011",4590421.46,3351719,0,79608,20559,81806,3533692
"Westhampton","2012",4626350.06,3459688,0,85712,21241,87080,3653721
"Westhampton","2013",4709839.74,3482256,0,95163,21805,87055,3686279
"Westminster","2003",14538893.85,7122933,0,518524,875288,408297,8925042
"Westminster","2004",13975734.82,7184209,0,556104,631040,792510,9163863
"Westminster","2005",16745820.58,8431035,0,619233,692975,629900,10373143
"Westminster","2006",19010608.56,9230960,0,634829,706001,418894,10990684
"Westminster","2007",20126113.96,9978353,0,754499,740652,334260,11807764
"Westminster","2008",19168426.61,10336301,0,683043,495046,380614,11895004
"Westminster","2009",23850871.91,11323081,0,814108,569479,626127,13332795
"Westminster","2010",20556475.61,10912760,0,876316,920835,622714,13332625
"Westminster","2011",20573569.31,11092251,0,899413,955856,792683,13740203
"Westminster","2012",21895255.85,11665695,0,994678,919780,861944,14442097
"Westminster","2013",22973705.02,12330882,0,1028839,960028,755906,15075655
"Weston","2003",55336499.93,38310575,0,967560,72591,222658,39573384
"Weston","2004",56545502.96,40133706,0,1165792,70921,250917,41621336
"Weston","2005",59968025.08,42257742,0,1181504,70470,248676,43758392
"Weston","2006",65747133,46688765,0,1276358,74131,273369,48312623
"Weston","2007",73450871.88,49740886,0,1340931,76517,283999,51442333
"Weston","2008",75747669.21,52495470,0,1524856,89978,330249,54440553
"Weston","2009",78528438.91,54969338,0,1558252,93612,377132,56998334
"Weston","2010",79036641.84,55898554,0,1696375,94291,386109,58075329
"Weston","2011",78982780.87,57166165,0,2210435,103418,440549,59920567
"Weston","2012",86677291.85,60203256,0,2457523,113008,482468,63256255
"Weston","2013",87397426.48,61269127,0,2494575,115714,543919,64423335
"Westport","2003",23830229.28,13180582,0,1093029,47344,218874,14539829
"Westport","2004",24566376.18,13776200,0,1110896,51072,233792,15171960
"Westport","2005",26400278.46,14490303,0,1145170,41910,193253,15870636
"Westport","2006",27824708.28,15128153,0,1249598,44860,176680,16599291
"Westport","2007",29593044.5,15833434,0,1271036,44733,177695,17326898
"Westport","2008",30712081.86,16641644,0,1363248,46864,211269,18263025
"Westport","2009",31622143.89,16995707,0,1378139,47845,274536,18696227
"Westport","2010",31583890.61,17701300,0,1458960,54044,320899,19535203
"Westport","2011",32241658.87,18178805,0,1572155,57462,348601,20157023
"Westport","2012",33032644.3,19509771,0,1142817,59635,348028,21060251
"Westport","2013",35244237.96,20125436,0,1216476,60181,360492,21762585
"Westwood","2003",51230423.64,28300946,0,4515918,3884654,587111,37288629
"Westwood","2004",55940807.69,32210219,0,5161207,4439673,1301284,43112383
"Westwood","2005",57510797.26,33242873,0,5398750,3676183,774541,43092347
"Westwood","2006",58447383.94,32513554,0,5097518,3631785,954163,42197020
"Westwood","2007",60518315.35,33772830,0,5384499,3780735,1029383,43967447
"Westwood","2008",67029108.67,37283573,0,5911978,4198510,1125876,48519937
"Westwood","2009",85387149.14,38405199,0,7247510,3657622,1062758,50373089
"Westwood","2010",68417652.98,40368223,0,7517796,2786031,1160196,51832246
"Westwood","2011",69671948.13,41684578,0,7714413,2839717,1332519,53571227
"Westwood","2012",72296696.11,43721559,0,7937195,3094749,1306871,56060374
"Westwood","2013",73286036.05,45048912,0,8327119,3001778,1294122,57671931
"Weymouth","2003",122515073.58,44369317,0,6749028,4551781,1721147,57391273
"Weymouth","2004",123729380.21,46303167,0,7425621,4727431,1888031,60344250
"Weymouth","2005",127117410.45,48230999,0,8040702,4746086,1784631,62802418
"Weymouth","2006",137673853.01,50233187,0,8139357,4941645,1818756,65132945
"Weymouth","2007",139973461.46,52174089,0,8373180,5151000,1828365,67526634
"Weymouth","2008",143009207.87,54360381,0,9099229,4959347,1862791,70281748
"Weymouth","2009",149859870.56,55575743,0,9902855,5484559,2074606,73037763
"Weymouth","2010",147257792.6,57313144,0,10246963,5542151,2286467,75388725
"Weymouth","2011",144601307.65,59053797,0,10490819,5841896,2568660,77955172
"Weymouth","2012",153301758.1,61234875,0,10680395,6048958,2635622,80599850
"Weymouth","2013",159588563.06,62990930,0,11641721,5780141,2910942,83323734
"Whately","2003",3676117.05,1899699,0,243222,232396,77010,2452327
"Whately","2004",3720743.15,2002969,0,234230,241854,91403,2570456
"Whately","2005",4084725.2,2214003,0,226731,222686,77191,2740611
"Whately","2006",4218052.15,2343761,0,227058,211778,70893,2853490
"Whately","2007",4227127.91,2484615,0,241147,232183,71377,3029322
"Whately","2008",4562128,2589512,0,268641,269278,69514,3196945
"Whately","2009",4871945.89,2636873,0,273398,272027,85464,3267762
"Whately","2010",4707978.53,2651817,0,293268,272473,92151,3309709
"Whately","2011",4817445.22,2686792,27619,293789,286540,97038,3391778
"Whately","2012",5298582.6,2765429,29706,306254,293578,359903,3754870
"Whately","2013",5399510.87,2780042,28556,312732,295723,362129,3779182
"Whitman","2003",25831492.86,13463112,0,1006570,269289,299440,15038411
"Whitman","2004",26870891.68,14117569,0,1141185,294736,300183,15853673
"Whitman","2005",25832973.12,13689262,0,936291,233480,198257,15057290
"Whitman","2006",28607012.48,14845053,0,914268,218884,189833,16168038
"Whitman","2007",28771906.1,14713703,0,869712,207276,195190,15985881
"Whitman","2008",29548209.58,15306094,0,957671,251954,204134,16719853
"Whitman","2009",30036925.88,15072358,0,983736,260896,241373,16558363
"Whitman","2010",29798954.33,15686371,0,1078484,284281,353305,17402441
"Whitman","2011",29924753.25,16325617,0,1100486,275740,410786,18112629
"Whitman","2012",31056113.85,17273035,0,1176921,285865,454396,19190217
"Whitman","2013",32139011.05,18094554,0,1268104,309552,476388,20148598
"Wilbraham","2003",26109519.81,16902713,0,1345008,353577,408906,19010204
"Wilbraham","2004",28342342.61,19085933,0,1271891,360244,386974,21105042
"Wilbraham","2005",29550869.5,20113877,0,1404614,438487,401764,22358742
"Wilbraham","2006",32708985.46,21206547,0,1409467,416325,395665,23428004
"Wilbraham","2007",33222768.27,22276951,0,1470774,396445,345161,24489331
"Wilbraham","2008",33935872.75,23166320,0,1565083,401749,384776,25517928
"Wilbraham","2009",35240315.07,23887337,0,1748865,425975,478816,26540993
"Wilbraham","2010",35285465.46,24523735,0,1927267,449481,518302,27418785
"Wilbraham","2011",36742279.61,25320453,0,1972539,462756,558960,28314708
"Wilbraham","2012",38673593.17,26870942,0,2138922,506719,607698,30124281
"Wilbraham","2013",39880814.77,27807945,0,2329648,552279,668304,31358176
"Williamsburg","2003",4687039.09,2587398,0,228096,17982,54308,2887784
"Williamsburg","2004",5317022.29,3108511,0,239989,22628,51329,3422457
"Williamsburg","2005",5383641.92,3273504,0,251322,23587,56021,3604434
"Williamsburg","2006",5713320.44,3346338,0,244360,23897,42212,3656807
"Williamsburg","2007",6223534.29,3673842,0,250206,25403,39512,3988963
"Williamsburg","2008",6166772.06,3847282,0,261958,26422,46128,4181790
"Williamsburg","2009",6187729.31,3983565,0,267838,27106,74388,4352897
"Williamsburg","2010",6488086.31,4129486,0,268673,27370,80926,4506455
"Williamsburg","2011",6712564.62,4289778,0,276556,26107,92809,4685250
"Williamsburg","2012",6778370.11,4364908,0,281596,31197,102684,4780385
"Williamsburg","2013",7067058.69,4610384,0,289388,32244,106046,5038062
"Williamstown","2003",16512235.22,7974903,0,1014158,161911,176215,9327187
"Williamstown","2004",17092896.57,8732327,0,1098749,174021,220342,10225439
"Williamstown","2005",17463174.1,9131687,0,1060241,167019,212448,10571395
"Williamstown","2006",18621305.42,9695608,0,1130179,161531,177046,11164364
"Williamstown","2007",19473464.3,10313793,0,1098383,152914,177200,11742290
"Williamstown","2008",20386984.33,10758285,0,1129478,156910,189792,12234465
"Williamstown","2009",21297033.64,11057521,0,1285339,149272,229614,12721746
"Williamstown","2010",21443810.93,11619714,0,1175098,153363,233016,13181191
"Williamstown","2011",20811597.45,12039870,0,1233985,158350,243742,13675947
"Williamstown","2012",21475357.87,12832472,0,1172537,151488,249220,14405717
"Williamstown","2013",21706925.61,12687087,0,1205483,154189,254988,14301747
"Wilmington","2003",58592127,21177638,0,3736829,13983565,1851899,40749931
"Wilmington","2004",62069362.98,22085229,0,2946855,15588706,1594337,42215127
"Wilmington","2005",63086708.82,24266995,0,2906968,15079741,1344341,43598045
"Wilmington","2006",64638418.87,26274512,0,2998432,14800202,1469489,45542635
"Wilmington","2007",68764350.3,27878416,0,3006181,15367786,1193812,47446195
"Wilmington","2008",71255596.85,29563072,0,3090356,15609429,1387666,49650523
"Wilmington","2009",76114962.29,29542779,0,3511677,17093114,2012966,52160536
"Wilmington","2010",77567859.59,30024616,0,3794422,18343332,2134242,54296612
"Wilmington","2011",79588643.47,31093272,0,4063148,19117142,2313983,56587545
"Wilmington","2012",78686531.05,31886755,0,4071556,19253327,2551346,57762984
"Wilmington","2013",88180103.83,34974535,0,4603716,20882873,2824555,63285679
"Winchendon","2003",24266304.85,5697562,0,392465,143254,145636,6378917
"Winchendon","2004",25182785.17,5997835,0,384032,142173,145029,6669069
"Winchendon","2005",25857316.39,6360305,0,367180,136889,115707,6980081
"Winchendon","2006",26246160.81,7482500,0,390295,143689,127669,8144153
"Winchendon","2007",26913248.76,7979189,0,399666,142446,118527,8639828
"Winchendon","2008",28448317.42,8278185,0,410195,145555,126625,8960560
"Winchendon","2009",29344874.8,8503821,0,468635,142786,202964,9318206
"Winchendon","2010",27886826.54,8783081,0,441025,153082,224286,9601474
"Winchendon","2011",28312195.97,8985355,0,447639,154251,265756,9853001
"Winchendon","2012",28359221.79,9079509,0,513934,160675,276319,10030437
"Winchendon","2013",27613331.34,8681986,0,513467,162962,269189,9627604
"Winchester","2003",66845797.96,44431175,0,1768063,275565,353574,46828377
"Winchester","2004",67969138.21,46140293,0,1808107,278123,389178,48615701
"Winchester","2005",69349046.87,48009949,0,1831514,224639,351663,50417765
"Winchester","2006",75403999.42,50238631,0,1880551,222803,366188,52708173
"Winchester","2007",78774995.38,52067746,0,1950612,225633,373347,54617338
"Winchester","2008",81774173.91,54620224,0,2151666,253574,404032,57429496
"Winchester","2009",86391630.03,56929424,0,2361873,275870,505981,60073148
"Winchester","2010",86861180.32,58485527,0,2389731,281066,586898,61743222
"Winchester","2011",92677724.62,61043518,0,2411711,287240,641231,64383700
"Winchester","2012",95889751.66,63735785,0,2461240,298663,636364,67132052
"Winchester","2013",101824424.98,65812350,0,2500939,304753,691257,69309299
"Windsor","2003",1453568.73,873761,2429,15601,12850,21825,926466
"Windsor","2004",1505492.72,901993,1214,14142,13154,22940,953443
"Windsor","2005",1564212.74,987720,1255,13772,14105,31152,1048004
"Windsor","2006",1880727.24,1098819,70,15028,15165,25292,1154374
"Windsor","2007",1901982.12,1150284,70,15394,15440,24039,1205227
"Windsor","2008",2049308.09,1126325,58,13275,13500,20001,1173159
"Windsor","2009",2042681.35,1214250,0,15830,10800,28006,1268886
"Windsor","2010",2000926.55,1222074,0,15053,11070,34219,1282416
"Windsor","2011",2087382.27,1297302,0,17974,12296,44555,1372127
"Windsor","2012",2164412.16,1289110,0,16246,11152,51661,1368169
"Windsor","2013",1881572.33,1343392,0,16442,11763,54001,1425598
"Winthrop","2003",38740899.57,15132312,2765,784913,29882,148222,16098094
"Winthrop","2004",37441321.9,15485734,1705,805410,30494,166339,16489682
"Winthrop","2005",38331895.9,15919451,1763,803533,32066,171521,16928334
"Winthrop","2006",39806422.53,16681294,581,843659,32305,163479,17721318
"Winthrop","2007",42276132.04,17549909,593,807869,30656,157857,18546884
"Winthrop","2008",44060834.67,18153421,625,856846,32235,177851,19220978
"Winthrop","2009",43373333.57,18726389,670,963666,36098,217491,19944314
"Winthrop","2010",44333050.15,21548328,853,1185821,46274,275877,23057153
"Winthrop","2011",44377865.13,22041124,696,1248497,48984,314926,23654227
"Winthrop","2012",46218344.65,22612900,672,1291037,52803,347470,24304882
"Winthrop","2013",47901184.2,23082488,692,1342048,48256,370485,24843969
"Woburn","2003",95676136.25,25053767,0,15466202,13773264,3668666,57961899
"Woburn","2004",103322908.45,30280301,0,15480818,14213020,5008898,64983037
"Woburn","2005",106916802.62,34167895,0,14941501,15726400,3731551,68567347
"Woburn","2006",114271702.36,35006161,0,14522317,15383444,3726653,68638575
"Woburn","2007",123130919.82,38175072,0,14904665,15834405,3432627,72346769
"Woburn","2008",124994604.14,38891100,0,16450641,16822798,3466450,75630989
"Woburn","2009",132729426.45,39389814,0,18359589,18485688,4256014,80491105
"Woburn","2010",133356552.82,40684738,0,18820358,18882149,4542292,82929537
"Woburn","2011",122993746.71,40398721,0,18814710,18988203,5682134,83883768
"Woburn","2012",134177971.6,40897712,0,19791156,18941510,6519812,86150190
"Woburn","2013",135949047.86,41436057,0,21268655,18739581,6767090,88211383
"Worcester","2003",453533833.38,95539234,0,32566810,10884761,10279283,149270088
"Worcester","2004",460047075,103785033,0,32439179,10368389,9953796,156546397
"Worcester","2005",478497701.89,112015677,0,32859702,9917238,8591513,163384130
"Worcester","2006",506299359.65,118348640,0,35238511,10812080,8137095,172536326
"Worcester","2007",527515244.45,124780535,0,37516578,10950292,8518582,181765987
"Worcester","2008",550779433.07,131204080,0,38565493,11618201,9137012,190524786
"Worcester","2009",570667435.93,132516563,0,42431973,13090952,11142421,199181909
"Worcester","2010",565868895.17,130063177,0,49352474,14442032,13645196,207502879
"Worcester","2011",576734492.98,136432753,0,51756230,15340346,14735359,218264688
"Worcester","2012",596606133.61,138514500,0,56999465,16483070,17218989,229216024
"Worcester","2013",619151955.68,145251130,0,59578764,16844219,18016570,239690683
"Worthington","2003",2216425.77,1543795,0,55269,5441,43419,1647924
"Worthington","2004",2384619.7,1601563,0,55941,5519,47550,1710573
"Worthington","2005",2483480.01,1617741,0,51575,5266,35090,1709672
"Worthington","2006",2535508.03,1689261,0,58698,5410,34370,1787739
"Worthington","2007",2812679.17,1790844,0,58245,5609,34374,1889072
"Worthington","2008",3007772.79,1950248,0,68861,6060,36278,2061447
"Worthington","2009",3222833.51,1980355,0,74565,6328,51740,2112988
"Worthington","2010",3167088.65,2016637,0,72662,6365,52363,2148027
"Worthington","2011",3115708.77,2096545,0,78145,6609,53792,2235091
"Worthington","2012",3146171.85,2069149,0,74465,8285,66458,2218357
"Worthington","2013",3159377.37,2023976,0,72131,8085,69214,2173406
"Wrentham","2003",25823615.99,13302044,0,2526318,481189,350370,16659921
"Wrentham","2004",26713593.86,14026126,0,2655794,517355,427326,17626601
"Wrentham","2005",29687839.09,14987630,0,2802728,533695,403818,18727871
"Wrentham","2006",31130995.58,16178693,0,2878010,539136,427440,20023279
"Wrentham","2007",31143751.4,16872726,0,3097019,562326,447901,20979972
"Wrentham","2008",33018469.71,17415280,0,3160848,574334,530075,21680537
"Wrentham","2009",34960364.64,18220374,0,3365786,621318,724074,22931552
"Wrentham","2010",34049553.34,18902692,0,3507525,619436,706285,23735938
"Wrentham","2011",35064553.66,19413027,0,3739972,648820,809499,24611318
"Wrentham","2012",36345275.86,19989798,0,3954727,670047,800765,25415337
"Wrentham","2013",37367403.19,20223080,0,4683276,619839,874763,26400958
"Yarmouth","2003",62566358.67,27633612,5757,3586660,196420,885931,32308380
"Yarmouth","2004",63905752.13,32096118,5367,2636934,164267,593946,35496632
"Yarmouth","2005",65930880.66,32928970,5503,2778972,152039,609234,36474718
"Yarmouth","2006",69821572,34217269,4324,2766543,149304,533767,37671207
"Yarmouth","2007",72369481.94,36669935,6636,2976471,241289,396131,40290462
"Yarmouth","2008",74162194.78,36424845,6670,3245830,260487,447590,40385422
"Yarmouth","2009",74313312.09,38185081,6951,3432387,273838,623467,42521724
"Yarmouth","2010",78798217.6,39852867,0,3609960,294383,762505,44519715
"Yarmouth","2011",78410713.83,42070839,0,3717950,296523,876442,46961754
"Yarmouth","2012",78546624.34,43643818,0,3809766,302550,950617,48706751
"Yarmouth","2013",81949349.18,45185637,0,3924962,304223,995887,50410709
