"","Municipal","County","State","Region","Year","Unemployment Rate Avg","No Unemployed Avg","No Employed Avg","Labor Avg"
"3957",NA,"NA County","MA","MA","1976","Massachusetts",267633,2458306,2725939
"3958",NA,"NA County","MA","MA","1977","Massachusetts",218418,2541441,2759859
"3959",NA,"NA County","MA","MA","1978","Massachusetts",173402,2635115,2808517
"3960",NA,"NA County","MA","MA","1979","Massachusetts",156341,2706845,2863186
"3961",NA,"NA County","MA","MA","1980","Massachusetts",164064,2721430,2885494
"3962",NA,"NA County","MA","MA","1981","Massachusetts",189276,2749062,2938338
"3963",NA,"NA County","MA","MA","1982","Massachusetts",236372,2729293,2965665
"3964",NA,"NA County","MA","MA","1983","Massachusetts",208954,2763148,2972102
"3965",NA,"NA County","MA","MA","1984","Massachusetts",145657,2886782,3032439
"3966",NA,"NA County","MA","MA","1985","Massachusetts",124753,2924626,3049379
"3967",NA,"NA County","MA","MA","1986","Massachusetts",122686,2957321,3080007
"3968",NA,"NA County","MA","MA","1987","Massachusetts",104458,3009900,3114358
"3969",NA,"NA County","MA","MA","1988","Massachusetts",104345,3051355,3155700
"3970",NA,"NA County","MA","MA","1989","Massachusetts",132422,3057019,3189441
"3971",NA,"NA County","MA","MA","1990","Massachusetts",203975,3022393,3226368
"3972",NA,"NA County","MA","MA","1991","Massachusetts",282590,2916293,3198883
"3973",NA,"NA County","MA","MA","1992","Massachusetts",281022,2899718,3180740
"3974",NA,"NA County","MA","MA","1993","Massachusetts",232339,2940565,3172904
"3975",NA,"NA County","MA","MA","1994","Massachusetts",198690,2989123,3187813
"3976",NA,"NA County","MA","MA","1995","Massachusetts",175528,3029360,3204888
"3977",NA,"NA County","MA","MA","1996","Massachusetts",147721,3083332,3231053
"3978",NA,"NA County","MA","MA","1997","Massachusetts",134564,3158851,3293415
"3979",NA,"NA County","MA","MA","1998","Massachusetts",112674,3208988,3321662
"3980",NA,"NA County","MA","MA","1999","Massachusetts",109563,3245761,3355324
"3981",NA,"NA County","MA","MA","2000","Massachusetts",92292,3273281,3365573
"3982",NA,"NA County","MA","MA","2001","Massachusetts",125993,3275343,3401336
"3983",NA,"NA County","MA","MA","2002","Massachusetts",181003,3243409,3424412
"3984",NA,"NA County","MA","MA","2003","Massachusetts",197648,3209062,3406710
"3985",NA,"NA County","MA","MA","2004","Massachusetts",176839,3203810,3380649
"3986",NA,"NA County","MA","MA","2005","Massachusetts",163579,3219717,3383296
"3987",NA,"NA County","MA","MA","2006","Massachusetts",162495,3255504,3417999
"3988",NA,"NA County","MA","MA","2007","Massachusetts",154422,3276532,3430954
"3989",NA,"NA County","MA","MA","2008","Massachusetts",185177,3277934,3463111
"3990",NA,"NA County","MA","MA","2009","Massachusetts",283193,3187538,3470731
"3991",NA,"NA County","MA","MA","2010","Massachusetts",287549,3187622,3475171
"3992",NA,"NA County","MA","MA","2011","Massachusetts",253592,3216160,3469752
"3993",NA,"NA County","MA","MA","2012","Massachusetts",233684,3241762,3475446
"1","Abington","Plymouth County","MA","Abington","1990","Abington town, MA",553,7229,7782
"2","Abington","Plymouth County","MA","Abington","1991","Abington town, MA",818,6938,7756
"3","Abington","Plymouth County","MA","Abington","1992","Abington town, MA",754,6935,7689
"4","Abington","Plymouth County","MA","Abington","1993","Abington town, MA",589,7164,7753
"5","Abington","Plymouth County","MA","Abington","1994","Abington town, MA",510,7690,8200
"6","Abington","Plymouth County","MA","Abington","1995","Abington town, MA",458,7774,8232
"7","Abington","Plymouth County","MA","Abington","1996","Abington town, MA",415,7868,8283
"8","Abington","Plymouth County","MA","Abington","1997","Abington town, MA",371,8110,8481
"9","Abington","Plymouth County","MA","Abington","1998","Abington town, MA",309,8163,8472
"10","Abington","Plymouth County","MA","Abington","1999","Abington town, MA",265,8271,8536
"11","Abington","Plymouth County","MA","Abington","2000","Abington town, MA",209,8207,8416
"12","Abington","Plymouth County","MA","Abington","2001","Abington town, MA",269,8279,8548
"13","Abington","Plymouth County","MA","Abington","2002","Abington town, MA",383,8283,8666
"14","Abington","Plymouth County","MA","Abington","2003","Abington town, MA",464,8515,8979
"15","Abington","Plymouth County","MA","Abington","2004","Abington town, MA",465,8602,9067
"16","Abington","Plymouth County","MA","Abington","2005","Abington town, MA",441,8676,9117
"17","Abington","Plymouth County","MA","Abington","2006","Abington town, MA",436,8803,9239
"18","Abington","Plymouth County","MA","Abington","2007","Abington town, MA",430,8917,9347
"19","Abington","Plymouth County","MA","Abington","2008","Abington town, MA",513,9030,9543
"20","Abington","Plymouth County","MA","Abington","2009","Abington town, MA",821,8778,9599
"21","Abington","Plymouth County","MA","Abington","2010","Abington town, MA",811,8349,9160
"22","Abington","Plymouth County","MA","Abington","2011","Abington town, MA",708,8427,9135
"23","Abington","Plymouth County","MA","Abington","2012","Abington town, MA",642,8502,9144
"24","Acton","Middlesex County","MA","Acton","1990","Acton town, MA",322,10147,10469
"25","Acton","Middlesex County","MA","Acton","1991","Acton town, MA",461,9727,10188
"26","Acton","Middlesex County","MA","Acton","1992","Acton town, MA",523,9800,10323
"27","Acton","Middlesex County","MA","Acton","1993","Acton town, MA",481,10056,10537
"28","Acton","Middlesex County","MA","Acton","1994","Acton town, MA",389,10238,10627
"29","Acton","Middlesex County","MA","Acton","1995","Acton town, MA",347,10469,10816
"30","Acton","Middlesex County","MA","Acton","1996","Acton town, MA",230,10782,11012
"31","Acton","Middlesex County","MA","Acton","1997","Acton town, MA",230,11118,11348
"32","Acton","Middlesex County","MA","Acton","1998","Acton town, MA",193,11350,11543
"33","Acton","Middlesex County","MA","Acton","1999","Acton town, MA",229,11531,11760
"34","Acton","Middlesex County","MA","Acton","2000","Acton town, MA",185,11454,11639
"35","Acton","Middlesex County","MA","Acton","2001","Acton town, MA",348,11559,11907
"36","Acton","Middlesex County","MA","Acton","2002","Acton town, MA",590,11388,11978
"37","Acton","Middlesex County","MA","Acton","2003","Acton town, MA",573,11213,11786
"38","Acton","Middlesex County","MA","Acton","2004","Acton town, MA",435,11166,11601
"39","Acton","Middlesex County","MA","Acton","2005","Acton town, MA",394,11231,11625
"40","Acton","Middlesex County","MA","Acton","2006","Acton town, MA",388,11112,11500
"41","Acton","Middlesex County","MA","Acton","2007","Acton town, MA",350,11255,11605
"42","Acton","Middlesex County","MA","Acton","2008","Acton town, MA",414,11306,11720
"43","Acton","Middlesex County","MA","Acton","2009","Acton town, MA",688,11066,11754
"44","Acton","Middlesex County","MA","Acton","2010","Acton town, MA",683,11598,12281
"45","Acton","Middlesex County","MA","Acton","2011","Acton town, MA",576,11769,12345
"46","Acton","Middlesex County","MA","Acton","2012","Acton town, MA",535,11898,12433
"47","Acushnet","Bristol County","MA","Acushnet","1990","Acushnet town, MA",426,4859,5285
"48","Acushnet","Bristol County","MA","Acushnet","1991","Acushnet town, MA",654,4761,5415
"49","Acushnet","Bristol County","MA","Acushnet","1992","Acushnet town, MA",571,4855,5426
"50","Acushnet","Bristol County","MA","Acushnet","1993","Acushnet town, MA",523,4975,5498
"51","Acushnet","Bristol County","MA","Acushnet","1994","Acushnet town, MA",492,5053,5545
"52","Acushnet","Bristol County","MA","Acushnet","1995","Acushnet town, MA",470,4877,5347
"53","Acushnet","Bristol County","MA","Acushnet","1996","Acushnet town, MA",395,4876,5271
"54","Acushnet","Bristol County","MA","Acushnet","1997","Acushnet town, MA",347,5033,5380
"55","Acushnet","Bristol County","MA","Acushnet","1998","Acushnet town, MA",285,5268,5553
"56","Acushnet","Bristol County","MA","Acushnet","1999","Acushnet town, MA",241,5390,5631
"57","Acushnet","Bristol County","MA","Acushnet","2000","Acushnet town, MA",189,5444,5633
"58","Acushnet","Bristol County","MA","Acushnet","2001","Acushnet town, MA",234,5426,5660
"59","Acushnet","Bristol County","MA","Acushnet","2002","Acushnet town, MA",325,5514,5839
"60","Acushnet","Bristol County","MA","Acushnet","2003","Acushnet town, MA",374,5433,5807
"61","Acushnet","Bristol County","MA","Acushnet","2004","Acushnet town, MA",321,5473,5794
"62","Acushnet","Bristol County","MA","Acushnet","2005","Acushnet town, MA",341,5543,5884
"63","Acushnet","Bristol County","MA","Acushnet","2006","Acushnet town, MA",343,5625,5968
"64","Acushnet","Bristol County","MA","Acushnet","2007","Acushnet town, MA",322,5600,5922
"65","Acushnet","Bristol County","MA","Acushnet","2008","Acushnet town, MA",373,5414,5787
"66","Acushnet","Bristol County","MA","Acushnet","2009","Acushnet town, MA",579,5265,5844
"67","Acushnet","Bristol County","MA","Acushnet","2010","Acushnet town, MA",617,5159,5776
"68","Acushnet","Bristol County","MA","Acushnet","2011","Acushnet town, MA",533,5212,5745
"69","Acushnet","Bristol County","MA","Acushnet","2012","Acushnet town, MA",471,5274,5745
"70","Adams","Berkshire County","MA","Adams","1990","Adams town, MA",430,4158,4588
"71","Adams","Berkshire County","MA","Adams","1991","Adams town, MA",761,3941,4702
"72","Adams","Berkshire County","MA","Adams","1992","Adams town, MA",623,3853,4476
"73","Adams","Berkshire County","MA","Adams","1993","Adams town, MA",543,3852,4395
"74","Adams","Berkshire County","MA","Adams","1994","Adams town, MA",469,3763,4232
"75","Adams","Berkshire County","MA","Adams","1995","Adams town, MA",335,3753,4088
"76","Adams","Berkshire County","MA","Adams","1996","Adams town, MA",323,3799,4122
"77","Adams","Berkshire County","MA","Adams","1997","Adams town, MA",295,3813,4108
"78","Adams","Berkshire County","MA","Adams","1998","Adams town, MA",239,3807,4046
"79","Adams","Berkshire County","MA","Adams","1999","Adams town, MA",232,3809,4041
"80","Adams","Berkshire County","MA","Adams","2000","Adams town, MA",178,4259,4437
"81","Adams","Berkshire County","MA","Adams","2001","Adams town, MA",233,4264,4497
"82","Adams","Berkshire County","MA","Adams","2002","Adams town, MA",306,4227,4533
"83","Adams","Berkshire County","MA","Adams","2003","Adams town, MA",351,4166,4517
"84","Adams","Berkshire County","MA","Adams","2004","Adams town, MA",297,4125,4422
"85","Adams","Berkshire County","MA","Adams","2005","Adams town, MA",269,4135,4404
"86","Adams","Berkshire County","MA","Adams","2006","Adams town, MA",267,4155,4422
"87","Adams","Berkshire County","MA","Adams","2007","Adams town, MA",284,4135,4419
"88","Adams","Berkshire County","MA","Adams","2008","Adams town, MA",310,4181,4491
"89","Adams","Berkshire County","MA","Adams","2009","Adams town, MA",462,4074,4536
"90","Adams","Berkshire County","MA","Adams","2010","Adams town, MA",455,4114,4569
"91","Adams","Berkshire County","MA","Adams","2011","Adams town, MA",411,4107,4518
"92","Adams","Berkshire County","MA","Adams","2012","Adams town, MA",394,4053,4447
"93","Agawam","Hampden County","MA","Agawam","1990","Agawam Town city, MA",744,14394,15138
"94","Agawam","Hampden County","MA","Agawam","1991","Agawam Town city, MA",1145,13969,15114
"95","Agawam","Hampden County","MA","Agawam","1992","Agawam Town city, MA",1260,13941,15201
"96","Agawam","Hampden County","MA","Agawam","1993","Agawam Town city, MA",1116,13913,15029
"97","Agawam","Hampden County","MA","Agawam","1994","Agawam Town city, MA",984,14016,15000
"98","Agawam","Hampden County","MA","Agawam","1995","Agawam Town city, MA",781,13670,14451
"99","Agawam","Hampden County","MA","Agawam","1996","Agawam Town city, MA",617,13845,14462
"100","Agawam","Hampden County","MA","Agawam","1997","Agawam Town city, MA",582,14190,14772
"101","Agawam","Hampden County","MA","Agawam","1998","Agawam Town city, MA",490,14242,14732
"102","Agawam","Hampden County","MA","Agawam","1999","Agawam Town city, MA",446,14323,14769
"103","Agawam","Hampden County","MA","Agawam","2000","Agawam Town city, MA",416,15295,15711
"104","Agawam","Hampden County","MA","Agawam","2001","Agawam Town city, MA",513,15357,15870
"105","Agawam","Hampden County","MA","Agawam","2002","Agawam Town city, MA",752,15309,16061
"106","Agawam","Hampden County","MA","Agawam","2003","Agawam Town city, MA",875,15187,16062
"107","Agawam","Hampden County","MA","Agawam","2004","Agawam Town city, MA",786,15228,16014
"108","Agawam","Hampden County","MA","Agawam","2005","Agawam Town city, MA",737,15279,16016
"109","Agawam","Hampden County","MA","Agawam","2006","Agawam Town city, MA",748,15335,16083
"110","Agawam","Hampden County","MA","Agawam","2007","Agawam Town city, MA",696,15283,15979
"111","Agawam","Hampden County","MA","Agawam","2008","Agawam Town city, MA",826,15017,15843
"112","Agawam","Hampden County","MA","Agawam","2009","Agawam Town city, MA",1241,14533,15774
"113","Agawam","Hampden County","MA","Agawam","2010","Agawam Town city, MA",1282,14546,15828
"114","Agawam","Hampden County","MA","Agawam","2011","Agawam Town city, MA",1080,14400,15480
"115","Agawam","Hampden County","MA","Agawam","2012","Agawam Town city, MA",990,14409,15399
"116","Alford","Berkshire County","MA","Alford","1990","Alford town, MA",6,199,205
"117","Alford","Berkshire County","MA","Alford","1991","Alford town, MA",7,192,199
"118","Alford","Berkshire County","MA","Alford","1992","Alford town, MA",6,188,194
"119","Alford","Berkshire County","MA","Alford","1993","Alford town, MA",8,193,201
"120","Alford","Berkshire County","MA","Alford","1994","Alford town, MA",5,192,197
"121","Alford","Berkshire County","MA","Alford","1995","Alford town, MA",3,214,217
"122","Alford","Berkshire County","MA","Alford","1996","Alford town, MA",4,219,223
"123","Alford","Berkshire County","MA","Alford","1997","Alford town, MA",6,223,229
"124","Alford","Berkshire County","MA","Alford","1998","Alford town, MA",5,220,225
"125","Alford","Berkshire County","MA","Alford","1999","Alford town, MA",5,217,222
"126","Alford","Berkshire County","MA","Alford","2000","Alford town, MA",4,211,215
"127","Alford","Berkshire County","MA","Alford","2001","Alford town, MA",5,218,223
"128","Alford","Berkshire County","MA","Alford","2002","Alford town, MA",7,223,230
"129","Alford","Berkshire County","MA","Alford","2003","Alford town, MA",11,224,235
"130","Alford","Berkshire County","MA","Alford","2004","Alford town, MA",7,221,228
"131","Alford","Berkshire County","MA","Alford","2005","Alford town, MA",10,229,239
"132","Alford","Berkshire County","MA","Alford","2006","Alford town, MA",10,231,241
"133","Alford","Berkshire County","MA","Alford","2007","Alford town, MA",8,226,234
"134","Alford","Berkshire County","MA","Alford","2008","Alford town, MA",8,225,233
"135","Alford","Berkshire County","MA","Alford","2009","Alford town, MA",8,219,227
"136","Alford","Berkshire County","MA","Alford","2010","Alford town, MA",13,277,290
"137","Alford","Berkshire County","MA","Alford","2011","Alford town, MA",12,278,290
"138","Alford","Berkshire County","MA","Alford","2012","Alford town, MA",9,276,285
"139","Amesbury","Essex County","MA","Amesbury","1990","Amesbury Town city, MA",563,7391,7954
"140","Amesbury","Essex County","MA","Amesbury","1991","Amesbury Town city, MA",674,7107,7781
"141","Amesbury","Essex County","MA","Amesbury","1992","Amesbury Town city, MA",655,7097,7752
"142","Amesbury","Essex County","MA","Amesbury","1993","Amesbury Town city, MA",601,7382,7983
"143","Amesbury","Essex County","MA","Amesbury","1994","Amesbury Town city, MA",442,7712,8154
"144","Amesbury","Essex County","MA","Amesbury","1995","Amesbury Town city, MA",383,7623,8006
"145","Amesbury","Essex County","MA","Amesbury","1996","Amesbury Town city, MA",353,7818,8171
"146","Amesbury","Essex County","MA","Amesbury","1997","Amesbury Town city, MA",338,8054,8392
"147","Amesbury","Essex County","MA","Amesbury","1998","Amesbury Town city, MA",286,8220,8506
"148","Amesbury","Essex County","MA","Amesbury","1999","Amesbury Town city, MA",274,8339,8613
"149","Amesbury","Essex County","MA","Amesbury","2000","Amesbury Town city, MA",208,8882,9090
"150","Amesbury","Essex County","MA","Amesbury","2001","Amesbury Town city, MA",323,8828,9151
"151","Amesbury","Essex County","MA","Amesbury","2002","Amesbury Town city, MA",471,8566,9037
"152","Amesbury","Essex County","MA","Amesbury","2003","Amesbury Town city, MA",505,8372,8877
"153","Amesbury","Essex County","MA","Amesbury","2004","Amesbury Town city, MA",438,8279,8717
"154","Amesbury","Essex County","MA","Amesbury","2005","Amesbury Town city, MA",388,8300,8688
"155","Amesbury","Essex County","MA","Amesbury","2006","Amesbury Town city, MA",407,8325,8732
"156","Amesbury","Essex County","MA","Amesbury","2007","Amesbury Town city, MA",373,8280,8653
"157","Amesbury","Essex County","MA","Amesbury","2008","Amesbury Town city, MA",452,8236,8688
"158","Amesbury","Essex County","MA","Amesbury","2009","Amesbury Town city, MA",691,8025,8716
"159","Amesbury","Essex County","MA","Amesbury","2010","Amesbury Town city, MA",706,8016,8722
"160","Amesbury","Essex County","MA","Amesbury","2011","Amesbury Town city, MA",597,8119,8716
"161","Amesbury","Essex County","MA","Amesbury","2012","Amesbury Town city, MA",535,8226,8761
"162","Amherst","Hampshire County","MA","Amherst","1990","Amherst town, MA",752,17229,17981
"163","Amherst","Hampshire County","MA","Amherst","1991","Amherst town, MA",744,16166,16910
"164","Amherst","Hampshire County","MA","Amherst","1992","Amherst town, MA",546,16309,16855
"165","Amherst","Hampshire County","MA","Amherst","1993","Amherst town, MA",455,16674,17129
"166","Amherst","Hampshire County","MA","Amherst","1994","Amherst town, MA",402,16869,17271
"167","Amherst","Hampshire County","MA","Amherst","1995","Amherst town, MA",382,16921,17303
"168","Amherst","Hampshire County","MA","Amherst","1996","Amherst town, MA",324,17187,17511
"169","Amherst","Hampshire County","MA","Amherst","1997","Amherst town, MA",301,17564,17865
"170","Amherst","Hampshire County","MA","Amherst","1998","Amherst town, MA",298,18224,18522
"171","Amherst","Hampshire County","MA","Amherst","1999","Amherst town, MA",279,18309,18588
"172","Amherst","Hampshire County","MA","Amherst","2000","Amherst town, MA",354,17926,18280
"173","Amherst","Hampshire County","MA","Amherst","2001","Amherst town, MA",401,17871,18272
"174","Amherst","Hampshire County","MA","Amherst","2002","Amherst town, MA",498,17884,18382
"175","Amherst","Hampshire County","MA","Amherst","2003","Amherst town, MA",614,18094,18708
"176","Amherst","Hampshire County","MA","Amherst","2004","Amherst town, MA",618,18153,18771
"177","Amherst","Hampshire County","MA","Amherst","2005","Amherst town, MA",639,18087,18726
"178","Amherst","Hampshire County","MA","Amherst","2006","Amherst town, MA",617,18307,18924
"179","Amherst","Hampshire County","MA","Amherst","2007","Amherst town, MA",590,18514,19104
"180","Amherst","Hampshire County","MA","Amherst","2008","Amherst town, MA",745,18538,19283
"181","Amherst","Hampshire County","MA","Amherst","2009","Amherst town, MA",984,18287,19271
"182","Amherst","Hampshire County","MA","Amherst","2010","Amherst town, MA",1077,18640,19717
"183","Amherst","Hampshire County","MA","Amherst","2011","Amherst town, MA",955,18751,19706
"184","Amherst","Hampshire County","MA","Amherst","2012","Amherst town, MA",896,18919,19815
"185","Andover","Essex County","MA","Andover","1990","Andover town, MA",685,14522,15207
"186","Andover","Essex County","MA","Andover","1991","Andover town, MA",997,14413,15410
"187","Andover","Essex County","MA","Andover","1992","Andover town, MA",997,14787,15784
"188","Andover","Essex County","MA","Andover","1993","Andover town, MA",823,15162,15985
"189","Andover","Essex County","MA","Andover","1994","Andover town, MA",807,15630,16437
"190","Andover","Essex County","MA","Andover","1995","Andover town, MA",612,15600,16212
"191","Andover","Essex County","MA","Andover","1996","Andover town, MA",527,16036,16563
"192","Andover","Essex County","MA","Andover","1997","Andover town, MA",520,16204,16724
"193","Andover","Essex County","MA","Andover","1998","Andover town, MA",414,16681,17095
"194","Andover","Essex County","MA","Andover","1999","Andover town, MA",437,17038,17475
"195","Andover","Essex County","MA","Andover","2000","Andover town, MA",337,16032,16369
"196","Andover","Essex County","MA","Andover","2001","Andover town, MA",521,16138,16659
"197","Andover","Essex County","MA","Andover","2002","Andover town, MA",862,15949,16811
"198","Andover","Essex County","MA","Andover","2003","Andover town, MA",865,15755,16620
"199","Andover","Essex County","MA","Andover","2004","Andover town, MA",740,15825,16565
"200","Andover","Essex County","MA","Andover","2005","Andover town, MA",672,16088,16760
"201","Andover","Essex County","MA","Andover","2006","Andover town, MA",691,16039,16730
"202","Andover","Essex County","MA","Andover","2007","Andover town, MA",692,16100,16792
"203","Andover","Essex County","MA","Andover","2008","Andover town, MA",697,16144,16841
"204","Andover","Essex County","MA","Andover","2009","Andover town, MA",1119,15655,16774
"205","Andover","Essex County","MA","Andover","2010","Andover town, MA",1066,15657,16723
"206","Andover","Essex County","MA","Andover","2011","Andover town, MA",952,15845,16797
"207","Andover","Essex County","MA","Andover","2012","Andover town, MA",834,16018,16852
"208","Aquinnah","Dukes County","MA","Aquinnah","1990","Aquinnah town, MA",8,83,91
"209","Aquinnah","Dukes County","MA","Aquinnah","1991","Aquinnah town, MA",21,81,102
"210","Aquinnah","Dukes County","MA","Aquinnah","1992","Aquinnah town, MA",16,76,92
"211","Aquinnah","Dukes County","MA","Aquinnah","1993","Aquinnah town, MA",18,84,102
"212","Aquinnah","Dukes County","MA","Aquinnah","1994","Aquinnah town, MA",12,94,106
"213","Aquinnah","Dukes County","MA","Aquinnah","1995","Aquinnah town, MA",11,98,109
"214","Aquinnah","Dukes County","MA","Aquinnah","1996","Aquinnah town, MA",14,103,117
"215","Aquinnah","Dukes County","MA","Aquinnah","1997","Aquinnah town, MA",17,107,124
"216","Aquinnah","Dukes County","MA","Aquinnah","1998","Aquinnah town, MA",9,102,111
"217","Aquinnah","Dukes County","MA","Aquinnah","1999","Aquinnah town, MA",8,105,113
"218","Aquinnah","Dukes County","MA","Aquinnah","2000","Aquinnah town, MA",5,225,230
"219","Aquinnah","Dukes County","MA","Aquinnah","2001","Aquinnah town, MA",6,225,231
"220","Aquinnah","Dukes County","MA","Aquinnah","2002","Aquinnah town, MA",10,235,245
"221","Aquinnah","Dukes County","MA","Aquinnah","2003","Aquinnah town, MA",17,242,259
"222","Aquinnah","Dukes County","MA","Aquinnah","2004","Aquinnah town, MA",14,245,259
"223","Aquinnah","Dukes County","MA","Aquinnah","2005","Aquinnah town, MA",13,240,253
"224","Aquinnah","Dukes County","MA","Aquinnah","2006","Aquinnah town, MA",12,242,254
"225","Aquinnah","Dukes County","MA","Aquinnah","2007","Aquinnah town, MA",10,246,256
"226","Aquinnah","Dukes County","MA","Aquinnah","2008","Aquinnah town, MA",13,248,261
"227","Aquinnah","Dukes County","MA","Aquinnah","2009","Aquinnah town, MA",12,246,258
"228","Aquinnah","Dukes County","MA","Aquinnah","2010","Aquinnah town, MA",12,202,214
"229","Aquinnah","Dukes County","MA","Aquinnah","2011","Aquinnah town, MA",17,203,220
"230","Aquinnah","Dukes County","MA","Aquinnah","2012","Aquinnah town, MA",9,205,214
"231","Arlington","Middlesex County","MA","Arlington","1990","Arlington town, MA",989,25245,26234
"232","Arlington","Middlesex County","MA","Arlington","1991","Arlington town, MA",1316,24087,25403
"233","Arlington","Middlesex County","MA","Arlington","1992","Arlington town, MA",1413,23857,25270
"234","Arlington","Middlesex County","MA","Arlington","1993","Arlington town, MA",1220,23929,25149
"235","Arlington","Middlesex County","MA","Arlington","1994","Arlington town, MA",981,24239,25220
"236","Arlington","Middlesex County","MA","Arlington","1995","Arlington town, MA",885,24496,25381
"237","Arlington","Middlesex County","MA","Arlington","1996","Arlington town, MA",671,24895,25566
"238","Arlington","Middlesex County","MA","Arlington","1997","Arlington town, MA",621,25406,26027
"239","Arlington","Middlesex County","MA","Arlington","1998","Arlington town, MA",504,25672,26176
"240","Arlington","Middlesex County","MA","Arlington","1999","Arlington town, MA",499,25752,26251
"241","Arlington","Middlesex County","MA","Arlington","2000","Arlington town, MA",508,24778,25286
"242","Arlington","Middlesex County","MA","Arlington","2001","Arlington town, MA",762,24594,25356
"243","Arlington","Middlesex County","MA","Arlington","2002","Arlington town, MA",1181,23996,25177
"244","Arlington","Middlesex County","MA","Arlington","2003","Arlington town, MA",1193,23524,24717
"245","Arlington","Middlesex County","MA","Arlington","2004","Arlington town, MA",930,23393,24323
"246","Arlington","Middlesex County","MA","Arlington","2005","Arlington town, MA",850,23457,24307
"247","Arlington","Middlesex County","MA","Arlington","2006","Arlington town, MA",791,23094,23885
"248","Arlington","Middlesex County","MA","Arlington","2007","Arlington town, MA",756,23264,24020
"249","Arlington","Middlesex County","MA","Arlington","2008","Arlington town, MA",901,23244,24145
"250","Arlington","Middlesex County","MA","Arlington","2009","Arlington town, MA",1462,22652,24114
"251","Arlington","Middlesex County","MA","Arlington","2010","Arlington town, MA",1420,23613,25033
"252","Arlington","Middlesex County","MA","Arlington","2011","Arlington town, MA",1173,23961,25134
"253","Arlington","Middlesex County","MA","Arlington","2012","Arlington town, MA",1067,24224,25291
"254","Ashburnham","Worcester County","MA","Ashburnham","1990","Ashburnham town, MA",255,2705,2960
"255","Ashburnham","Worcester County","MA","Ashburnham","1991","Ashburnham town, MA",316,2699,3015
"256","Ashburnham","Worcester County","MA","Ashburnham","1992","Ashburnham town, MA",256,2731,2987
"257","Ashburnham","Worcester County","MA","Ashburnham","1993","Ashburnham town, MA",211,2863,3074
"258","Ashburnham","Worcester County","MA","Ashburnham","1994","Ashburnham town, MA",188,2860,3048
"259","Ashburnham","Worcester County","MA","Ashburnham","1995","Ashburnham town, MA",177,2694,2871
"260","Ashburnham","Worcester County","MA","Ashburnham","1996","Ashburnham town, MA",164,2701,2865
"261","Ashburnham","Worcester County","MA","Ashburnham","1997","Ashburnham town, MA",152,2768,2920
"262","Ashburnham","Worcester County","MA","Ashburnham","1998","Ashburnham town, MA",105,2775,2880
"263","Ashburnham","Worcester County","MA","Ashburnham","1999","Ashburnham town, MA",110,2790,2900
"264","Ashburnham","Worcester County","MA","Ashburnham","2000","Ashburnham town, MA",82,2940,3022
"265","Ashburnham","Worcester County","MA","Ashburnham","2001","Ashburnham town, MA",126,2934,3060
"266","Ashburnham","Worcester County","MA","Ashburnham","2002","Ashburnham town, MA",183,2931,3114
"267","Ashburnham","Worcester County","MA","Ashburnham","2003","Ashburnham town, MA",200,2947,3147
"268","Ashburnham","Worcester County","MA","Ashburnham","2004","Ashburnham town, MA",198,2952,3150
"269","Ashburnham","Worcester County","MA","Ashburnham","2005","Ashburnham town, MA",179,2959,3138
"270","Ashburnham","Worcester County","MA","Ashburnham","2006","Ashburnham town, MA",180,2993,3173
"271","Ashburnham","Worcester County","MA","Ashburnham","2007","Ashburnham town, MA",172,2987,3159
"272","Ashburnham","Worcester County","MA","Ashburnham","2008","Ashburnham town, MA",195,2954,3149
"273","Ashburnham","Worcester County","MA","Ashburnham","2009","Ashburnham town, MA",291,2830,3121
"274","Ashburnham","Worcester County","MA","Ashburnham","2010","Ashburnham town, MA",305,2899,3204
"275","Ashburnham","Worcester County","MA","Ashburnham","2011","Ashburnham town, MA",279,2898,3177
"276","Ashburnham","Worcester County","MA","Ashburnham","2012","Ashburnham town, MA",239,2896,3135
"277","Ashby","Middlesex County","MA","Ashby","1990","Ashby town, MA",103,1425,1528
"278","Ashby","Middlesex County","MA","Ashby","1991","Ashby town, MA",156,1415,1571
"279","Ashby","Middlesex County","MA","Ashby","1992","Ashby town, MA",124,1458,1582
"280","Ashby","Middlesex County","MA","Ashby","1993","Ashby town, MA",76,1507,1583
"281","Ashby","Middlesex County","MA","Ashby","1994","Ashby town, MA",82,1557,1639
"282","Ashby","Middlesex County","MA","Ashby","1995","Ashby town, MA",75,1502,1577
"283","Ashby","Middlesex County","MA","Ashby","1996","Ashby town, MA",84,1516,1600
"284","Ashby","Middlesex County","MA","Ashby","1997","Ashby town, MA",70,1558,1628
"285","Ashby","Middlesex County","MA","Ashby","1998","Ashby town, MA",55,1564,1619
"286","Ashby","Middlesex County","MA","Ashby","1999","Ashby town, MA",65,1571,1636
"287","Ashby","Middlesex County","MA","Ashby","2000","Ashby town, MA",41,1552,1593
"288","Ashby","Middlesex County","MA","Ashby","2001","Ashby town, MA",56,1537,1593
"289","Ashby","Middlesex County","MA","Ashby","2002","Ashby town, MA",88,1521,1609
"290","Ashby","Middlesex County","MA","Ashby","2003","Ashby town, MA",99,1513,1612
"291","Ashby","Middlesex County","MA","Ashby","2004","Ashby town, MA",96,1509,1605
"292","Ashby","Middlesex County","MA","Ashby","2005","Ashby town, MA",85,1494,1579
"293","Ashby","Middlesex County","MA","Ashby","2006","Ashby town, MA",88,1514,1602
"294","Ashby","Middlesex County","MA","Ashby","2007","Ashby town, MA",81,1522,1603
"295","Ashby","Middlesex County","MA","Ashby","2008","Ashby town, MA",94,1492,1586
"296","Ashby","Middlesex County","MA","Ashby","2009","Ashby town, MA",156,1502,1658
"297","Ashby","Middlesex County","MA","Ashby","2010","Ashby town, MA",154,1511,1665
"298","Ashby","Middlesex County","MA","Ashby","2011","Ashby town, MA",135,1520,1655
"299","Ashby","Middlesex County","MA","Ashby","2012","Ashby town, MA",135,1519,1654
"300","Ashfield","Franklin County","MA","Ashfield","1990","Ashfield town, MA",52,963,1015
"301","Ashfield","Franklin County","MA","Ashfield","1991","Ashfield town, MA",72,955,1027
"302","Ashfield","Franklin County","MA","Ashfield","1992","Ashfield town, MA",58,911,969
"303","Ashfield","Franklin County","MA","Ashfield","1993","Ashfield town, MA",47,938,985
"304","Ashfield","Franklin County","MA","Ashfield","1994","Ashfield town, MA",43,965,1008
"305","Ashfield","Franklin County","MA","Ashfield","1995","Ashfield town, MA",34,979,1013
"306","Ashfield","Franklin County","MA","Ashfield","1996","Ashfield town, MA",39,984,1023
"307","Ashfield","Franklin County","MA","Ashfield","1997","Ashfield town, MA",34,1004,1038
"308","Ashfield","Franklin County","MA","Ashfield","1998","Ashfield town, MA",25,1024,1049
"309","Ashfield","Franklin County","MA","Ashfield","1999","Ashfield town, MA",23,1042,1065
"310","Ashfield","Franklin County","MA","Ashfield","2000","Ashfield town, MA",22,1080,1102
"311","Ashfield","Franklin County","MA","Ashfield","2001","Ashfield town, MA",26,1080,1106
"312","Ashfield","Franklin County","MA","Ashfield","2002","Ashfield town, MA",37,1079,1116
"313","Ashfield","Franklin County","MA","Ashfield","2003","Ashfield town, MA",43,1070,1113
"314","Ashfield","Franklin County","MA","Ashfield","2004","Ashfield town, MA",40,1072,1112
"315","Ashfield","Franklin County","MA","Ashfield","2005","Ashfield town, MA",35,1079,1114
"316","Ashfield","Franklin County","MA","Ashfield","2006","Ashfield town, MA",42,1084,1126
"317","Ashfield","Franklin County","MA","Ashfield","2007","Ashfield town, MA",41,1083,1124
"318","Ashfield","Franklin County","MA","Ashfield","2008","Ashfield town, MA",43,1077,1120
"319","Ashfield","Franklin County","MA","Ashfield","2009","Ashfield town, MA",61,1029,1090
"320","Ashfield","Franklin County","MA","Ashfield","2010","Ashfield town, MA",65,983,1048
"321","Ashfield","Franklin County","MA","Ashfield","2011","Ashfield town, MA",49,975,1024
"322","Ashfield","Franklin County","MA","Ashfield","2012","Ashfield town, MA",47,976,1023
"323","Ashland","Middlesex County","MA","Ashland","1990","Ashland town, MA",399,7188,7587
"324","Ashland","Middlesex County","MA","Ashland","1991","Ashland town, MA",572,7011,7583
"325","Ashland","Middlesex County","MA","Ashland","1992","Ashland town, MA",575,7029,7604
"326","Ashland","Middlesex County","MA","Ashland","1993","Ashland town, MA",468,7232,7700
"327","Ashland","Middlesex County","MA","Ashland","1994","Ashland town, MA",385,7505,7890
"328","Ashland","Middlesex County","MA","Ashland","1995","Ashland town, MA",324,7477,7801
"329","Ashland","Middlesex County","MA","Ashland","1996","Ashland town, MA",280,7734,8014
"330","Ashland","Middlesex County","MA","Ashland","1997","Ashland town, MA",240,8051,8291
"331","Ashland","Middlesex County","MA","Ashland","1998","Ashland town, MA",204,8371,8575
"332","Ashland","Middlesex County","MA","Ashland","1999","Ashland town, MA",215,8630,8845
"333","Ashland","Middlesex County","MA","Ashland","2000","Ashland town, MA",193,8659,8852
"334","Ashland","Middlesex County","MA","Ashland","2001","Ashland town, MA",281,8864,9145
"335","Ashland","Middlesex County","MA","Ashland","2002","Ashland town, MA",454,8763,9217
"336","Ashland","Middlesex County","MA","Ashland","2003","Ashland town, MA",455,8659,9114
"337","Ashland","Middlesex County","MA","Ashland","2004","Ashland town, MA",382,8762,9144
"338","Ashland","Middlesex County","MA","Ashland","2005","Ashland town, MA",343,8914,9257
"339","Ashland","Middlesex County","MA","Ashland","2006","Ashland town, MA",341,9039,9380
"340","Ashland","Middlesex County","MA","Ashland","2007","Ashland town, MA",325,9218,9543
"341","Ashland","Middlesex County","MA","Ashland","2008","Ashland town, MA",396,9309,9705
"342","Ashland","Middlesex County","MA","Ashland","2009","Ashland town, MA",638,8638,9276
"343","Ashland","Middlesex County","MA","Ashland","2010","Ashland town, MA",587,9223,9810
"344","Ashland","Middlesex County","MA","Ashland","2011","Ashland town, MA",491,9315,9806
"345","Ashland","Middlesex County","MA","Ashland","2012","Ashland town, MA",471,9400,9871
"346","Athol","Worcester County","MA","Athol","1990","Athol town, MA",531,4734,5265
"347","Athol","Worcester County","MA","Athol","1991","Athol town, MA",765,4475,5240
"348","Athol","Worcester County","MA","Athol","1992","Athol town, MA",723,4441,5164
"349","Athol","Worcester County","MA","Athol","1993","Athol town, MA",542,4610,5152
"350","Athol","Worcester County","MA","Athol","1994","Athol town, MA",445,4544,4989
"351","Athol","Worcester County","MA","Athol","1995","Athol town, MA",372,4331,4703
"352","Athol","Worcester County","MA","Athol","1996","Athol town, MA",326,4271,4597
"353","Athol","Worcester County","MA","Athol","1997","Athol town, MA",328,4345,4673
"354","Athol","Worcester County","MA","Athol","1998","Athol town, MA",265,4387,4652
"355","Athol","Worcester County","MA","Athol","1999","Athol town, MA",251,4368,4619
"356","Athol","Worcester County","MA","Athol","2000","Athol town, MA",170,5239,5409
"357","Athol","Worcester County","MA","Athol","2001","Athol town, MA",248,5150,5398
"358","Athol","Worcester County","MA","Athol","2002","Athol town, MA",331,5165,5496
"359","Athol","Worcester County","MA","Athol","2003","Athol town, MA",391,5125,5516
"360","Athol","Worcester County","MA","Athol","2004","Athol town, MA",360,5061,5421
"361","Athol","Worcester County","MA","Athol","2005","Athol town, MA",326,5022,5348
"362","Athol","Worcester County","MA","Athol","2006","Athol town, MA",327,4982,5309
"363","Athol","Worcester County","MA","Athol","2007","Athol town, MA",349,4931,5280
"364","Athol","Worcester County","MA","Athol","2008","Athol town, MA",386,4973,5359
"365","Athol","Worcester County","MA","Athol","2009","Athol town, MA",605,4880,5485
"366","Athol","Worcester County","MA","Athol","2010","Athol town, MA",614,4720,5334
"367","Athol","Worcester County","MA","Athol","2011","Athol town, MA",528,4711,5239
"368","Athol","Worcester County","MA","Athol","2012","Athol town, MA",478,4727,5205
"369","Attleboro","Bristol County","MA","Attleboro","1990","Attleboro city, MA",1656,19919,21575
"370","Attleboro","Bristol County","MA","Attleboro","1991","Attleboro city, MA",2485,19164,21649
"371","Attleboro","Bristol County","MA","Attleboro","1992","Attleboro city, MA",2365,19259,21624
"372","Attleboro","Bristol County","MA","Attleboro","1993","Attleboro city, MA",1788,19685,21473
"373","Attleboro","Bristol County","MA","Attleboro","1994","Attleboro city, MA",1616,20056,21672
"374","Attleboro","Bristol County","MA","Attleboro","1995","Attleboro city, MA",1509,20279,21788
"375","Attleboro","Bristol County","MA","Attleboro","1996","Attleboro city, MA",1255,20441,21696
"376","Attleboro","Bristol County","MA","Attleboro","1997","Attleboro city, MA",1146,20910,22056
"377","Attleboro","Bristol County","MA","Attleboro","1998","Attleboro city, MA",868,21292,22160
"378","Attleboro","Bristol County","MA","Attleboro","1999","Attleboro city, MA",781,21560,22341
"379","Attleboro","Bristol County","MA","Attleboro","2000","Attleboro city, MA",773,22870,23643
"380","Attleboro","Bristol County","MA","Attleboro","2001","Attleboro city, MA",1099,22824,23923
"381","Attleboro","Bristol County","MA","Attleboro","2002","Attleboro city, MA",1468,23113,24581
"382","Attleboro","Bristol County","MA","Attleboro","2003","Attleboro city, MA",1454,23339,24793
"383","Attleboro","Bristol County","MA","Attleboro","2004","Attleboro city, MA",1406,23394,24800
"384","Attleboro","Bristol County","MA","Attleboro","2005","Attleboro city, MA",1328,23491,24819
"385","Attleboro","Bristol County","MA","Attleboro","2006","Attleboro city, MA",1290,23682,24972
"386","Attleboro","Bristol County","MA","Attleboro","2007","Attleboro city, MA",1220,23649,24869
"387","Attleboro","Bristol County","MA","Attleboro","2008","Attleboro city, MA",1588,23145,24733
"388","Attleboro","Bristol County","MA","Attleboro","2009","Attleboro city, MA",2605,22453,25058
"389","Attleboro","Bristol County","MA","Attleboro","2010","Attleboro city, MA",2515,22387,24902
"390","Attleboro","Bristol County","MA","Attleboro","2011","Attleboro city, MA",2309,22551,24860
"391","Attleboro","Bristol County","MA","Attleboro","2012","Attleboro city, MA",2220,22586,24806
"392","Auburn","Worcester County","MA","Auburn","1990","Auburn town, MA",591,7929,8520
"393","Auburn","Worcester County","MA","Auburn","1991","Auburn town, MA",737,7718,8455
"394","Auburn","Worcester County","MA","Auburn","1992","Auburn town, MA",655,7696,8351
"395","Auburn","Worcester County","MA","Auburn","1993","Auburn town, MA",497,7848,8345
"396","Auburn","Worcester County","MA","Auburn","1994","Auburn town, MA",395,8017,8412
"397","Auburn","Worcester County","MA","Auburn","1995","Auburn town, MA",359,7879,8238
"398","Auburn","Worcester County","MA","Auburn","1996","Auburn town, MA",294,7986,8280
"399","Auburn","Worcester County","MA","Auburn","1997","Auburn town, MA",262,8258,8520
"400","Auburn","Worcester County","MA","Auburn","1998","Auburn town, MA",227,8558,8785
"401","Auburn","Worcester County","MA","Auburn","1999","Auburn town, MA",220,8628,8848
"402","Auburn","Worcester County","MA","Auburn","2000","Auburn town, MA",220,8484,8704
"403","Auburn","Worcester County","MA","Auburn","2001","Auburn town, MA",260,8497,8757
"404","Auburn","Worcester County","MA","Auburn","2002","Auburn town, MA",429,8459,8888
"405","Auburn","Worcester County","MA","Auburn","2003","Auburn town, MA",481,8443,8924
"406","Auburn","Worcester County","MA","Auburn","2004","Auburn town, MA",413,8427,8840
"407","Auburn","Worcester County","MA","Auburn","2005","Auburn town, MA",381,8411,8792
"408","Auburn","Worcester County","MA","Auburn","2006","Auburn town, MA",363,8454,8817
"409","Auburn","Worcester County","MA","Auburn","2007","Auburn town, MA",384,8456,8840
"410","Auburn","Worcester County","MA","Auburn","2008","Auburn town, MA",428,8289,8717
"411","Auburn","Worcester County","MA","Auburn","2009","Auburn town, MA",698,8058,8756
"412","Auburn","Worcester County","MA","Auburn","2010","Auburn town, MA",713,7947,8660
"413","Auburn","Worcester County","MA","Auburn","2011","Auburn town, MA",602,8017,8619
"414","Auburn","Worcester County","MA","Auburn","2012","Auburn town, MA",593,8015,8608
"415","Avon","Norfolk County","MA","Avon","1990","Avon town, MA",187,2344,2531
"416","Avon","Norfolk County","MA","Avon","1991","Avon town, MA",311,2247,2558
"417","Avon","Norfolk County","MA","Avon","1992","Avon town, MA",280,2220,2500
"418","Avon","Norfolk County","MA","Avon","1993","Avon town, MA",202,2271,2473
"419","Avon","Norfolk County","MA","Avon","1994","Avon town, MA",194,2343,2537
"420","Avon","Norfolk County","MA","Avon","1995","Avon town, MA",163,2425,2588
"421","Avon","Norfolk County","MA","Avon","1996","Avon town, MA",154,2433,2587
"422","Avon","Norfolk County","MA","Avon","1997","Avon town, MA",126,2491,2617
"423","Avon","Norfolk County","MA","Avon","1998","Avon town, MA",98,2497,2595
"424","Avon","Norfolk County","MA","Avon","1999","Avon town, MA",88,2509,2597
"425","Avon","Norfolk County","MA","Avon","2000","Avon town, MA",68,2302,2370
"426","Avon","Norfolk County","MA","Avon","2001","Avon town, MA",82,2281,2363
"427","Avon","Norfolk County","MA","Avon","2002","Avon town, MA",126,2232,2358
"428","Avon","Norfolk County","MA","Avon","2003","Avon town, MA",146,2165,2311
"429","Avon","Norfolk County","MA","Avon","2004","Avon town, MA",134,2148,2282
"430","Avon","Norfolk County","MA","Avon","2005","Avon town, MA",126,2133,2259
"431","Avon","Norfolk County","MA","Avon","2006","Avon town, MA",124,2154,2278
"432","Avon","Norfolk County","MA","Avon","2007","Avon town, MA",118,2172,2290
"433","Avon","Norfolk County","MA","Avon","2008","Avon town, MA",139,2155,2294
"434","Avon","Norfolk County","MA","Avon","2009","Avon town, MA",229,2119,2348
"435","Avon","Norfolk County","MA","Avon","2010","Avon town, MA",212,2107,2319
"436","Avon","Norfolk County","MA","Avon","2011","Avon town, MA",180,2131,2311
"437","Avon","Norfolk County","MA","Avon","2012","Avon town, MA",162,2149,2311
"438","Ayer","Middlesex County","MA","Ayer","1990","Ayer town, MA",241,3325,3566
"439","Ayer","Middlesex County","MA","Ayer","1991","Ayer town, MA",338,3249,3587
"440","Ayer","Middlesex County","MA","Ayer","1992","Ayer town, MA",325,3243,3568
"441","Ayer","Middlesex County","MA","Ayer","1993","Ayer town, MA",300,3295,3595
"442","Ayer","Middlesex County","MA","Ayer","1994","Ayer town, MA",273,3367,3640
"443","Ayer","Middlesex County","MA","Ayer","1995","Ayer town, MA",227,3480,3707
"444","Ayer","Middlesex County","MA","Ayer","1996","Ayer town, MA",174,3587,3761
"445","Ayer","Middlesex County","MA","Ayer","1997","Ayer town, MA",133,3706,3839
"446","Ayer","Middlesex County","MA","Ayer","1998","Ayer town, MA",126,3761,3887
"447","Ayer","Middlesex County","MA","Ayer","1999","Ayer town, MA",133,3856,3989
"448","Ayer","Middlesex County","MA","Ayer","2000","Ayer town, MA",99,4090,4189
"449","Ayer","Middlesex County","MA","Ayer","2001","Ayer town, MA",163,4083,4246
"450","Ayer","Middlesex County","MA","Ayer","2002","Ayer town, MA",237,3993,4230
"451","Ayer","Middlesex County","MA","Ayer","2003","Ayer town, MA",260,3913,4173
"452","Ayer","Middlesex County","MA","Ayer","2004","Ayer town, MA",216,3895,4111
"453","Ayer","Middlesex County","MA","Ayer","2005","Ayer town, MA",213,3945,4158
"454","Ayer","Middlesex County","MA","Ayer","2006","Ayer town, MA",190,4018,4208
"455","Ayer","Middlesex County","MA","Ayer","2007","Ayer town, MA",188,4140,4328
"456","Ayer","Middlesex County","MA","Ayer","2008","Ayer town, MA",227,4174,4401
"457","Ayer","Middlesex County","MA","Ayer","2009","Ayer town, MA",349,4091,4440
"458","Ayer","Middlesex County","MA","Ayer","2010","Ayer town, MA",352,3926,4278
"459","Ayer","Middlesex County","MA","Ayer","2011","Ayer town, MA",312,3982,4294
"460","Ayer","Middlesex County","MA","Ayer","2012","Ayer town, MA",277,4026,4303
"461","Barnstable","Barnstable County","MA","Barnstable","1990","Barnstable Town city, MA",2023,20340,22363
"462","Barnstable","Barnstable County","MA","Barnstable","1991","Barnstable Town city, MA",2390,19553,21943
"463","Barnstable","Barnstable County","MA","Barnstable","1992","Barnstable Town city, MA",2268,19351,21619
"464","Barnstable","Barnstable County","MA","Barnstable","1993","Barnstable Town city, MA",1965,19866,21831
"465","Barnstable","Barnstable County","MA","Barnstable","1994","Barnstable Town city, MA",1761,20265,22026
"466","Barnstable","Barnstable County","MA","Barnstable","1995","Barnstable Town city, MA",1378,20986,22364
"467","Barnstable","Barnstable County","MA","Barnstable","1996","Barnstable Town city, MA",1255,21461,22716
"468","Barnstable","Barnstable County","MA","Barnstable","1997","Barnstable Town city, MA",1164,21887,23051
"469","Barnstable","Barnstable County","MA","Barnstable","1998","Barnstable Town city, MA",942,22396,23338
"470","Barnstable","Barnstable County","MA","Barnstable","1999","Barnstable Town city, MA",857,23212,24069
"471","Barnstable","Barnstable County","MA","Barnstable","2000","Barnstable Town city, MA",762,24628,25390
"472","Barnstable","Barnstable County","MA","Barnstable","2001","Barnstable Town city, MA",873,24817,25690
"473","Barnstable","Barnstable County","MA","Barnstable","2002","Barnstable Town city, MA",1115,25248,26363
"474","Barnstable","Barnstable County","MA","Barnstable","2003","Barnstable Town city, MA",1265,25677,26942
"475","Barnstable","Barnstable County","MA","Barnstable","2004","Barnstable Town city, MA",1217,25854,27071
"476","Barnstable","Barnstable County","MA","Barnstable","2005","Barnstable Town city, MA",1204,25626,26830
"477","Barnstable","Barnstable County","MA","Barnstable","2006","Barnstable Town city, MA",1190,25631,26821
"478","Barnstable","Barnstable County","MA","Barnstable","2007","Barnstable Town city, MA",1125,25430,26555
"479","Barnstable","Barnstable County","MA","Barnstable","2008","Barnstable Town city, MA",1370,25098,26468
"480","Barnstable","Barnstable County","MA","Barnstable","2009","Barnstable Town city, MA",2070,24449,26519
"481","Barnstable","Barnstable County","MA","Barnstable","2010","Barnstable Town city, MA",2126,24215,26341
"482","Barnstable","Barnstable County","MA","Barnstable","2011","Barnstable Town city, MA",1907,24174,26081
"483","Barnstable","Barnstable County","MA","Barnstable","2012","Barnstable Town city, MA",1748,24579,26327
"484",NA,"Barnstable County","MA","Barnstable County","1990","Barnstable County, MA",7220,90285,97505
"485",NA,"Barnstable County","MA","Barnstable County","1991","Barnstable County, MA",10034,87680,97714
"486",NA,"Barnstable County","MA","Barnstable County","1992","Barnstable County, MA",10512,87131,97643
"487",NA,"Barnstable County","MA","Barnstable County","1993","Barnstable County, MA",9481,90495,99976
"488",NA,"Barnstable County","MA","Barnstable County","1994","Barnstable County, MA",8667,92498,101165
"489",NA,"Barnstable County","MA","Barnstable County","1995","Barnstable County, MA",7378,95070,102448
"490",NA,"Barnstable County","MA","Barnstable County","1996","Barnstable County, MA",6432,97295,103727
"491",NA,"Barnstable County","MA","Barnstable County","1997","Barnstable County, MA",6220,99207,105427
"492",NA,"Barnstable County","MA","Barnstable County","1998","Barnstable County, MA",5347,101312,106659
"493",NA,"Barnstable County","MA","Barnstable County","1999","Barnstable County, MA",4754,104664,109418
"494",NA,"Barnstable County","MA","Barnstable County","2000","Barnstable County, MA",3919,109564,113483
"495",NA,"Barnstable County","MA","Barnstable County","2001","Barnstable County, MA",4454,110854,115308
"496",NA,"Barnstable County","MA","Barnstable County","2002","Barnstable County, MA",5592,113093,118685
"497",NA,"Barnstable County","MA","Barnstable County","2003","Barnstable County, MA",6414,115428,121842
"498",NA,"Barnstable County","MA","Barnstable County","2004","Barnstable County, MA",6199,116532,122731
"499",NA,"Barnstable County","MA","Barnstable County","2005","Barnstable County, MA",6005,116107,122112
"500",NA,"Barnstable County","MA","Barnstable County","2006","Barnstable County, MA",6079,116354,122433
"501",NA,"Barnstable County","MA","Barnstable County","2007","Barnstable County, MA",5822,115658,121480
"502",NA,"Barnstable County","MA","Barnstable County","2008","Barnstable County, MA",7114,114928,122042
"503",NA,"Barnstable County","MA","Barnstable County","2009","Barnstable County, MA",10284,111792,122076
"504",NA,"Barnstable County","MA","Barnstable County","2010","Barnstable County, MA",10896,110726,121622
"505",NA,"Barnstable County","MA","Barnstable County","2011","Barnstable County, MA",9843,110543,120386
"506",NA,"Barnstable County","MA","Barnstable County","2012","Barnstable County, MA",8953,112398,121351
"507","Barre","Worcester County","MA","Barre","1990","Barre town, MA",197,2137,2334
"508","Barre","Worcester County","MA","Barre","1991","Barre town, MA",267,2086,2353
"509","Barre","Worcester County","MA","Barre","1992","Barre town, MA",277,2121,2398
"510","Barre","Worcester County","MA","Barre","1993","Barre town, MA",213,2202,2415
"511","Barre","Worcester County","MA","Barre","1994","Barre town, MA",164,2229,2393
"512","Barre","Worcester County","MA","Barre","1995","Barre town, MA",129,2203,2332
"513","Barre","Worcester County","MA","Barre","1996","Barre town, MA",100,2251,2351
"514","Barre","Worcester County","MA","Barre","1997","Barre town, MA",117,2325,2442
"515","Barre","Worcester County","MA","Barre","1998","Barre town, MA",107,2389,2496
"516","Barre","Worcester County","MA","Barre","1999","Barre town, MA",90,2388,2478
"517","Barre","Worcester County","MA","Barre","2000","Barre town, MA",81,2566,2647
"518","Barre","Worcester County","MA","Barre","2001","Barre town, MA",109,2588,2697
"519","Barre","Worcester County","MA","Barre","2002","Barre town, MA",160,2585,2745
"520","Barre","Worcester County","MA","Barre","2003","Barre town, MA",174,2587,2761
"521","Barre","Worcester County","MA","Barre","2004","Barre town, MA",171,2587,2758
"522","Barre","Worcester County","MA","Barre","2005","Barre town, MA",152,2590,2742
"523","Barre","Worcester County","MA","Barre","2006","Barre town, MA",150,2694,2844
"524","Barre","Worcester County","MA","Barre","2007","Barre town, MA",154,2708,2862
"525","Barre","Worcester County","MA","Barre","2008","Barre town, MA",184,2649,2833
"526","Barre","Worcester County","MA","Barre","2009","Barre town, MA",271,2578,2849
"527","Barre","Worcester County","MA","Barre","2010","Barre town, MA",279,2487,2766
"528","Barre","Worcester County","MA","Barre","2011","Barre town, MA",240,2509,2749
"529","Barre","Worcester County","MA","Barre","2012","Barre town, MA",227,2508,2735
"530","Becket","Berkshire County","MA","Becket","1990","Becket town, MA",43,715,758
"531","Becket","Berkshire County","MA","Becket","1991","Becket town, MA",73,696,769
"532","Becket","Berkshire County","MA","Becket","1992","Becket town, MA",60,764,824
"533","Becket","Berkshire County","MA","Becket","1993","Becket town, MA",45,784,829
"534","Becket","Berkshire County","MA","Becket","1994","Becket town, MA",47,863,910
"535","Becket","Berkshire County","MA","Becket","1995","Becket town, MA",47,848,895
"536","Becket","Berkshire County","MA","Becket","1996","Becket town, MA",35,825,860
"537","Becket","Berkshire County","MA","Becket","1997","Becket town, MA",50,832,882
"538","Becket","Berkshire County","MA","Becket","1998","Becket town, MA",36,878,914
"539","Becket","Berkshire County","MA","Becket","1999","Becket town, MA",27,949,976
"540","Becket","Berkshire County","MA","Becket","2000","Becket town, MA",22,907,929
"541","Becket","Berkshire County","MA","Becket","2001","Becket town, MA",25,906,931
"542","Becket","Berkshire County","MA","Becket","2002","Becket town, MA",30,923,953
"543","Becket","Berkshire County","MA","Becket","2003","Becket town, MA",41,928,969
"544","Becket","Berkshire County","MA","Becket","2004","Becket town, MA",38,937,975
"545","Becket","Berkshire County","MA","Becket","2005","Becket town, MA",41,959,1000
"546","Becket","Berkshire County","MA","Becket","2006","Becket town, MA",46,988,1034
"547","Becket","Berkshire County","MA","Becket","2007","Becket town, MA",49,990,1039
"548","Becket","Berkshire County","MA","Becket","2008","Becket town, MA",61,985,1046
"549","Becket","Berkshire County","MA","Becket","2009","Becket town, MA",96,958,1054
"550","Becket","Berkshire County","MA","Becket","2010","Becket town, MA",94,912,1006
"551","Becket","Berkshire County","MA","Becket","2011","Becket town, MA",78,920,998
"552","Becket","Berkshire County","MA","Becket","2012","Becket town, MA",74,915,989
"553","Bedford","Middlesex County","MA","Bedford","1990","Bedford town, MA",302,6643,6945
"554","Bedford","Middlesex County","MA","Bedford","1991","Bedford town, MA",397,6555,6952
"555","Bedford","Middlesex County","MA","Bedford","1992","Bedford town, MA",428,6401,6829
"556","Bedford","Middlesex County","MA","Bedford","1993","Bedford town, MA",345,6290,6635
"557","Bedford","Middlesex County","MA","Bedford","1994","Bedford town, MA",284,6405,6689
"558","Bedford","Middlesex County","MA","Bedford","1995","Bedford town, MA",246,6834,7080
"559","Bedford","Middlesex County","MA","Bedford","1996","Bedford town, MA",214,7043,7257
"560","Bedford","Middlesex County","MA","Bedford","1997","Bedford town, MA",162,7270,7432
"561","Bedford","Middlesex County","MA","Bedford","1998","Bedford town, MA",146,7328,7474
"562","Bedford","Middlesex County","MA","Bedford","1999","Bedford town, MA",145,7412,7557
"563","Bedford","Middlesex County","MA","Bedford","2000","Bedford town, MA",158,6548,6706
"564","Bedford","Middlesex County","MA","Bedford","2001","Bedford town, MA",237,6532,6769
"565","Bedford","Middlesex County","MA","Bedford","2002","Bedford town, MA",351,6366,6717
"566","Bedford","Middlesex County","MA","Bedford","2003","Bedford town, MA",358,6274,6632
"567","Bedford","Middlesex County","MA","Bedford","2004","Bedford town, MA",274,6258,6532
"568","Bedford","Middlesex County","MA","Bedford","2005","Bedford town, MA",241,6300,6541
"569","Bedford","Middlesex County","MA","Bedford","2006","Bedford town, MA",257,6403,6660
"570","Bedford","Middlesex County","MA","Bedford","2007","Bedford town, MA",221,6571,6792
"571","Bedford","Middlesex County","MA","Bedford","2008","Bedford town, MA",287,6809,7096
"572","Bedford","Middlesex County","MA","Bedford","2009","Bedford town, MA",446,6663,7109
"573","Bedford","Middlesex County","MA","Bedford","2010","Bedford town, MA",417,6522,6939
"574","Bedford","Middlesex County","MA","Bedford","2011","Bedford town, MA",398,6616,7014
"575","Bedford","Middlesex County","MA","Bedford","2012","Bedford town, MA",350,6689,7039
"576","Belchertown","Hampshire County","MA","Belchertown","1990","Belchertown town, MA",298,5711,6009
"577","Belchertown","Hampshire County","MA","Belchertown","1991","Belchertown town, MA",425,5647,6072
"578","Belchertown","Hampshire County","MA","Belchertown","1992","Belchertown town, MA",460,5706,6166
"579","Belchertown","Hampshire County","MA","Belchertown","1993","Belchertown town, MA",406,5777,6183
"580","Belchertown","Hampshire County","MA","Belchertown","1994","Belchertown town, MA",338,6029,6367
"581","Belchertown","Hampshire County","MA","Belchertown","1995","Belchertown town, MA",262,5987,6249
"582","Belchertown","Hampshire County","MA","Belchertown","1996","Belchertown town, MA",215,6162,6377
"583","Belchertown","Hampshire County","MA","Belchertown","1997","Belchertown town, MA",204,6362,6566
"584","Belchertown","Hampshire County","MA","Belchertown","1998","Belchertown town, MA",197,6486,6683
"585","Belchertown","Hampshire County","MA","Belchertown","1999","Belchertown town, MA",180,6621,6801
"586","Belchertown","Hampshire County","MA","Belchertown","2000","Belchertown town, MA",161,7468,7629
"587","Belchertown","Hampshire County","MA","Belchertown","2001","Belchertown town, MA",202,7563,7765
"588","Belchertown","Hampshire County","MA","Belchertown","2002","Belchertown town, MA",286,7630,7916
"589","Belchertown","Hampshire County","MA","Belchertown","2003","Belchertown town, MA",349,7670,8019
"590","Belchertown","Hampshire County","MA","Belchertown","2004","Belchertown town, MA",371,7777,8148
"591","Belchertown","Hampshire County","MA","Belchertown","2005","Belchertown town, MA",422,7881,8303
"592","Belchertown","Hampshire County","MA","Belchertown","2006","Belchertown town, MA",380,8018,8398
"593","Belchertown","Hampshire County","MA","Belchertown","2007","Belchertown town, MA",326,7965,8291
"594","Belchertown","Hampshire County","MA","Belchertown","2008","Belchertown town, MA",358,8041,8399
"595","Belchertown","Hampshire County","MA","Belchertown","2009","Belchertown town, MA",514,7696,8210
"596","Belchertown","Hampshire County","MA","Belchertown","2010","Belchertown town, MA",574,7920,8494
"597","Belchertown","Hampshire County","MA","Belchertown","2011","Belchertown town, MA",474,7820,8294
"598","Belchertown","Hampshire County","MA","Belchertown","2012","Belchertown town, MA",458,7825,8283
"599","Bellingham","Norfolk County","MA","Bellingham","1990","Bellingham town, MA",668,8212,8880
"600","Bellingham","Norfolk County","MA","Bellingham","1991","Bellingham town, MA",860,7973,8833
"601","Bellingham","Norfolk County","MA","Bellingham","1992","Bellingham town, MA",794,7931,8725
"602","Bellingham","Norfolk County","MA","Bellingham","1993","Bellingham town, MA",649,8069,8718
"603","Bellingham","Norfolk County","MA","Bellingham","1994","Bellingham town, MA",552,8235,8787
"604","Bellingham","Norfolk County","MA","Bellingham","1995","Bellingham town, MA",504,8419,8923
"605","Bellingham","Norfolk County","MA","Bellingham","1996","Bellingham town, MA",419,8616,9035
"606","Bellingham","Norfolk County","MA","Bellingham","1997","Bellingham town, MA",387,8883,9270
"607","Bellingham","Norfolk County","MA","Bellingham","1998","Bellingham town, MA",288,9086,9374
"608","Bellingham","Norfolk County","MA","Bellingham","1999","Bellingham town, MA",296,9246,9542
"609","Bellingham","Norfolk County","MA","Bellingham","2000","Bellingham town, MA",262,8926,9188
"610","Bellingham","Norfolk County","MA","Bellingham","2001","Bellingham town, MA",373,8896,9269
"611","Bellingham","Norfolk County","MA","Bellingham","2002","Bellingham town, MA",508,8933,9441
"612","Bellingham","Norfolk County","MA","Bellingham","2003","Bellingham town, MA",546,9034,9580
"613","Bellingham","Norfolk County","MA","Bellingham","2004","Bellingham town, MA",478,9103,9581
"614","Bellingham","Norfolk County","MA","Bellingham","2005","Bellingham town, MA",436,9174,9610
"615","Bellingham","Norfolk County","MA","Bellingham","2006","Bellingham town, MA",473,9335,9808
"616","Bellingham","Norfolk County","MA","Bellingham","2007","Bellingham town, MA",449,9365,9814
"617","Bellingham","Norfolk County","MA","Bellingham","2008","Bellingham town, MA",563,9222,9785
"618","Bellingham","Norfolk County","MA","Bellingham","2009","Bellingham town, MA",943,8767,9710
"619","Bellingham","Norfolk County","MA","Bellingham","2010","Bellingham town, MA",991,9002,9993
"620","Bellingham","Norfolk County","MA","Bellingham","2011","Bellingham town, MA",895,9121,10016
"621","Bellingham","Norfolk County","MA","Bellingham","2012","Bellingham town, MA",815,9135,9950
"622","Belmont","Middlesex County","MA","Belmont","1990","Belmont town, MA",437,13097,13534
"623","Belmont","Middlesex County","MA","Belmont","1991","Belmont town, MA",599,12484,13083
"624","Belmont","Middlesex County","MA","Belmont","1992","Belmont town, MA",589,12347,12936
"625","Belmont","Middlesex County","MA","Belmont","1993","Belmont town, MA",549,12524,13073
"626","Belmont","Middlesex County","MA","Belmont","1994","Belmont town, MA",481,12652,13133
"627","Belmont","Middlesex County","MA","Belmont","1995","Belmont town, MA",396,12631,13027
"628","Belmont","Middlesex County","MA","Belmont","1996","Belmont town, MA",327,12827,13154
"629","Belmont","Middlesex County","MA","Belmont","1997","Belmont town, MA",271,13084,13355
"630","Belmont","Middlesex County","MA","Belmont","1998","Belmont town, MA",208,13166,13374
"631","Belmont","Middlesex County","MA","Belmont","1999","Belmont town, MA",226,13214,13440
"632","Belmont","Middlesex County","MA","Belmont","2000","Belmont town, MA",246,13124,13370
"633","Belmont","Middlesex County","MA","Belmont","2001","Belmont town, MA",400,13022,13422
"634","Belmont","Middlesex County","MA","Belmont","2002","Belmont town, MA",552,12713,13265
"635","Belmont","Middlesex County","MA","Belmont","2003","Belmont town, MA",590,12436,13026
"636","Belmont","Middlesex County","MA","Belmont","2004","Belmont town, MA",447,12335,12782
"637","Belmont","Middlesex County","MA","Belmont","2005","Belmont town, MA",409,12342,12751
"638","Belmont","Middlesex County","MA","Belmont","2006","Belmont town, MA",401,12147,12548
"639","Belmont","Middlesex County","MA","Belmont","2007","Belmont town, MA",367,12237,12604
"640","Belmont","Middlesex County","MA","Belmont","2008","Belmont town, MA",450,12248,12698
"641","Belmont","Middlesex County","MA","Belmont","2009","Belmont town, MA",730,11955,12685
"642","Belmont","Middlesex County","MA","Belmont","2010","Belmont town, MA",740,12649,13389
"643","Belmont","Middlesex County","MA","Belmont","2011","Belmont town, MA",628,12836,13464
"644","Belmont","Middlesex County","MA","Belmont","2012","Belmont town, MA",599,12977,13576
"645","Berkley","Bristol County","MA","Berkley","1990","Berkley town, MA",174,2226,2400
"646","Berkley","Bristol County","MA","Berkley","1991","Berkley town, MA",251,2268,2519
"647","Berkley","Bristol County","MA","Berkley","1992","Berkley town, MA",248,2384,2632
"648","Berkley","Bristol County","MA","Berkley","1993","Berkley town, MA",201,2568,2769
"649","Berkley","Bristol County","MA","Berkley","1994","Berkley town, MA",189,2779,2968
"650","Berkley","Bristol County","MA","Berkley","1995","Berkley town, MA",165,2627,2792
"651","Berkley","Bristol County","MA","Berkley","1996","Berkley town, MA",143,2727,2870
"652","Berkley","Bristol County","MA","Berkley","1997","Berkley town, MA",138,2833,2971
"653","Berkley","Bristol County","MA","Berkley","1998","Berkley town, MA",104,2918,3022
"654","Berkley","Bristol County","MA","Berkley","1999","Berkley town, MA",93,2984,3077
"655","Berkley","Bristol County","MA","Berkley","2000","Berkley town, MA",76,3263,3339
"656","Berkley","Bristol County","MA","Berkley","2001","Berkley town, MA",100,3319,3419
"657","Berkley","Bristol County","MA","Berkley","2002","Berkley town, MA",138,3415,3553
"658","Berkley","Bristol County","MA","Berkley","2003","Berkley town, MA",174,3466,3640
"659","Berkley","Bristol County","MA","Berkley","2004","Berkley town, MA",159,3480,3639
"660","Berkley","Bristol County","MA","Berkley","2005","Berkley town, MA",157,3557,3714
"661","Berkley","Bristol County","MA","Berkley","2006","Berkley town, MA",161,3610,3771
"662","Berkley","Bristol County","MA","Berkley","2007","Berkley town, MA",152,3665,3817
"663","Berkley","Bristol County","MA","Berkley","2008","Berkley town, MA",200,3676,3876
"664","Berkley","Bristol County","MA","Berkley","2009","Berkley town, MA",305,3569,3874
"665","Berkley","Bristol County","MA","Berkley","2010","Berkley town, MA",307,3494,3801
"666","Berkley","Bristol County","MA","Berkley","2011","Berkley town, MA",269,3530,3799
"667","Berkley","Bristol County","MA","Berkley","2012","Berkley town, MA",253,3519,3772
"668",NA,"Berkshire County","MA","Berkshire County","1990","Berkshire County, MA",4959,64944,69903
"669",NA,"Berkshire County","MA","Berkshire County","1991","Berkshire County, MA",7579,62120,69699
"670",NA,"Berkshire County","MA","Berkshire County","1992","Berkshire County, MA",7319,61249,68568
"671",NA,"Berkshire County","MA","Berkshire County","1993","Berkshire County, MA",5818,62126,67944
"672",NA,"Berkshire County","MA","Berkshire County","1994","Berkshire County, MA",5162,61842,67004
"673",NA,"Berkshire County","MA","Berkshire County","1995","Berkshire County, MA",4186,61898,66084
"674",NA,"Berkshire County","MA","Berkshire County","1996","Berkshire County, MA",3454,62717,66171
"675",NA,"Berkshire County","MA","Berkshire County","1997","Berkshire County, MA",3278,63296,66574
"676",NA,"Berkshire County","MA","Berkshire County","1998","Berkshire County, MA",2632,63487,66119
"677",NA,"Berkshire County","MA","Berkshire County","1999","Berkshire County, MA",2541,63818,66359
"678",NA,"Berkshire County","MA","Berkshire County","2000","Berkshire County, MA",2068,68092,70160
"679",NA,"Berkshire County","MA","Berkshire County","2001","Berkshire County, MA",2492,68590,71082
"680",NA,"Berkshire County","MA","Berkshire County","2002","Berkshire County, MA",3311,69395,72706
"681",NA,"Berkshire County","MA","Berkshire County","2003","Berkshire County, MA",3696,68958,72654
"682",NA,"Berkshire County","MA","Berkshire County","2004","Berkshire County, MA",3420,68705,72125
"683",NA,"Berkshire County","MA","Berkshire County","2005","Berkshire County, MA",3161,69485,72646
"684",NA,"Berkshire County","MA","Berkshire County","2006","Berkshire County, MA",3175,70292,73467
"685",NA,"Berkshire County","MA","Berkshire County","2007","Berkshire County, MA",3212,69717,72929
"686",NA,"Berkshire County","MA","Berkshire County","2008","Berkshire County, MA",3767,69288,73055
"687",NA,"Berkshire County","MA","Berkshire County","2009","Berkshire County, MA",5667,67425,73092
"688",NA,"Berkshire County","MA","Berkshire County","2010","Berkshire County, MA",5881,66909,72790
"689",NA,"Berkshire County","MA","Berkshire County","2011","Berkshire County, MA",5223,67309,72532
"690",NA,"Berkshire County","MA","Berkshire County","2012","Berkshire County, MA",4817,66814,71631
"691","Berlin","Worcester County","MA","Berlin","1990","Berlin town, MA",83,1286,1369
"692","Berlin","Worcester County","MA","Berlin","1991","Berlin town, MA",105,1239,1344
"693","Berlin","Worcester County","MA","Berlin","1992","Berlin town, MA",114,1250,1364
"694","Berlin","Worcester County","MA","Berlin","1993","Berlin town, MA",95,1277,1372
"695","Berlin","Worcester County","MA","Berlin","1994","Berlin town, MA",79,1301,1380
"696","Berlin","Worcester County","MA","Berlin","1995","Berlin town, MA",83,1286,1369
"697","Berlin","Worcester County","MA","Berlin","1996","Berlin town, MA",57,1316,1373
"698","Berlin","Worcester County","MA","Berlin","1997","Berlin town, MA",57,1361,1418
"699","Berlin","Worcester County","MA","Berlin","1998","Berlin town, MA",38,1397,1435
"700","Berlin","Worcester County","MA","Berlin","1999","Berlin town, MA",46,1432,1478
"701","Berlin","Worcester County","MA","Berlin","2000","Berlin town, MA",37,1304,1341
"702","Berlin","Worcester County","MA","Berlin","2001","Berlin town, MA",52,1331,1383
"703","Berlin","Worcester County","MA","Berlin","2002","Berlin town, MA",93,1364,1457
"704","Berlin","Worcester County","MA","Berlin","2003","Berlin town, MA",89,1389,1478
"705","Berlin","Worcester County","MA","Berlin","2004","Berlin town, MA",66,1405,1471
"706","Berlin","Worcester County","MA","Berlin","2005","Berlin town, MA",71,1433,1504
"707","Berlin","Worcester County","MA","Berlin","2006","Berlin town, MA",65,1457,1522
"708","Berlin","Worcester County","MA","Berlin","2007","Berlin town, MA",67,1464,1531
"709","Berlin","Worcester County","MA","Berlin","2008","Berlin town, MA",72,1562,1634
"710","Berlin","Worcester County","MA","Berlin","2009","Berlin town, MA",122,1537,1659
"711","Berlin","Worcester County","MA","Berlin","2010","Berlin town, MA",126,1481,1607
"712","Berlin","Worcester County","MA","Berlin","2011","Berlin town, MA",100,1485,1585
"713","Berlin","Worcester County","MA","Berlin","2012","Berlin town, MA",89,1499,1588
"714","Bernardston","Franklin County","MA","Bernardston","1990","Bernardston town, MA",63,1028,1091
"715","Bernardston","Franklin County","MA","Bernardston","1991","Bernardston town, MA",97,1028,1125
"716","Bernardston","Franklin County","MA","Bernardston","1992","Bernardston town, MA",78,989,1067
"717","Bernardston","Franklin County","MA","Bernardston","1993","Bernardston town, MA",68,960,1028
"718","Bernardston","Franklin County","MA","Bernardston","1994","Bernardston town, MA",70,1002,1072
"719","Bernardston","Franklin County","MA","Bernardston","1995","Bernardston town, MA",54,1050,1104
"720","Bernardston","Franklin County","MA","Bernardston","1996","Bernardston town, MA",40,1059,1099
"721","Bernardston","Franklin County","MA","Bernardston","1997","Bernardston town, MA",47,1088,1135
"722","Bernardston","Franklin County","MA","Bernardston","1998","Bernardston town, MA",38,1107,1145
"723","Bernardston","Franklin County","MA","Bernardston","1999","Bernardston town, MA",41,1132,1173
"724","Bernardston","Franklin County","MA","Bernardston","2000","Bernardston town, MA",32,1164,1196
"725","Bernardston","Franklin County","MA","Bernardston","2001","Bernardston town, MA",42,1163,1205
"726","Bernardston","Franklin County","MA","Bernardston","2002","Bernardston town, MA",52,1182,1234
"727","Bernardston","Franklin County","MA","Bernardston","2003","Bernardston town, MA",58,1190,1248
"728","Bernardston","Franklin County","MA","Bernardston","2004","Bernardston town, MA",57,1180,1237
"729","Bernardston","Franklin County","MA","Bernardston","2005","Bernardston town, MA",55,1191,1246
"730","Bernardston","Franklin County","MA","Bernardston","2006","Bernardston town, MA",54,1196,1250
"731","Bernardston","Franklin County","MA","Bernardston","2007","Bernardston town, MA",44,1183,1227
"732","Bernardston","Franklin County","MA","Bernardston","2008","Bernardston town, MA",54,1168,1222
"733","Bernardston","Franklin County","MA","Bernardston","2009","Bernardston town, MA",90,1136,1226
"734","Bernardston","Franklin County","MA","Bernardston","2010","Bernardston town, MA",99,1103,1202
"735","Bernardston","Franklin County","MA","Bernardston","2011","Bernardston town, MA",85,1104,1189
"736","Bernardston","Franklin County","MA","Bernardston","2012","Bernardston town, MA",69,1107,1176
"737","Beverly","Essex County","MA","Beverly","1990","Beverly city, MA",1087,20193,21280
"738","Beverly","Essex County","MA","Beverly","1991","Beverly city, MA",1474,19583,21057
"739","Beverly","Essex County","MA","Beverly","1992","Beverly city, MA",1614,19470,21084
"740","Beverly","Essex County","MA","Beverly","1993","Beverly city, MA",1166,19728,20894
"741","Beverly","Essex County","MA","Beverly","1994","Beverly city, MA",991,20064,21055
"742","Beverly","Essex County","MA","Beverly","1995","Beverly city, MA",817,20120,20937
"743","Beverly","Essex County","MA","Beverly","1996","Beverly city, MA",731,20508,21239
"744","Beverly","Essex County","MA","Beverly","1997","Beverly city, MA",655,21100,21755
"745","Beverly","Essex County","MA","Beverly","1998","Beverly city, MA",575,21486,22061
"746","Beverly","Essex County","MA","Beverly","1999","Beverly city, MA",556,21675,22231
"747","Beverly","Essex County","MA","Beverly","2000","Beverly city, MA",476,21310,21786
"748","Beverly","Essex County","MA","Beverly","2001","Beverly city, MA",687,21346,22033
"749","Beverly","Essex County","MA","Beverly","2002","Beverly city, MA",1023,21041,22064
"750","Beverly","Essex County","MA","Beverly","2003","Beverly city, MA",1096,20726,21822
"751","Beverly","Essex County","MA","Beverly","2004","Beverly city, MA",1057,20629,21686
"752","Beverly","Essex County","MA","Beverly","2005","Beverly city, MA",931,20710,21641
"753","Beverly","Essex County","MA","Beverly","2006","Beverly city, MA",886,20412,21298
"754","Beverly","Essex County","MA","Beverly","2007","Beverly city, MA",836,20416,21252
"755","Beverly","Essex County","MA","Beverly","2008","Beverly city, MA",1019,20356,21375
"756","Beverly","Essex County","MA","Beverly","2009","Beverly city, MA",1584,19583,21167
"757","Beverly","Essex County","MA","Beverly","2010","Beverly city, MA",1590,19871,21461
"758","Beverly","Essex County","MA","Beverly","2011","Beverly city, MA",1380,20105,21485
"759","Beverly","Essex County","MA","Beverly","2012","Beverly city, MA",1255,20325,21580
"760","Billerica","Middlesex County","MA","Billerica","1990","Billerica town, MA",1435,21287,22722
"761","Billerica","Middlesex County","MA","Billerica","1991","Billerica town, MA",1977,20558,22535
"762","Billerica","Middlesex County","MA","Billerica","1992","Billerica town, MA",2178,20514,22692
"763","Billerica","Middlesex County","MA","Billerica","1993","Billerica town, MA",1831,20663,22494
"764","Billerica","Middlesex County","MA","Billerica","1994","Billerica town, MA",1467,20820,22287
"765","Billerica","Middlesex County","MA","Billerica","1995","Billerica town, MA",1208,20807,22015
"766","Billerica","Middlesex County","MA","Billerica","1996","Billerica town, MA",1036,21577,22613
"767","Billerica","Middlesex County","MA","Billerica","1997","Billerica town, MA",889,22518,23407
"768","Billerica","Middlesex County","MA","Billerica","1998","Billerica town, MA",744,23221,23965
"769","Billerica","Middlesex County","MA","Billerica","1999","Billerica town, MA",781,23977,24758
"770","Billerica","Middlesex County","MA","Billerica","2000","Billerica town, MA",557,21528,22085
"771","Billerica","Middlesex County","MA","Billerica","2001","Billerica town, MA",816,21620,22436
"772","Billerica","Middlesex County","MA","Billerica","2002","Billerica town, MA",1331,21307,22638
"773","Billerica","Middlesex County","MA","Billerica","2003","Billerica town, MA",1406,20993,22399
"774","Billerica","Middlesex County","MA","Billerica","2004","Billerica town, MA",1201,21142,22343
"775","Billerica","Middlesex County","MA","Billerica","2005","Billerica town, MA",1026,21299,22325
"776","Billerica","Middlesex County","MA","Billerica","2006","Billerica town, MA",1000,22039,23039
"777","Billerica","Middlesex County","MA","Billerica","2007","Billerica town, MA",979,22373,23352
"778","Billerica","Middlesex County","MA","Billerica","2008","Billerica town, MA",1129,22211,23340
"779","Billerica","Middlesex County","MA","Billerica","2009","Billerica town, MA",1827,20546,22373
"780","Billerica","Middlesex County","MA","Billerica","2010","Billerica town, MA",1811,20893,22704
"781","Billerica","Middlesex County","MA","Billerica","2011","Billerica town, MA",1520,21114,22634
"782","Billerica","Middlesex County","MA","Billerica","2012","Billerica town, MA",1427,21347,22774
"783","Blackstone","Worcester County","MA","Blackstone","1990","Blackstone town, MA",400,4115,4515
"784","Blackstone","Worcester County","MA","Blackstone","1991","Blackstone town, MA",530,4034,4564
"785","Blackstone","Worcester County","MA","Blackstone","1992","Blackstone town, MA",554,4003,4557
"786","Blackstone","Worcester County","MA","Blackstone","1993","Blackstone town, MA",391,4087,4478
"787","Blackstone","Worcester County","MA","Blackstone","1994","Blackstone town, MA",325,4213,4538
"788","Blackstone","Worcester County","MA","Blackstone","1995","Blackstone town, MA",311,4145,4456
"789","Blackstone","Worcester County","MA","Blackstone","1996","Blackstone town, MA",296,4222,4518
"790","Blackstone","Worcester County","MA","Blackstone","1997","Blackstone town, MA",242,4345,4587
"791","Blackstone","Worcester County","MA","Blackstone","1998","Blackstone town, MA",182,4434,4616
"792","Blackstone","Worcester County","MA","Blackstone","1999","Blackstone town, MA",179,4508,4687
"793","Blackstone","Worcester County","MA","Blackstone","2000","Blackstone town, MA",158,4914,5072
"794","Blackstone","Worcester County","MA","Blackstone","2001","Blackstone town, MA",218,4913,5131
"795","Blackstone","Worcester County","MA","Blackstone","2002","Blackstone town, MA",304,4955,5259
"796","Blackstone","Worcester County","MA","Blackstone","2003","Blackstone town, MA",300,4994,5294
"797","Blackstone","Worcester County","MA","Blackstone","2004","Blackstone town, MA",275,5003,5278
"798","Blackstone","Worcester County","MA","Blackstone","2005","Blackstone town, MA",267,5035,5302
"799","Blackstone","Worcester County","MA","Blackstone","2006","Blackstone town, MA",294,5074,5368
"800","Blackstone","Worcester County","MA","Blackstone","2007","Blackstone town, MA",272,5093,5365
"801","Blackstone","Worcester County","MA","Blackstone","2008","Blackstone town, MA",357,5005,5362
"802","Blackstone","Worcester County","MA","Blackstone","2009","Blackstone town, MA",582,5152,5734
"803","Blackstone","Worcester County","MA","Blackstone","2010","Blackstone town, MA",562,4760,5322
"804","Blackstone","Worcester County","MA","Blackstone","2011","Blackstone town, MA",518,4805,5323
"805","Blackstone","Worcester County","MA","Blackstone","2012","Blackstone town, MA",491,4812,5303
"806","Blandford","Hampden County","MA","Blandford","1990","Blandford town, MA",32,611,643
"807","Blandford","Hampden County","MA","Blandford","1991","Blandford town, MA",60,573,633
"808","Blandford","Hampden County","MA","Blandford","1992","Blandford town, MA",61,628,689
"809","Blandford","Hampden County","MA","Blandford","1993","Blandford town, MA",50,642,692
"810","Blandford","Hampden County","MA","Blandford","1994","Blandford town, MA",46,694,740
"811","Blandford","Hampden County","MA","Blandford","1995","Blandford town, MA",41,689,730
"812","Blandford","Hampden County","MA","Blandford","1996","Blandford town, MA",29,665,694
"813","Blandford","Hampden County","MA","Blandford","1997","Blandford town, MA",27,667,694
"814","Blandford","Hampden County","MA","Blandford","1998","Blandford town, MA",23,694,717
"815","Blandford","Hampden County","MA","Blandford","1999","Blandford town, MA",28,749,777
"816","Blandford","Hampden County","MA","Blandford","2000","Blandford town, MA",21,691,712
"817","Blandford","Hampden County","MA","Blandford","2001","Blandford town, MA",25,696,721
"818","Blandford","Hampden County","MA","Blandford","2002","Blandford town, MA",33,698,731
"819","Blandford","Hampden County","MA","Blandford","2003","Blandford town, MA",39,695,734
"820","Blandford","Hampden County","MA","Blandford","2004","Blandford town, MA",44,705,749
"821","Blandford","Hampden County","MA","Blandford","2005","Blandford town, MA",35,709,744
"822","Blandford","Hampden County","MA","Blandford","2006","Blandford town, MA",32,719,751
"823","Blandford","Hampden County","MA","Blandford","2007","Blandford town, MA",31,723,754
"824","Blandford","Hampden County","MA","Blandford","2008","Blandford town, MA",29,711,740
"825","Blandford","Hampden County","MA","Blandford","2009","Blandford town, MA",50,693,743
"826","Blandford","Hampden County","MA","Blandford","2010","Blandford town, MA",55,661,716
"827","Blandford","Hampden County","MA","Blandford","2011","Blandford town, MA",49,654,703
"828","Blandford","Hampden County","MA","Blandford","2012","Blandford town, MA",37,655,692
"829","Bolton","Worcester County","MA","Bolton","1990","Bolton town, MA",94,1710,1804
"830","Bolton","Worcester County","MA","Bolton","1991","Bolton town, MA",125,1703,1828
"831","Bolton","Worcester County","MA","Bolton","1992","Bolton town, MA",111,1715,1826
"832","Bolton","Worcester County","MA","Bolton","1993","Bolton town, MA",102,1782,1884
"833","Bolton","Worcester County","MA","Bolton","1994","Bolton town, MA",91,1904,1995
"834","Bolton","Worcester County","MA","Bolton","1995","Bolton town, MA",76,1742,1818
"835","Bolton","Worcester County","MA","Bolton","1996","Bolton town, MA",56,1784,1840
"836","Bolton","Worcester County","MA","Bolton","1997","Bolton town, MA",56,1843,1899
"837","Bolton","Worcester County","MA","Bolton","1998","Bolton town, MA",52,1889,1941
"838","Bolton","Worcester County","MA","Bolton","1999","Bolton town, MA",63,1929,1992
"839","Bolton","Worcester County","MA","Bolton","2000","Bolton town, MA",46,2374,2420
"840","Bolton","Worcester County","MA","Bolton","2001","Bolton town, MA",82,2398,2480
"841","Bolton","Worcester County","MA","Bolton","2002","Bolton town, MA",137,2383,2520
"842","Bolton","Worcester County","MA","Bolton","2003","Bolton town, MA",122,2389,2511
"843","Bolton","Worcester County","MA","Bolton","2004","Bolton town, MA",113,2411,2524
"844","Bolton","Worcester County","MA","Bolton","2005","Bolton town, MA",94,2462,2556
"845","Bolton","Worcester County","MA","Bolton","2006","Bolton town, MA",104,2478,2582
"846","Bolton","Worcester County","MA","Bolton","2007","Bolton town, MA",94,2525,2619
"847","Bolton","Worcester County","MA","Bolton","2008","Bolton town, MA",103,2512,2615
"848","Bolton","Worcester County","MA","Bolton","2009","Bolton town, MA",166,2436,2602
"849","Bolton","Worcester County","MA","Bolton","2010","Bolton town, MA",181,2633,2814
"850","Bolton","Worcester County","MA","Bolton","2011","Bolton town, MA",153,2654,2807
"851","Bolton","Worcester County","MA","Bolton","2012","Bolton town, MA",120,2683,2803
"852","Boston","Suffolk County","MA","Boston","1990","Boston city, MA",18133,286374,304507
"853","Boston","Suffolk County","MA","Boston","1991","Boston city, MA",24891,271660,296551
"854","Boston","Suffolk County","MA","Boston","1992","Boston city, MA",23992,265307,289299
"855","Boston","Suffolk County","MA","Boston","1993","Boston city, MA",19986,267080,287066
"856","Boston","Suffolk County","MA","Boston","1994","Boston city, MA",17195,268809,286004
"857","Boston","Suffolk County","MA","Boston","1995","Boston city, MA",15934,277847,293781
"858","Boston","Suffolk County","MA","Boston","1996","Boston city, MA",13888,281244,295132
"859","Boston","Suffolk County","MA","Boston","1997","Boston city, MA",12719,286537,299256
"860","Boston","Suffolk County","MA","Boston","1998","Boston city, MA",10464,289584,300048
"861","Boston","Suffolk County","MA","Boston","1999","Boston city, MA",10216,291680,301896
"862","Boston","Suffolk County","MA","Boston","2000","Boston city, MA",9216,295008,304224
"863","Boston","Suffolk County","MA","Boston","2001","Boston city, MA",12640,294165,306805
"864","Boston","Suffolk County","MA","Boston","2002","Boston city, MA",17871,286918,304789
"865","Boston","Suffolk County","MA","Boston","2003","Boston city, MA",19058,278948,298006
"866","Boston","Suffolk County","MA","Boston","2004","Boston city, MA",16410,274159,290569
"867","Boston","Suffolk County","MA","Boston","2005","Boston city, MA",14951,272483,287434
"868","Boston","Suffolk County","MA","Boston","2006","Boston city, MA",15135,295598,310733
"869","Boston","Suffolk County","MA","Boston","2007","Boston city, MA",13853,302153,316006
"870","Boston","Suffolk County","MA","Boston","2008","Boston city, MA",16609,307404,324013
"871","Boston","Suffolk County","MA","Boston","2009","Boston city, MA",24660,300082,324742
"872","Boston","Suffolk County","MA","Boston","2010","Boston city, MA",25106,291571,316677
"873","Boston","Suffolk County","MA","Boston","2011","Boston city, MA",22101,296374,318475
"874","Boston","Suffolk County","MA","Boston","2012","Boston city, MA",20626,299620,320246
"875","Bourne","Barnstable County","MA","Bourne","1990","Bourne town, MA",579,7454,8033
"876","Bourne","Barnstable County","MA","Bourne","1991","Bourne town, MA",839,7306,8145
"877","Bourne","Barnstable County","MA","Bourne","1992","Bourne town, MA",858,7289,8147
"878","Bourne","Barnstable County","MA","Bourne","1993","Bourne town, MA",694,7679,8373
"879","Bourne","Barnstable County","MA","Bourne","1994","Bourne town, MA",664,7801,8465
"880","Bourne","Barnstable County","MA","Bourne","1995","Bourne town, MA",564,8001,8565
"881","Bourne","Barnstable County","MA","Bourne","1996","Bourne town, MA",474,8185,8659
"882","Bourne","Barnstable County","MA","Bourne","1997","Bourne town, MA",429,8446,8875
"883","Bourne","Barnstable County","MA","Bourne","1998","Bourne town, MA",420,8580,9000
"884","Bourne","Barnstable County","MA","Bourne","1999","Bourne town, MA",368,8696,9064
"885","Bourne","Barnstable County","MA","Bourne","2000","Bourne town, MA",301,9263,9564
"886","Bourne","Barnstable County","MA","Bourne","2001","Bourne town, MA",348,9392,9740
"887","Bourne","Barnstable County","MA","Bourne","2002","Bourne town, MA",484,9600,10084
"888","Bourne","Barnstable County","MA","Bourne","2003","Bourne town, MA",563,9827,10390
"889","Bourne","Barnstable County","MA","Bourne","2004","Bourne town, MA",547,9967,10514
"890","Bourne","Barnstable County","MA","Bourne","2005","Bourne town, MA",522,9943,10465
"891","Bourne","Barnstable County","MA","Bourne","2006","Bourne town, MA",519,9971,10490
"892","Bourne","Barnstable County","MA","Bourne","2007","Bourne town, MA",514,9923,10437
"893","Bourne","Barnstable County","MA","Bourne","2008","Bourne town, MA",641,10103,10744
"894","Bourne","Barnstable County","MA","Bourne","2009","Bourne town, MA",924,9821,10745
"895","Bourne","Barnstable County","MA","Bourne","2010","Bourne town, MA",1011,10148,11159
"896","Bourne","Barnstable County","MA","Bourne","2011","Bourne town, MA",911,10132,11043
"897","Bourne","Barnstable County","MA","Bourne","2012","Bourne town, MA",837,10302,11139
"898","Boxborough","Middlesex County","MA","Boxborough","1990","Boxborough town, MA",81,1998,2079
"899","Boxborough","Middlesex County","MA","Boxborough","1991","Boxborough town, MA",104,1959,2063
"900","Boxborough","Middlesex County","MA","Boxborough","1992","Boxborough town, MA",124,2088,2212
"901","Boxborough","Middlesex County","MA","Boxborough","1993","Boxborough town, MA",104,2223,2327
"902","Boxborough","Middlesex County","MA","Boxborough","1994","Boxborough town, MA",106,2450,2556
"903","Boxborough","Middlesex County","MA","Boxborough","1995","Boxborough town, MA",94,2300,2394
"904","Boxborough","Middlesex County","MA","Boxborough","1996","Boxborough town, MA",66,2382,2448
"905","Boxborough","Middlesex County","MA","Boxborough","1997","Boxborough town, MA",58,2482,2540
"906","Boxborough","Middlesex County","MA","Boxborough","1998","Boxborough town, MA",52,2515,2567
"907","Boxborough","Middlesex County","MA","Boxborough","1999","Boxborough town, MA",47,2579,2626
"908","Boxborough","Middlesex County","MA","Boxborough","2000","Boxborough town, MA",47,2829,2876
"909","Boxborough","Middlesex County","MA","Boxborough","2001","Boxborough town, MA",87,2838,2925
"910","Boxborough","Middlesex County","MA","Boxborough","2002","Boxborough town, MA",152,2791,2943
"911","Boxborough","Middlesex County","MA","Boxborough","2003","Boxborough town, MA",148,2794,2942
"912","Boxborough","Middlesex County","MA","Boxborough","2004","Boxborough town, MA",112,2817,2929
"913","Boxborough","Middlesex County","MA","Boxborough","2005","Boxborough town, MA",107,2857,2964
"914","Boxborough","Middlesex County","MA","Boxborough","2006","Boxborough town, MA",99,2831,2930
"915","Boxborough","Middlesex County","MA","Boxborough","2007","Boxborough town, MA",93,2860,2953
"916","Boxborough","Middlesex County","MA","Boxborough","2008","Boxborough town, MA",105,2859,2964
"917","Boxborough","Middlesex County","MA","Boxborough","2009","Boxborough town, MA",180,2789,2969
"918","Boxborough","Middlesex County","MA","Boxborough","2010","Boxborough town, MA",183,2731,2914
"919","Boxborough","Middlesex County","MA","Boxborough","2011","Boxborough town, MA",158,2772,2930
"920","Boxborough","Middlesex County","MA","Boxborough","2012","Boxborough town, MA",147,2802,2949
"921","Boxford","Essex County","MA","Boxford","1990","Boxford town, MA",120,3311,3431
"922","Boxford","Essex County","MA","Boxford","1991","Boxford town, MA",170,3305,3475
"923","Boxford","Essex County","MA","Boxford","1992","Boxford town, MA",156,3400,3556
"924","Boxford","Essex County","MA","Boxford","1993","Boxford town, MA",162,3548,3710
"925","Boxford","Essex County","MA","Boxford","1994","Boxford town, MA",149,3767,3916
"926","Boxford","Essex County","MA","Boxford","1995","Boxford town, MA",136,4504,4640
"927","Boxford","Essex County","MA","Boxford","1996","Boxford town, MA",101,4711,4812
"928","Boxford","Essex County","MA","Boxford","1997","Boxford town, MA",96,4856,4952
"929","Boxford","Essex County","MA","Boxford","1998","Boxford town, MA",84,5027,5111
"930","Boxford","Essex County","MA","Boxford","1999","Boxford town, MA",94,5209,5303
"931","Boxford","Essex County","MA","Boxford","2000","Boxford town, MA",77,4025,4102
"932","Boxford","Essex County","MA","Boxford","2001","Boxford town, MA",117,4086,4203
"933","Boxford","Essex County","MA","Boxford","2002","Boxford town, MA",175,4051,4226
"934","Boxford","Essex County","MA","Boxford","2003","Boxford town, MA",182,4006,4188
"935","Boxford","Essex County","MA","Boxford","2004","Boxford town, MA",164,3999,4163
"936","Boxford","Essex County","MA","Boxford","2005","Boxford town, MA",142,4022,4164
"937","Boxford","Essex County","MA","Boxford","2006","Boxford town, MA",146,3955,4101
"938","Boxford","Essex County","MA","Boxford","2007","Boxford town, MA",142,3985,4127
"939","Boxford","Essex County","MA","Boxford","2008","Boxford town, MA",160,3988,4148
"940","Boxford","Essex County","MA","Boxford","2009","Boxford town, MA",241,3876,4117
"941","Boxford","Essex County","MA","Boxford","2010","Boxford town, MA",250,3796,4046
"942","Boxford","Essex County","MA","Boxford","2011","Boxford town, MA",221,3841,4062
"943","Boxford","Essex County","MA","Boxford","2012","Boxford town, MA",191,3883,4074
"944","Boylston","Worcester County","MA","Boylston","1990","Boylston town, MA",127,1828,1955
"945","Boylston","Worcester County","MA","Boylston","1991","Boylston town, MA",203,1778,1981
"946","Boylston","Worcester County","MA","Boylston","1992","Boylston town, MA",173,1782,1955
"947","Boylston","Worcester County","MA","Boylston","1993","Boylston town, MA",137,1823,1960
"948","Boylston","Worcester County","MA","Boylston","1994","Boylston town, MA",121,1835,1956
"949","Boylston","Worcester County","MA","Boylston","1995","Boylston town, MA",102,1932,2034
"950","Boylston","Worcester County","MA","Boylston","1996","Boylston town, MA",81,1978,2059
"951","Boylston","Worcester County","MA","Boylston","1997","Boylston town, MA",77,2043,2120
"952","Boylston","Worcester County","MA","Boylston","1998","Boylston town, MA",70,2096,2166
"953","Boylston","Worcester County","MA","Boylston","1999","Boylston town, MA",73,2105,2178
"954","Boylston","Worcester County","MA","Boylston","2000","Boylston town, MA",48,2147,2195
"955","Boylston","Worcester County","MA","Boylston","2001","Boylston town, MA",70,2155,2225
"956","Boylston","Worcester County","MA","Boylston","2002","Boylston town, MA",115,2147,2262
"957","Boylston","Worcester County","MA","Boylston","2003","Boylston town, MA",129,2154,2283
"958","Boylston","Worcester County","MA","Boylston","2004","Boylston town, MA",113,2159,2272
"959","Boylston","Worcester County","MA","Boylston","2005","Boylston town, MA",112,2193,2305
"960","Boylston","Worcester County","MA","Boylston","2006","Boylston town, MA",98,2230,2328
"961","Boylston","Worcester County","MA","Boylston","2007","Boylston town, MA",90,2257,2347
"962","Boylston","Worcester County","MA","Boylston","2008","Boylston town, MA",108,2214,2322
"963","Boylston","Worcester County","MA","Boylston","2009","Boylston town, MA",173,2160,2333
"964","Boylston","Worcester County","MA","Boylston","2010","Boylston town, MA",189,2146,2335
"965","Boylston","Worcester County","MA","Boylston","2011","Boylston town, MA",158,2166,2324
"966","Boylston","Worcester County","MA","Boylston","2012","Boylston town, MA",152,2165,2317
"967","Braintree","Norfolk County","MA","Braintree","1990","Braintree Town city, MA",1018,17114,18132
"968","Braintree","Norfolk County","MA","Braintree","1991","Braintree Town city, MA",1494,16569,18063
"969","Braintree","Norfolk County","MA","Braintree","1992","Braintree Town city, MA",1483,16509,17992
"970","Braintree","Norfolk County","MA","Braintree","1993","Braintree Town city, MA",1206,16529,17735
"971","Braintree","Norfolk County","MA","Braintree","1994","Braintree Town city, MA",1047,16751,17798
"972","Braintree","Norfolk County","MA","Braintree","1995","Braintree Town city, MA",930,17299,18229
"973","Braintree","Norfolk County","MA","Braintree","1996","Braintree Town city, MA",747,17654,18401
"974","Braintree","Norfolk County","MA","Braintree","1997","Braintree Town city, MA",673,18116,18789
"975","Braintree","Norfolk County","MA","Braintree","1998","Braintree Town city, MA",534,18378,18912
"976","Braintree","Norfolk County","MA","Braintree","1999","Braintree Town city, MA",457,18475,18932
"977","Braintree","Norfolk County","MA","Braintree","2000","Braintree Town city, MA",434,17744,18178
"978","Braintree","Norfolk County","MA","Braintree","2001","Braintree Town city, MA",584,17669,18253
"979","Braintree","Norfolk County","MA","Braintree","2002","Braintree Town city, MA",844,17350,18194
"980","Braintree","Norfolk County","MA","Braintree","2003","Braintree Town city, MA",1004,17019,18023
"981","Braintree","Norfolk County","MA","Braintree","2004","Braintree Town city, MA",919,17112,18031
"982","Braintree","Norfolk County","MA","Braintree","2005","Braintree Town city, MA",815,17190,18005
"983","Braintree","Norfolk County","MA","Braintree","2006","Braintree Town city, MA",817,17133,17950
"984","Braintree","Norfolk County","MA","Braintree","2007","Braintree Town city, MA",783,17422,18205
"985","Braintree","Norfolk County","MA","Braintree","2008","Braintree Town city, MA",958,17881,18839
"986","Braintree","Norfolk County","MA","Braintree","2009","Braintree Town city, MA",1428,17284,18712
"987","Braintree","Norfolk County","MA","Braintree","2010","Braintree Town city, MA",1494,17670,19164
"988","Braintree","Norfolk County","MA","Braintree","2011","Braintree Town city, MA",1251,17868,19119
"989","Braintree","Norfolk County","MA","Braintree","2012","Braintree Town city, MA",1160,18063,19223
"990","Brewster","Barnstable County","MA","Brewster","1990","Brewster town, MA",261,4174,4435
"991","Brewster","Barnstable County","MA","Brewster","1991","Brewster town, MA",340,4102,4442
"992","Brewster","Barnstable County","MA","Brewster","1992","Brewster town, MA",341,4083,4424
"993","Brewster","Barnstable County","MA","Brewster","1993","Brewster town, MA",297,4268,4565
"994","Brewster","Barnstable County","MA","Brewster","1994","Brewster town, MA",262,4372,4634
"995","Brewster","Barnstable County","MA","Brewster","1995","Brewster town, MA",210,4376,4586
"996","Brewster","Barnstable County","MA","Brewster","1996","Brewster town, MA",193,4521,4714
"997","Brewster","Barnstable County","MA","Brewster","1997","Brewster town, MA",181,4616,4797
"998","Brewster","Barnstable County","MA","Brewster","1998","Brewster town, MA",170,4719,4889
"999","Brewster","Barnstable County","MA","Brewster","1999","Brewster town, MA",128,4947,5075
"1000","Brewster","Barnstable County","MA","Brewster","2000","Brewster town, MA",148,5145,5293
"1001","Brewster","Barnstable County","MA","Brewster","2001","Brewster town, MA",166,5206,5372
"1002","Brewster","Barnstable County","MA","Brewster","2002","Brewster town, MA",199,5306,5505
"1003","Brewster","Barnstable County","MA","Brewster","2003","Brewster town, MA",235,5413,5648
"1004","Brewster","Barnstable County","MA","Brewster","2004","Brewster town, MA",235,5460,5695
"1005","Brewster","Barnstable County","MA","Brewster","2005","Brewster town, MA",225,5425,5650
"1006","Brewster","Barnstable County","MA","Brewster","2006","Brewster town, MA",227,5424,5651
"1007","Brewster","Barnstable County","MA","Brewster","2007","Brewster town, MA",223,5392,5615
"1008","Brewster","Barnstable County","MA","Brewster","2008","Brewster town, MA",280,5338,5618
"1009","Brewster","Barnstable County","MA","Brewster","2009","Brewster town, MA",419,5210,5629
"1010","Brewster","Barnstable County","MA","Brewster","2010","Brewster town, MA",457,5202,5659
"1011","Brewster","Barnstable County","MA","Brewster","2011","Brewster town, MA",412,5193,5605
"1012","Brewster","Barnstable County","MA","Brewster","2012","Brewster town, MA",361,5280,5641
"1013","Bridgewater","Plymouth County","MA","Bridgewater","1990","Bridgewater town, MA",693,10103,10796
"1014","Bridgewater","Plymouth County","MA","Bridgewater","1991","Bridgewater town, MA",997,9687,10684
"1015","Bridgewater","Plymouth County","MA","Bridgewater","1992","Bridgewater town, MA",1006,9533,10539
"1016","Bridgewater","Plymouth County","MA","Bridgewater","1993","Bridgewater town, MA",784,10251,11035
"1017","Bridgewater","Plymouth County","MA","Bridgewater","1994","Bridgewater town, MA",694,11061,11755
"1018","Bridgewater","Plymouth County","MA","Bridgewater","1995","Bridgewater town, MA",611,11264,11875
"1019","Bridgewater","Plymouth County","MA","Bridgewater","1996","Bridgewater town, MA",489,11467,11956
"1020","Bridgewater","Plymouth County","MA","Bridgewater","1997","Bridgewater town, MA",431,11945,12376
"1021","Bridgewater","Plymouth County","MA","Bridgewater","1998","Bridgewater town, MA",361,12077,12438
"1022","Bridgewater","Plymouth County","MA","Bridgewater","1999","Bridgewater town, MA",365,12391,12756
"1023","Bridgewater","Plymouth County","MA","Bridgewater","2000","Bridgewater town, MA",305,12846,13151
"1024","Bridgewater","Plymouth County","MA","Bridgewater","2001","Bridgewater town, MA",399,12726,13125
"1025","Bridgewater","Plymouth County","MA","Bridgewater","2002","Bridgewater town, MA",579,12607,13186
"1026","Bridgewater","Plymouth County","MA","Bridgewater","2003","Bridgewater town, MA",660,12354,13014
"1027","Bridgewater","Plymouth County","MA","Bridgewater","2004","Bridgewater town, MA",657,12380,13037
"1028","Bridgewater","Plymouth County","MA","Bridgewater","2005","Bridgewater town, MA",612,12415,13027
"1029","Bridgewater","Plymouth County","MA","Bridgewater","2006","Bridgewater town, MA",596,12564,13160
"1030","Bridgewater","Plymouth County","MA","Bridgewater","2007","Bridgewater town, MA",591,12647,13238
"1031","Bridgewater","Plymouth County","MA","Bridgewater","2008","Bridgewater town, MA",699,12686,13385
"1032","Bridgewater","Plymouth County","MA","Bridgewater","2009","Bridgewater town, MA",1064,12967,14031
"1033","Bridgewater","Plymouth County","MA","Bridgewater","2010","Bridgewater town, MA",1097,12619,13716
"1034","Bridgewater","Plymouth County","MA","Bridgewater","2011","Bridgewater town, MA",1006,12728,13734
"1035","Bridgewater","Plymouth County","MA","Bridgewater","2012","Bridgewater town, MA",923,12841,13764
"1036","Brimfield","Hampden County","MA","Brimfield","1990","Brimfield town, MA",87,1374,1461
"1037","Brimfield","Hampden County","MA","Brimfield","1991","Brimfield town, MA",136,1352,1488
"1038","Brimfield","Hampden County","MA","Brimfield","1992","Brimfield town, MA",153,1296,1449
"1039","Brimfield","Hampden County","MA","Brimfield","1993","Brimfield town, MA",130,1304,1434
"1040","Brimfield","Hampden County","MA","Brimfield","1994","Brimfield town, MA",107,1318,1425
"1041","Brimfield","Hampden County","MA","Brimfield","1995","Brimfield town, MA",100,1535,1635
"1042","Brimfield","Hampden County","MA","Brimfield","1996","Brimfield town, MA",82,1620,1702
"1043","Brimfield","Hampden County","MA","Brimfield","1997","Brimfield town, MA",83,1614,1697
"1044","Brimfield","Hampden County","MA","Brimfield","1998","Brimfield town, MA",77,1565,1642
"1045","Brimfield","Hampden County","MA","Brimfield","1999","Brimfield town, MA",71,1536,1607
"1046","Brimfield","Hampden County","MA","Brimfield","2000","Brimfield town, MA",45,1786,1831
"1047","Brimfield","Hampden County","MA","Brimfield","2001","Brimfield town, MA",66,1821,1887
"1048","Brimfield","Hampden County","MA","Brimfield","2002","Brimfield town, MA",97,1842,1939
"1049","Brimfield","Hampden County","MA","Brimfield","2003","Brimfield town, MA",113,1853,1966
"1050","Brimfield","Hampden County","MA","Brimfield","2004","Brimfield town, MA",110,1878,1988
"1051","Brimfield","Hampden County","MA","Brimfield","2005","Brimfield town, MA",99,1905,2004
"1052","Brimfield","Hampden County","MA","Brimfield","2006","Brimfield town, MA",108,1947,2055
"1053","Brimfield","Hampden County","MA","Brimfield","2007","Brimfield town, MA",106,1953,2059
"1054","Brimfield","Hampden County","MA","Brimfield","2008","Brimfield town, MA",114,1942,2056
"1055","Brimfield","Hampden County","MA","Brimfield","2009","Brimfield town, MA",173,1903,2076
"1056","Brimfield","Hampden County","MA","Brimfield","2010","Brimfield town, MA",162,1809,1971
"1057","Brimfield","Hampden County","MA","Brimfield","2011","Brimfield town, MA",164,1791,1955
"1058","Brimfield","Hampden County","MA","Brimfield","2012","Brimfield town, MA",132,1792,1924
"1059",NA,"Bristol County","MA","Bristol County","1990","Bristol County, MA",24323,240931,265254
"1060",NA,"Bristol County","MA","Bristol County","1991","Bristol County, MA",33258,232353,265611
"1061",NA,"Bristol County","MA","Bristol County","1992","Bristol County, MA",31979,232860,264839
"1062",NA,"Bristol County","MA","Bristol County","1993","Bristol County, MA",27713,238197,265910
"1063",NA,"Bristol County","MA","Bristol County","1994","Bristol County, MA",24052,242955,267007
"1064",NA,"Bristol County","MA","Bristol County","1995","Bristol County, MA",21989,243960,265949
"1065",NA,"Bristol County","MA","Bristol County","1996","Bristol County, MA",19622,245280,264902
"1066",NA,"Bristol County","MA","Bristol County","1997","Bristol County, MA",17101,251177,268278
"1067",NA,"Bristol County","MA","Bristol County","1998","Bristol County, MA",13475,254513,267988
"1068",NA,"Bristol County","MA","Bristol County","1999","Bristol County, MA",12534,257366,269900
"1069",NA,"Bristol County","MA","Bristol County","2000","Bristol County, MA",10441,267626,278067
"1070",NA,"Bristol County","MA","Bristol County","2001","Bristol County, MA",13208,266374,279582
"1071",NA,"Bristol County","MA","Bristol County","2002","Bristol County, MA",17497,268084,285581
"1072",NA,"Bristol County","MA","Bristol County","2003","Bristol County, MA",18909,267471,286380
"1073",NA,"Bristol County","MA","Bristol County","2004","Bristol County, MA",17858,268272,286130
"1074",NA,"Bristol County","MA","Bristol County","2005","Bristol County, MA",17171,270583,287754
"1075",NA,"Bristol County","MA","Bristol County","2006","Bristol County, MA",17347,273260,290607
"1076",NA,"Bristol County","MA","Bristol County","2007","Bristol County, MA",16861,273636,290497
"1077",NA,"Bristol County","MA","Bristol County","2008","Bristol County, MA",20586,270811,291397
"1078",NA,"Bristol County","MA","Bristol County","2009","Bristol County, MA",31383,261345,292728
"1079",NA,"Bristol County","MA","Bristol County","2010","Bristol County, MA",31838,260053,291891
"1080",NA,"Bristol County","MA","Bristol County","2011","Bristol County, MA",29053,262273,291326
"1081",NA,"Bristol County","MA","Bristol County","2012","Bristol County, MA",27116,263376,290492
"1082","Brockton","Plymouth County","MA","Brockton","1990","Brockton city, MA",4385,41953,46338
"1083","Brockton","Plymouth County","MA","Brockton","1991","Brockton city, MA",5856,39354,45210
"1084","Brockton","Plymouth County","MA","Brockton","1992","Brockton city, MA",5567,38229,43796
"1085","Brockton","Plymouth County","MA","Brockton","1993","Brockton city, MA",4317,38668,42985
"1086","Brockton","Plymouth County","MA","Brockton","1994","Brockton city, MA",3557,40358,43915
"1087","Brockton","Plymouth County","MA","Brockton","1995","Brockton city, MA",3222,42855,46077
"1088","Brockton","Plymouth County","MA","Brockton","1996","Brockton city, MA",2994,42976,45970
"1089","Brockton","Plymouth County","MA","Brockton","1997","Brockton city, MA",2594,44258,46852
"1090","Brockton","Plymouth County","MA","Brockton","1998","Brockton city, MA",2120,44540,46660
"1091","Brockton","Plymouth County","MA","Brockton","1999","Brockton city, MA",2036,45028,47064
"1092","Brockton","Plymouth County","MA","Brockton","2000","Brockton city, MA",1540,43817,45357
"1093","Brockton","Plymouth County","MA","Brockton","2001","Brockton city, MA",2157,43526,45683
"1094","Brockton","Plymouth County","MA","Brockton","2002","Brockton city, MA",2935,43023,45958
"1095","Brockton","Plymouth County","MA","Brockton","2003","Brockton city, MA",3280,41894,45174
"1096","Brockton","Plymouth County","MA","Brockton","2004","Brockton city, MA",3072,41719,44791
"1097","Brockton","Plymouth County","MA","Brockton","2005","Brockton city, MA",2724,41684,44408
"1098","Brockton","Plymouth County","MA","Brockton","2006","Brockton city, MA",2721,42029,44750
"1099","Brockton","Plymouth County","MA","Brockton","2007","Brockton city, MA",2617,42109,44726
"1100","Brockton","Plymouth County","MA","Brockton","2008","Brockton city, MA",3097,41776,44873
"1101","Brockton","Plymouth County","MA","Brockton","2009","Brockton city, MA",4694,40593,45287
"1102","Brockton","Plymouth County","MA","Brockton","2010","Brockton city, MA",5166,40673,45839
"1103","Brockton","Plymouth County","MA","Brockton","2011","Brockton city, MA",4569,41052,45621
"1104","Brockton","Plymouth County","MA","Brockton","2012","Brockton city, MA",4115,41416,45531
"1105","Brookfield","Worcester County","MA","Brookfield","1990","Brookfield town, MA",103,1404,1507
"1106","Brookfield","Worcester County","MA","Brookfield","1991","Brookfield town, MA",177,1415,1592
"1107","Brookfield","Worcester County","MA","Brookfield","1992","Brookfield town, MA",178,1391,1569
"1108","Brookfield","Worcester County","MA","Brookfield","1993","Brookfield town, MA",123,1440,1563
"1109","Brookfield","Worcester County","MA","Brookfield","1994","Brookfield town, MA",94,1451,1545
"1110","Brookfield","Worcester County","MA","Brookfield","1995","Brookfield town, MA",68,1362,1430
"1111","Brookfield","Worcester County","MA","Brookfield","1996","Brookfield town, MA",83,1381,1464
"1112","Brookfield","Worcester County","MA","Brookfield","1997","Brookfield town, MA",74,1413,1487
"1113","Brookfield","Worcester County","MA","Brookfield","1998","Brookfield town, MA",62,1436,1498
"1114","Brookfield","Worcester County","MA","Brookfield","1999","Brookfield town, MA",54,1433,1487
"1115","Brookfield","Worcester County","MA","Brookfield","2000","Brookfield town, MA",42,1642,1684
"1116","Brookfield","Worcester County","MA","Brookfield","2001","Brookfield town, MA",54,1644,1698
"1117","Brookfield","Worcester County","MA","Brookfield","2002","Brookfield town, MA",99,1631,1730
"1118","Brookfield","Worcester County","MA","Brookfield","2003","Brookfield town, MA",109,1620,1729
"1119","Brookfield","Worcester County","MA","Brookfield","2004","Brookfield town, MA",98,1610,1708
"1120","Brookfield","Worcester County","MA","Brookfield","2005","Brookfield town, MA",98,1602,1700
"1121","Brookfield","Worcester County","MA","Brookfield","2006","Brookfield town, MA",107,1759,1866
"1122","Brookfield","Worcester County","MA","Brookfield","2007","Brookfield town, MA",110,1765,1875
"1123","Brookfield","Worcester County","MA","Brookfield","2008","Brookfield town, MA",107,1735,1842
"1124","Brookfield","Worcester County","MA","Brookfield","2009","Brookfield town, MA",169,1683,1852
"1125","Brookfield","Worcester County","MA","Brookfield","2010","Brookfield town, MA",177,1679,1856
"1126","Brookfield","Worcester County","MA","Brookfield","2011","Brookfield town, MA",156,1694,1850
"1127","Brookfield","Worcester County","MA","Brookfield","2012","Brookfield town, MA",143,1693,1836
"1128","Brookline","Norfolk County","MA","Brookline","1990","Brookline town, MA",812,30784,31596
"1129","Brookline","Norfolk County","MA","Brookline","1991","Brookline town, MA",1240,29218,30458
"1130","Brookline","Norfolk County","MA","Brookline","1992","Brookline town, MA",1462,28683,30145
"1131","Brookline","Norfolk County","MA","Brookline","1993","Brookline town, MA",1172,28873,30045
"1132","Brookline","Norfolk County","MA","Brookline","1994","Brookline town, MA",1102,29189,30291
"1133","Brookline","Norfolk County","MA","Brookline","1995","Brookline town, MA",887,30233,31120
"1134","Brookline","Norfolk County","MA","Brookline","1996","Brookline town, MA",698,30763,31461
"1135","Brookline","Norfolk County","MA","Brookline","1997","Brookline town, MA",612,31428,32040
"1136","Brookline","Norfolk County","MA","Brookline","1998","Brookline town, MA",488,31717,32205
"1137","Brookline","Norfolk County","MA","Brookline","1999","Brookline town, MA",474,31770,32244
"1138","Brookline","Norfolk County","MA","Brookline","2000","Brookline town, MA",561,33760,34321
"1139","Brookline","Norfolk County","MA","Brookline","2001","Brookline town, MA",881,33571,34452
"1140","Brookline","Norfolk County","MA","Brookline","2002","Brookline town, MA",1266,32911,34177
"1141","Brookline","Norfolk County","MA","Brookline","2003","Brookline town, MA",1199,32253,33452
"1142","Brookline","Norfolk County","MA","Brookline","2004","Brookline town, MA",1021,32001,33022
"1143","Brookline","Norfolk County","MA","Brookline","2005","Brookline town, MA",924,31989,32913
"1144","Brookline","Norfolk County","MA","Brookline","2006","Brookline town, MA",872,31907,32779
"1145","Brookline","Norfolk County","MA","Brookline","2007","Brookline town, MA",841,32167,33008
"1146","Brookline","Norfolk County","MA","Brookline","2008","Brookline town, MA",1046,32100,33146
"1147","Brookline","Norfolk County","MA","Brookline","2009","Brookline town, MA",1686,30980,32666
"1148","Brookline","Norfolk County","MA","Brookline","2010","Brookline town, MA",1554,32735,34289
"1149","Brookline","Norfolk County","MA","Brookline","2011","Brookline town, MA",1310,33100,34410
"1150","Brookline","Norfolk County","MA","Brookline","2012","Brookline town, MA",1189,33462,34651
"1151","Buckland","Franklin County","MA","Buckland","1990","Buckland town, MA",15,1035,1050
"1152","Buckland","Franklin County","MA","Buckland","1991","Buckland town, MA",19,1047,1066
"1153","Buckland","Franklin County","MA","Buckland","1992","Buckland town, MA",20,1037,1057
"1154","Buckland","Franklin County","MA","Buckland","1993","Buckland town, MA",16,1065,1081
"1155","Buckland","Franklin County","MA","Buckland","1994","Buckland town, MA",16,1152,1168
"1156","Buckland","Franklin County","MA","Buckland","1995","Buckland town, MA",18,1046,1064
"1157","Buckland","Franklin County","MA","Buckland","1996","Buckland town, MA",11,1052,1063
"1158","Buckland","Franklin County","MA","Buckland","1997","Buckland town, MA",12,1074,1086
"1159","Buckland","Franklin County","MA","Buckland","1998","Buckland town, MA",12,1094,1106
"1160","Buckland","Franklin County","MA","Buckland","1999","Buckland town, MA",14,1114,1128
"1161","Buckland","Franklin County","MA","Buckland","2000","Buckland town, MA",15,1128,1143
"1162","Buckland","Franklin County","MA","Buckland","2001","Buckland town, MA",18,1120,1138
"1163","Buckland","Franklin County","MA","Buckland","2002","Buckland town, MA",19,1132,1151
"1164","Buckland","Franklin County","MA","Buckland","2003","Buckland town, MA",25,1136,1161
"1165","Buckland","Franklin County","MA","Buckland","2004","Buckland town, MA",29,1112,1141
"1166","Buckland","Franklin County","MA","Buckland","2005","Buckland town, MA",27,1115,1142
"1167","Buckland","Franklin County","MA","Buckland","2006","Buckland town, MA",29,1125,1154
"1168","Buckland","Franklin County","MA","Buckland","2007","Buckland town, MA",34,1111,1145
"1169","Buckland","Franklin County","MA","Buckland","2008","Buckland town, MA",32,1094,1126
"1170","Buckland","Franklin County","MA","Buckland","2009","Buckland town, MA",43,1063,1106
"1171","Buckland","Franklin County","MA","Buckland","2010","Buckland town, MA",44,1034,1078
"1172","Buckland","Franklin County","MA","Buckland","2011","Buckland town, MA",39,1037,1076
"1173","Buckland","Franklin County","MA","Buckland","2012","Buckland town, MA",40,1040,1080
"1174","Burlington","Middlesex County","MA","Burlington","1990","Burlington town, MA",732,13821,14553
"1175","Burlington","Middlesex County","MA","Burlington","1991","Burlington town, MA",1000,13337,14337
"1176","Burlington","Middlesex County","MA","Burlington","1992","Burlington town, MA",1120,13201,14321
"1177","Burlington","Middlesex County","MA","Burlington","1993","Burlington town, MA",793,13268,14061
"1178","Burlington","Middlesex County","MA","Burlington","1994","Burlington town, MA",689,13423,14112
"1179","Burlington","Middlesex County","MA","Burlington","1995","Burlington town, MA",569,13655,14224
"1180","Burlington","Middlesex County","MA","Burlington","1996","Burlington town, MA",444,13962,14406
"1181","Burlington","Middlesex County","MA","Burlington","1997","Burlington town, MA",429,14340,14769
"1182","Burlington","Middlesex County","MA","Burlington","1998","Burlington town, MA",300,14481,14781
"1183","Burlington","Middlesex County","MA","Burlington","1999","Burlington town, MA",332,14653,14985
"1184","Burlington","Middlesex County","MA","Burlington","2000","Burlington town, MA",290,12850,13140
"1185","Burlington","Middlesex County","MA","Burlington","2001","Burlington town, MA",431,12800,13231
"1186","Burlington","Middlesex County","MA","Burlington","2002","Burlington town, MA",654,12524,13178
"1187","Burlington","Middlesex County","MA","Burlington","2003","Burlington town, MA",680,12303,12983
"1188","Burlington","Middlesex County","MA","Burlington","2004","Burlington town, MA",564,12555,13119
"1189","Burlington","Middlesex County","MA","Burlington","2005","Burlington town, MA",512,12729,13241
"1190","Burlington","Middlesex County","MA","Burlington","2006","Burlington town, MA",503,13542,14045
"1191","Burlington","Middlesex County","MA","Burlington","2007","Burlington town, MA",477,13733,14210
"1192","Burlington","Middlesex County","MA","Burlington","2008","Burlington town, MA",584,13754,14338
"1193","Burlington","Middlesex County","MA","Burlington","2009","Burlington town, MA",945,13423,14368
"1194","Burlington","Middlesex County","MA","Burlington","2010","Burlington town, MA",880,12963,13843
"1195","Burlington","Middlesex County","MA","Burlington","2011","Burlington town, MA",746,13156,13902
"1196","Burlington","Middlesex County","MA","Burlington","2012","Burlington town, MA",707,13300,14007
"1197","Cambridge","Middlesex County","MA","Cambridge","1990","Cambridge city, MA",2256,53753,56009
"1198","Cambridge","Middlesex County","MA","Cambridge","1991","Cambridge city, MA",3098,52551,55649
"1199","Cambridge","Middlesex County","MA","Cambridge","1992","Cambridge city, MA",3141,52660,55801
"1200","Cambridge","Middlesex County","MA","Cambridge","1993","Cambridge city, MA",2660,53871,56531
"1201","Cambridge","Middlesex County","MA","Cambridge","1994","Cambridge city, MA",2240,55065,57305
"1202","Cambridge","Middlesex County","MA","Cambridge","1995","Cambridge city, MA",1917,52219,54136
"1203","Cambridge","Middlesex County","MA","Cambridge","1996","Cambridge city, MA",1539,53013,54552
"1204","Cambridge","Middlesex County","MA","Cambridge","1997","Cambridge city, MA",1354,54192,55546
"1205","Cambridge","Middlesex County","MA","Cambridge","1998","Cambridge city, MA",1078,54649,55727
"1206","Cambridge","Middlesex County","MA","Cambridge","1999","Cambridge city, MA",1105,54841,55946
"1207","Cambridge","Middlesex County","MA","Cambridge","2000","Cambridge city, MA",1146,58159,59305
"1208","Cambridge","Middlesex County","MA","Cambridge","2001","Cambridge city, MA",1658,58309,59967
"1209","Cambridge","Middlesex County","MA","Cambridge","2002","Cambridge city, MA",2402,57199,59601
"1210","Cambridge","Middlesex County","MA","Cambridge","2003","Cambridge city, MA",2484,56071,58555
"1211","Cambridge","Middlesex County","MA","Cambridge","2004","Cambridge city, MA",2107,55675,57782
"1212","Cambridge","Middlesex County","MA","Cambridge","2005","Cambridge city, MA",1954,55816,57770
"1213","Cambridge","Middlesex County","MA","Cambridge","2006","Cambridge city, MA",1925,57683,59608
"1214","Cambridge","Middlesex County","MA","Cambridge","2007","Cambridge city, MA",1803,58948,60751
"1215","Cambridge","Middlesex County","MA","Cambridge","2008","Cambridge city, MA",2168,59561,61729
"1216","Cambridge","Middlesex County","MA","Cambridge","2009","Cambridge city, MA",3293,57857,61150
"1217","Cambridge","Middlesex County","MA","Cambridge","2010","Cambridge city, MA",3199,56777,59976
"1218","Cambridge","Middlesex County","MA","Cambridge","2011","Cambridge city, MA",2778,57496,60274
"1219","Cambridge","Middlesex County","MA","Cambridge","2012","Cambridge city, MA",2540,58126,60666
"1220","Canton","Norfolk County","MA","Canton","1990","Canton town, MA",550,9987,10537
"1221","Canton","Norfolk County","MA","Canton","1991","Canton town, MA",782,9832,10614
"1222","Canton","Norfolk County","MA","Canton","1992","Canton town, MA",814,9897,10711
"1223","Canton","Norfolk County","MA","Canton","1993","Canton town, MA",618,10183,10801
"1224","Canton","Norfolk County","MA","Canton","1994","Canton town, MA",579,10557,11136
"1225","Canton","Norfolk County","MA","Canton","1995","Canton town, MA",501,10665,11166
"1226","Canton","Norfolk County","MA","Canton","1996","Canton town, MA",408,10984,11392
"1227","Canton","Norfolk County","MA","Canton","1997","Canton town, MA",360,11344,11704
"1228","Canton","Norfolk County","MA","Canton","1998","Canton town, MA",278,11625,11903
"1229","Canton","Norfolk County","MA","Canton","1999","Canton town, MA",264,11779,12043
"1230","Canton","Norfolk County","MA","Canton","2000","Canton town, MA",260,10941,11201
"1231","Canton","Norfolk County","MA","Canton","2001","Canton town, MA",344,11013,11357
"1232","Canton","Norfolk County","MA","Canton","2002","Canton town, MA",500,10936,11436
"1233","Canton","Norfolk County","MA","Canton","2003","Canton town, MA",565,10828,11393
"1234","Canton","Norfolk County","MA","Canton","2004","Canton town, MA",503,10877,11380
"1235","Canton","Norfolk County","MA","Canton","2005","Canton town, MA",449,11023,11472
"1236","Canton","Norfolk County","MA","Canton","2006","Canton town, MA",468,10959,11427
"1237","Canton","Norfolk County","MA","Canton","2007","Canton town, MA",429,11151,11580
"1238","Canton","Norfolk County","MA","Canton","2008","Canton town, MA",539,11162,11701
"1239","Canton","Norfolk County","MA","Canton","2009","Canton town, MA",844,10908,11752
"1240","Canton","Norfolk County","MA","Canton","2010","Canton town, MA",809,10672,11481
"1241","Canton","Norfolk County","MA","Canton","2011","Canton town, MA",706,10792,11498
"1242","Canton","Norfolk County","MA","Canton","2012","Canton town, MA",667,10910,11577
"1243","Carlisle","Middlesex County","MA","Carlisle","1990","Carlisle town, MA",59,2404,2463
"1244","Carlisle","Middlesex County","MA","Carlisle","1991","Carlisle town, MA",93,2334,2427
"1245","Carlisle","Middlesex County","MA","Carlisle","1992","Carlisle town, MA",94,2361,2455
"1246","Carlisle","Middlesex County","MA","Carlisle","1993","Carlisle town, MA",67,2444,2511
"1247","Carlisle","Middlesex County","MA","Carlisle","1994","Carlisle town, MA",71,2503,2574
"1248","Carlisle","Middlesex County","MA","Carlisle","1995","Carlisle town, MA",63,2489,2552
"1249","Carlisle","Middlesex County","MA","Carlisle","1996","Carlisle town, MA",52,2560,2612
"1250","Carlisle","Middlesex County","MA","Carlisle","1997","Carlisle town, MA",41,2656,2697
"1251","Carlisle","Middlesex County","MA","Carlisle","1998","Carlisle town, MA",37,2734,2771
"1252","Carlisle","Middlesex County","MA","Carlisle","1999","Carlisle town, MA",47,2791,2838
"1253","Carlisle","Middlesex County","MA","Carlisle","2000","Carlisle town, MA",42,2454,2496
"1254","Carlisle","Middlesex County","MA","Carlisle","2001","Carlisle town, MA",70,2472,2542
"1255","Carlisle","Middlesex County","MA","Carlisle","2002","Carlisle town, MA",128,2449,2577
"1256","Carlisle","Middlesex County","MA","Carlisle","2003","Carlisle town, MA",117,2420,2537
"1257","Carlisle","Middlesex County","MA","Carlisle","2004","Carlisle town, MA",101,2412,2513
"1258","Carlisle","Middlesex County","MA","Carlisle","2005","Carlisle town, MA",92,2436,2528
"1259","Carlisle","Middlesex County","MA","Carlisle","2006","Carlisle town, MA",81,2394,2475
"1260","Carlisle","Middlesex County","MA","Carlisle","2007","Carlisle town, MA",76,2413,2489
"1261","Carlisle","Middlesex County","MA","Carlisle","2008","Carlisle town, MA",90,2410,2500
"1262","Carlisle","Middlesex County","MA","Carlisle","2009","Carlisle town, MA",160,2348,2508
"1263","Carlisle","Middlesex County","MA","Carlisle","2010","Carlisle town, MA",152,2371,2523
"1264","Carlisle","Middlesex County","MA","Carlisle","2011","Carlisle town, MA",109,2406,2515
"1265","Carlisle","Middlesex County","MA","Carlisle","2012","Carlisle town, MA",113,2432,2545
"1266","Carver","Plymouth County","MA","Carver","1990","Carver town, MA",391,4744,5135
"1267","Carver","Plymouth County","MA","Carver","1991","Carver town, MA",557,4652,5209
"1268","Carver","Plymouth County","MA","Carver","1992","Carver town, MA",557,4668,5225
"1269","Carver","Plymouth County","MA","Carver","1993","Carver town, MA",494,4810,5304
"1270","Carver","Plymouth County","MA","Carver","1994","Carver town, MA",380,4887,5267
"1271","Carver","Plymouth County","MA","Carver","1995","Carver town, MA",371,4917,5288
"1272","Carver","Plymouth County","MA","Carver","1996","Carver town, MA",303,5063,5366
"1273","Carver","Plymouth County","MA","Carver","1997","Carver town, MA",306,5248,5554
"1274","Carver","Plymouth County","MA","Carver","1998","Carver town, MA",227,5409,5636
"1275","Carver","Plymouth County","MA","Carver","1999","Carver town, MA",217,5557,5774
"1276","Carver","Plymouth County","MA","Carver","2000","Carver town, MA",175,5856,6031
"1277","Carver","Plymouth County","MA","Carver","2001","Carver town, MA",232,5875,6107
"1278","Carver","Plymouth County","MA","Carver","2002","Carver town, MA",302,5824,6126
"1279","Carver","Plymouth County","MA","Carver","2003","Carver town, MA",381,5769,6150
"1280","Carver","Plymouth County","MA","Carver","2004","Carver town, MA",332,5791,6123
"1281","Carver","Plymouth County","MA","Carver","2005","Carver town, MA",327,5888,6215
"1282","Carver","Plymouth County","MA","Carver","2006","Carver town, MA",318,5874,6192
"1283","Carver","Plymouth County","MA","Carver","2007","Carver town, MA",324,5986,6310
"1284","Carver","Plymouth County","MA","Carver","2008","Carver town, MA",377,6019,6396
"1285","Carver","Plymouth County","MA","Carver","2009","Carver town, MA",571,5851,6422
"1286","Carver","Plymouth County","MA","Carver","2010","Carver town, MA",572,5676,6248
"1287","Carver","Plymouth County","MA","Carver","2011","Carver town, MA",492,5733,6225
"1288","Carver","Plymouth County","MA","Carver","2012","Carver town, MA",437,5796,6233
"1289","Charlemont","Franklin County","MA","Charlemont","1990","Charlemont town, MA",46,610,656
"1290","Charlemont","Franklin County","MA","Charlemont","1991","Charlemont town, MA",62,594,656
"1291","Charlemont","Franklin County","MA","Charlemont","1992","Charlemont town, MA",70,598,668
"1292","Charlemont","Franklin County","MA","Charlemont","1993","Charlemont town, MA",59,597,656
"1293","Charlemont","Franklin County","MA","Charlemont","1994","Charlemont town, MA",51,600,651
"1294","Charlemont","Franklin County","MA","Charlemont","1995","Charlemont town, MA",34,618,652
"1295","Charlemont","Franklin County","MA","Charlemont","1996","Charlemont town, MA",36,620,656
"1296","Charlemont","Franklin County","MA","Charlemont","1997","Charlemont town, MA",40,632,672
"1297","Charlemont","Franklin County","MA","Charlemont","1998","Charlemont town, MA",32,644,676
"1298","Charlemont","Franklin County","MA","Charlemont","1999","Charlemont town, MA",32,655,687
"1299","Charlemont","Franklin County","MA","Charlemont","2000","Charlemont town, MA",21,758,779
"1300","Charlemont","Franklin County","MA","Charlemont","2001","Charlemont town, MA",24,767,791
"1301","Charlemont","Franklin County","MA","Charlemont","2002","Charlemont town, MA",35,776,811
"1302","Charlemont","Franklin County","MA","Charlemont","2003","Charlemont town, MA",41,776,817
"1303","Charlemont","Franklin County","MA","Charlemont","2004","Charlemont town, MA",38,768,806
"1304","Charlemont","Franklin County","MA","Charlemont","2005","Charlemont town, MA",31,762,793
"1305","Charlemont","Franklin County","MA","Charlemont","2006","Charlemont town, MA",30,760,790
"1306","Charlemont","Franklin County","MA","Charlemont","2007","Charlemont town, MA",37,751,788
"1307","Charlemont","Franklin County","MA","Charlemont","2008","Charlemont town, MA",37,745,782
"1308","Charlemont","Franklin County","MA","Charlemont","2009","Charlemont town, MA",56,728,784
"1309","Charlemont","Franklin County","MA","Charlemont","2010","Charlemont town, MA",54,677,731
"1310","Charlemont","Franklin County","MA","Charlemont","2011","Charlemont town, MA",48,678,726
"1311","Charlemont","Franklin County","MA","Charlemont","2012","Charlemont town, MA",47,680,727
"1312","Charlton","Worcester County","MA","Charlton","1990","Charlton town, MA",319,4887,5206
"1313","Charlton","Worcester County","MA","Charlton","1991","Charlton town, MA",469,4664,5133
"1314","Charlton","Worcester County","MA","Charlton","1992","Charlton town, MA",565,5317,5882
"1315","Charlton","Worcester County","MA","Charlton","1993","Charlton town, MA",414,5672,6086
"1316","Charlton","Worcester County","MA","Charlton","1994","Charlton town, MA",313,5910,6223
"1317","Charlton","Worcester County","MA","Charlton","1995","Charlton town, MA",316,5062,5378
"1318","Charlton","Worcester County","MA","Charlton","1996","Charlton town, MA",258,5172,5430
"1319","Charlton","Worcester County","MA","Charlton","1997","Charlton town, MA",222,5339,5561
"1320","Charlton","Worcester County","MA","Charlton","1998","Charlton town, MA",223,5483,5706
"1321","Charlton","Worcester County","MA","Charlton","1999","Charlton town, MA",193,5542,5735
"1322","Charlton","Worcester County","MA","Charlton","2000","Charlton town, MA",157,6076,6233
"1323","Charlton","Worcester County","MA","Charlton","2001","Charlton town, MA",225,6169,6394
"1324","Charlton","Worcester County","MA","Charlton","2002","Charlton town, MA",363,6225,6588
"1325","Charlton","Worcester County","MA","Charlton","2003","Charlton town, MA",405,6318,6723
"1326","Charlton","Worcester County","MA","Charlton","2004","Charlton town, MA",373,6373,6746
"1327","Charlton","Worcester County","MA","Charlton","2005","Charlton town, MA",352,6446,6798
"1328","Charlton","Worcester County","MA","Charlton","2006","Charlton town, MA",341,6517,6858
"1329","Charlton","Worcester County","MA","Charlton","2007","Charlton town, MA",340,6526,6866
"1330","Charlton","Worcester County","MA","Charlton","2008","Charlton town, MA",372,6387,6759
"1331","Charlton","Worcester County","MA","Charlton","2009","Charlton town, MA",591,6230,6821
"1332","Charlton","Worcester County","MA","Charlton","2010","Charlton town, MA",582,6421,7003
"1333","Charlton","Worcester County","MA","Charlton","2011","Charlton town, MA",515,6478,6993
"1334","Charlton","Worcester County","MA","Charlton","2012","Charlton town, MA",507,6476,6983
"1335","Chatham","Barnstable County","MA","Chatham","1990","Chatham town, MA",114,2771,2885
"1336","Chatham","Barnstable County","MA","Chatham","1991","Chatham town, MA",224,2616,2840
"1337","Chatham","Barnstable County","MA","Chatham","1992","Chatham town, MA",227,2521,2748
"1338","Chatham","Barnstable County","MA","Chatham","1993","Chatham town, MA",199,2565,2764
"1339","Chatham","Barnstable County","MA","Chatham","1994","Chatham town, MA",194,2550,2744
"1340","Chatham","Barnstable County","MA","Chatham","1995","Chatham town, MA",179,2848,3027
"1341","Chatham","Barnstable County","MA","Chatham","1996","Chatham town, MA",152,2909,3061
"1342","Chatham","Barnstable County","MA","Chatham","1997","Chatham town, MA",138,2940,3078
"1343","Chatham","Barnstable County","MA","Chatham","1998","Chatham town, MA",119,2994,3113
"1344","Chatham","Barnstable County","MA","Chatham","1999","Chatham town, MA",117,3108,3225
"1345","Chatham","Barnstable County","MA","Chatham","2000","Chatham town, MA",99,3057,3156
"1346","Chatham","Barnstable County","MA","Chatham","2001","Chatham town, MA",114,3098,3212
"1347","Chatham","Barnstable County","MA","Chatham","2002","Chatham town, MA",133,3153,3286
"1348","Chatham","Barnstable County","MA","Chatham","2003","Chatham town, MA",147,3225,3372
"1349","Chatham","Barnstable County","MA","Chatham","2004","Chatham town, MA",152,3270,3422
"1350","Chatham","Barnstable County","MA","Chatham","2005","Chatham town, MA",155,3276,3431
"1351","Chatham","Barnstable County","MA","Chatham","2006","Chatham town, MA",155,3283,3438
"1352","Chatham","Barnstable County","MA","Chatham","2007","Chatham town, MA",153,3275,3428
"1353","Chatham","Barnstable County","MA","Chatham","2008","Chatham town, MA",187,3258,3445
"1354","Chatham","Barnstable County","MA","Chatham","2009","Chatham town, MA",264,3191,3455
"1355","Chatham","Barnstable County","MA","Chatham","2010","Chatham town, MA",251,2936,3187
"1356","Chatham","Barnstable County","MA","Chatham","2011","Chatham town, MA",225,2932,3157
"1357","Chatham","Barnstable County","MA","Chatham","2012","Chatham town, MA",217,2982,3199
"1358","Chelmsford","Middlesex County","MA","Chelmsford","1990","Chelmsford town, MA",1084,19116,20200
"1359","Chelmsford","Middlesex County","MA","Chelmsford","1991","Chelmsford town, MA",1521,18513,20034
"1360","Chelmsford","Middlesex County","MA","Chelmsford","1992","Chelmsford town, MA",1606,18445,20051
"1361","Chelmsford","Middlesex County","MA","Chelmsford","1993","Chelmsford town, MA",1363,18604,19967
"1362","Chelmsford","Middlesex County","MA","Chelmsford","1994","Chelmsford town, MA",1110,18837,19947
"1363","Chelmsford","Middlesex County","MA","Chelmsford","1995","Chelmsford town, MA",837,18766,19603
"1364","Chelmsford","Middlesex County","MA","Chelmsford","1996","Chelmsford town, MA",613,19441,20054
"1365","Chelmsford","Middlesex County","MA","Chelmsford","1997","Chelmsford town, MA",577,20183,20760
"1366","Chelmsford","Middlesex County","MA","Chelmsford","1998","Chelmsford town, MA",529,20662,21191
"1367","Chelmsford","Middlesex County","MA","Chelmsford","1999","Chelmsford town, MA",567,21292,21859
"1368","Chelmsford","Middlesex County","MA","Chelmsford","2000","Chelmsford town, MA",410,18713,19123
"1369","Chelmsford","Middlesex County","MA","Chelmsford","2001","Chelmsford town, MA",607,18740,19347
"1370","Chelmsford","Middlesex County","MA","Chelmsford","2002","Chelmsford town, MA",1050,18346,19396
"1371","Chelmsford","Middlesex County","MA","Chelmsford","2003","Chelmsford town, MA",1101,18180,19281
"1372","Chelmsford","Middlesex County","MA","Chelmsford","2004","Chelmsford town, MA",868,18028,18896
"1373","Chelmsford","Middlesex County","MA","Chelmsford","2005","Chelmsford town, MA",758,18152,18910
"1374","Chelmsford","Middlesex County","MA","Chelmsford","2006","Chelmsford town, MA",742,18106,18848
"1375","Chelmsford","Middlesex County","MA","Chelmsford","2007","Chelmsford town, MA",708,18325,19033
"1376","Chelmsford","Middlesex County","MA","Chelmsford","2008","Chelmsford town, MA",843,18426,19269
"1377","Chelmsford","Middlesex County","MA","Chelmsford","2009","Chelmsford town, MA",1345,17734,19079
"1378","Chelmsford","Middlesex County","MA","Chelmsford","2010","Chelmsford town, MA",1325,17705,19030
"1379","Chelmsford","Middlesex County","MA","Chelmsford","2011","Chelmsford town, MA",1143,17896,19039
"1380","Chelmsford","Middlesex County","MA","Chelmsford","2012","Chelmsford town, MA",1076,18094,19170
"1381","Chelsea","Suffolk County","MA","Chelsea","1990","Chelsea city, MA",1131,11886,13017
"1382","Chelsea","Suffolk County","MA","Chelsea","1991","Chelsea city, MA",1451,11106,12557
"1383","Chelsea","Suffolk County","MA","Chelsea","1992","Chelsea city, MA",1457,10506,11963
"1384","Chelsea","Suffolk County","MA","Chelsea","1993","Chelsea city, MA",1113,10409,11522
"1385","Chelsea","Suffolk County","MA","Chelsea","1994","Chelsea city, MA",930,10481,11411
"1386","Chelsea","Suffolk County","MA","Chelsea","1995","Chelsea city, MA",948,11415,12363
"1387","Chelsea","Suffolk County","MA","Chelsea","1996","Chelsea city, MA",835,11543,12378
"1388","Chelsea","Suffolk County","MA","Chelsea","1997","Chelsea city, MA",737,11746,12483
"1389","Chelsea","Suffolk County","MA","Chelsea","1998","Chelsea city, MA",673,11886,12559
"1390","Chelsea","Suffolk County","MA","Chelsea","1999","Chelsea city, MA",708,11959,12667
"1391","Chelsea","Suffolk County","MA","Chelsea","2000","Chelsea city, MA",515,13590,14105
"1392","Chelsea","Suffolk County","MA","Chelsea","2001","Chelsea city, MA",713,13531,14244
"1393","Chelsea","Suffolk County","MA","Chelsea","2002","Chelsea city, MA",1041,13071,14112
"1394","Chelsea","Suffolk County","MA","Chelsea","2003","Chelsea city, MA",1207,12668,13875
"1395","Chelsea","Suffolk County","MA","Chelsea","2004","Chelsea city, MA",1024,12387,13411
"1396","Chelsea","Suffolk County","MA","Chelsea","2005","Chelsea city, MA",927,12267,13194
"1397","Chelsea","Suffolk County","MA","Chelsea","2006","Chelsea city, MA",890,13218,14108
"1398","Chelsea","Suffolk County","MA","Chelsea","2007","Chelsea city, MA",859,13675,14534
"1399","Chelsea","Suffolk County","MA","Chelsea","2008","Chelsea city, MA",978,13601,14579
"1400","Chelsea","Suffolk County","MA","Chelsea","2009","Chelsea city, MA",1473,13492,14965
"1401","Chelsea","Suffolk County","MA","Chelsea","2010","Chelsea city, MA",1536,12852,14388
"1402","Chelsea","Suffolk County","MA","Chelsea","2011","Chelsea city, MA",1367,13081,14448
"1403","Chelsea","Suffolk County","MA","Chelsea","2012","Chelsea city, MA",1262,13225,14487
"1404","Cheshire","Berkshire County","MA","Cheshire","1990","Cheshire town, MA",118,1739,1857
"1405","Cheshire","Berkshire County","MA","Cheshire","1991","Cheshire town, MA",223,1632,1855
"1406","Cheshire","Berkshire County","MA","Cheshire","1992","Cheshire town, MA",210,1592,1802
"1407","Cheshire","Berkshire County","MA","Cheshire","1993","Cheshire town, MA",173,1593,1766
"1408","Cheshire","Berkshire County","MA","Cheshire","1994","Cheshire town, MA",161,1639,1800
"1409","Cheshire","Berkshire County","MA","Cheshire","1995","Cheshire town, MA",134,1624,1758
"1410","Cheshire","Berkshire County","MA","Cheshire","1996","Cheshire town, MA",106,1652,1758
"1411","Cheshire","Berkshire County","MA","Cheshire","1997","Cheshire town, MA",107,1670,1777
"1412","Cheshire","Berkshire County","MA","Cheshire","1998","Cheshire town, MA",80,1680,1760
"1413","Cheshire","Berkshire County","MA","Cheshire","1999","Cheshire town, MA",72,1691,1763
"1414","Cheshire","Berkshire County","MA","Cheshire","2000","Cheshire town, MA",56,1799,1855
"1415","Cheshire","Berkshire County","MA","Cheshire","2001","Cheshire town, MA",70,1801,1871
"1416","Cheshire","Berkshire County","MA","Cheshire","2002","Cheshire town, MA",114,1825,1939
"1417","Cheshire","Berkshire County","MA","Cheshire","2003","Cheshire town, MA",119,1811,1930
"1418","Cheshire","Berkshire County","MA","Cheshire","2004","Cheshire town, MA",106,1812,1918
"1419","Cheshire","Berkshire County","MA","Cheshire","2005","Cheshire town, MA",101,1845,1946
"1420","Cheshire","Berkshire County","MA","Cheshire","2006","Cheshire town, MA",86,1877,1963
"1421","Cheshire","Berkshire County","MA","Cheshire","2007","Cheshire town, MA",94,1857,1951
"1422","Cheshire","Berkshire County","MA","Cheshire","2008","Cheshire town, MA",111,1853,1964
"1423","Cheshire","Berkshire County","MA","Cheshire","2009","Cheshire town, MA",169,1796,1965
"1424","Cheshire","Berkshire County","MA","Cheshire","2010","Cheshire town, MA",166,1696,1862
"1425","Cheshire","Berkshire County","MA","Cheshire","2011","Cheshire town, MA",154,1711,1865
"1426","Cheshire","Berkshire County","MA","Cheshire","2012","Cheshire town, MA",139,1704,1843
"1427","Chester","Hampden County","MA","Chester","1990","Chester town, MA",38,633,671
"1428","Chester","Hampden County","MA","Chester","1991","Chester town, MA",78,601,679
"1429","Chester","Hampden County","MA","Chester","1992","Chester town, MA",103,678,781
"1430","Chester","Hampden County","MA","Chester","1993","Chester town, MA",75,688,763
"1431","Chester","Hampden County","MA","Chester","1994","Chester town, MA",102,738,840
"1432","Chester","Hampden County","MA","Chester","1995","Chester town, MA",68,715,783
"1433","Chester","Hampden County","MA","Chester","1996","Chester town, MA",59,691,750
"1434","Chester","Hampden County","MA","Chester","1997","Chester town, MA",51,694,745
"1435","Chester","Hampden County","MA","Chester","1998","Chester town, MA",49,725,774
"1436","Chester","Hampden County","MA","Chester","1999","Chester town, MA",47,785,832
"1437","Chester","Hampden County","MA","Chester","2000","Chester town, MA",34,698,732
"1438","Chester","Hampden County","MA","Chester","2001","Chester town, MA",38,699,737
"1439","Chester","Hampden County","MA","Chester","2002","Chester town, MA",58,701,759
"1440","Chester","Hampden County","MA","Chester","2003","Chester town, MA",56,692,748
"1441","Chester","Hampden County","MA","Chester","2004","Chester town, MA",40,691,731
"1442","Chester","Hampden County","MA","Chester","2005","Chester town, MA",39,692,731
"1443","Chester","Hampden County","MA","Chester","2006","Chester town, MA",29,692,721
"1444","Chester","Hampden County","MA","Chester","2007","Chester town, MA",30,685,715
"1445","Chester","Hampden County","MA","Chester","2008","Chester town, MA",37,674,711
"1446","Chester","Hampden County","MA","Chester","2009","Chester town, MA",67,652,719
"1447","Chester","Hampden County","MA","Chester","2010","Chester town, MA",69,670,739
"1448","Chester","Hampden County","MA","Chester","2011","Chester town, MA",59,664,723
"1449","Chester","Hampden County","MA","Chester","2012","Chester town, MA",42,664,706
"1450","Chesterfield","Hampshire County","MA","Chesterfield","1990","Chesterfield town, MA",32,592,624
"1451","Chesterfield","Hampshire County","MA","Chesterfield","1991","Chesterfield town, MA",77,577,654
"1452","Chesterfield","Hampshire County","MA","Chesterfield","1992","Chesterfield town, MA",56,601,657
"1453","Chesterfield","Hampshire County","MA","Chesterfield","1993","Chesterfield town, MA",51,600,651
"1454","Chesterfield","Hampshire County","MA","Chesterfield","1994","Chesterfield town, MA",30,647,677
"1455","Chesterfield","Hampshire County","MA","Chesterfield","1995","Chesterfield town, MA",26,721,747
"1456","Chesterfield","Hampshire County","MA","Chesterfield","1996","Chesterfield town, MA",27,711,738
"1457","Chesterfield","Hampshire County","MA","Chesterfield","1997","Chesterfield town, MA",25,720,745
"1458","Chesterfield","Hampshire County","MA","Chesterfield","1998","Chesterfield town, MA",24,757,781
"1459","Chesterfield","Hampshire County","MA","Chesterfield","1999","Chesterfield town, MA",20,827,847
"1460","Chesterfield","Hampshire County","MA","Chesterfield","2000","Chesterfield town, MA",13,706,719
"1461","Chesterfield","Hampshire County","MA","Chesterfield","2001","Chesterfield town, MA",19,717,736
"1462","Chesterfield","Hampshire County","MA","Chesterfield","2002","Chesterfield town, MA",24,713,737
"1463","Chesterfield","Hampshire County","MA","Chesterfield","2003","Chesterfield town, MA",30,716,746
"1464","Chesterfield","Hampshire County","MA","Chesterfield","2004","Chesterfield town, MA",30,723,753
"1465","Chesterfield","Hampshire County","MA","Chesterfield","2005","Chesterfield town, MA",22,732,754
"1466","Chesterfield","Hampshire County","MA","Chesterfield","2006","Chesterfield town, MA",34,739,773
"1467","Chesterfield","Hampshire County","MA","Chesterfield","2007","Chesterfield town, MA",25,740,765
"1468","Chesterfield","Hampshire County","MA","Chesterfield","2008","Chesterfield town, MA",32,742,774
"1469","Chesterfield","Hampshire County","MA","Chesterfield","2009","Chesterfield town, MA",50,710,760
"1470","Chesterfield","Hampshire County","MA","Chesterfield","2010","Chesterfield town, MA",55,674,729
"1471","Chesterfield","Hampshire County","MA","Chesterfield","2011","Chesterfield town, MA",39,665,704
"1472","Chesterfield","Hampshire County","MA","Chesterfield","2012","Chesterfield town, MA",40,665,705
"1473","Chicopee","Hampden County","MA","Chicopee","1990","Chicopee city, MA",2026,27039,29065
"1474","Chicopee","Hampden County","MA","Chicopee","1991","Chicopee city, MA",2857,26073,28930
"1475","Chicopee","Hampden County","MA","Chicopee","1992","Chicopee city, MA",2663,25802,28465
"1476","Chicopee","Hampden County","MA","Chicopee","1993","Chicopee city, MA",2538,25692,28230
"1477","Chicopee","Hampden County","MA","Chicopee","1994","Chicopee city, MA",1978,25417,27395
"1478","Chicopee","Hampden County","MA","Chicopee","1995","Chicopee city, MA",1794,25469,27263
"1479","Chicopee","Hampden County","MA","Chicopee","1996","Chicopee city, MA",1447,25673,27120
"1480","Chicopee","Hampden County","MA","Chicopee","1997","Chicopee city, MA",1282,26197,27479
"1481","Chicopee","Hampden County","MA","Chicopee","1998","Chicopee city, MA",1143,26221,27364
"1482","Chicopee","Hampden County","MA","Chicopee","1999","Chicopee city, MA",1070,26214,27284
"1483","Chicopee","Hampden County","MA","Chicopee","2000","Chicopee city, MA",899,26521,27420
"1484","Chicopee","Hampden County","MA","Chicopee","2001","Chicopee city, MA",1168,26548,27716
"1485","Chicopee","Hampden County","MA","Chicopee","2002","Chicopee city, MA",1609,26398,28007
"1486","Chicopee","Hampden County","MA","Chicopee","2003","Chicopee city, MA",1880,26129,28009
"1487","Chicopee","Hampden County","MA","Chicopee","2004","Chicopee city, MA",1750,26078,27828
"1488","Chicopee","Hampden County","MA","Chicopee","2005","Chicopee city, MA",1605,26103,27708
"1489","Chicopee","Hampden County","MA","Chicopee","2006","Chicopee city, MA",1642,26160,27802
"1490","Chicopee","Hampden County","MA","Chicopee","2007","Chicopee city, MA",1571,25967,27538
"1491","Chicopee","Hampden County","MA","Chicopee","2008","Chicopee city, MA",1818,26244,28062
"1492","Chicopee","Hampden County","MA","Chicopee","2009","Chicopee city, MA",2740,25491,28231
"1493","Chicopee","Hampden County","MA","Chicopee","2010","Chicopee city, MA",2774,25275,28049
"1494","Chicopee","Hampden County","MA","Chicopee","2011","Chicopee city, MA",2454,25022,27476
"1495","Chicopee","Hampden County","MA","Chicopee","2012","Chicopee city, MA",2214,25037,27251
"1496","Chilmark","Dukes County","MA","Chilmark","1990","Chilmark town, MA",13,353,366
"1497","Chilmark","Dukes County","MA","Chilmark","1991","Chilmark town, MA",14,386,400
"1498","Chilmark","Dukes County","MA","Chilmark","1992","Chilmark town, MA",12,369,381
"1499","Chilmark","Dukes County","MA","Chilmark","1993","Chilmark town, MA",19,379,398
"1500","Chilmark","Dukes County","MA","Chilmark","1994","Chilmark town, MA",21,428,449
"1501","Chilmark","Dukes County","MA","Chilmark","1995","Chilmark town, MA",11,416,427
"1502","Chilmark","Dukes County","MA","Chilmark","1996","Chilmark town, MA",16,437,453
"1503","Chilmark","Dukes County","MA","Chilmark","1997","Chilmark town, MA",12,451,463
"1504","Chilmark","Dukes County","MA","Chilmark","1998","Chilmark town, MA",11,449,460
"1505","Chilmark","Dukes County","MA","Chilmark","1999","Chilmark town, MA",21,457,478
"1506","Chilmark","Dukes County","MA","Chilmark","2000","Chilmark town, MA",16,543,559
"1507","Chilmark","Dukes County","MA","Chilmark","2001","Chilmark town, MA",11,551,562
"1508","Chilmark","Dukes County","MA","Chilmark","2002","Chilmark town, MA",14,580,594
"1509","Chilmark","Dukes County","MA","Chilmark","2003","Chilmark town, MA",17,612,629
"1510","Chilmark","Dukes County","MA","Chilmark","2004","Chilmark town, MA",14,626,640
"1511","Chilmark","Dukes County","MA","Chilmark","2005","Chilmark town, MA",17,628,645
"1512","Chilmark","Dukes County","MA","Chilmark","2006","Chilmark town, MA",19,642,661
"1513","Chilmark","Dukes County","MA","Chilmark","2007","Chilmark town, MA",18,656,674
"1514","Chilmark","Dukes County","MA","Chilmark","2008","Chilmark town, MA",19,661,680
"1515","Chilmark","Dukes County","MA","Chilmark","2009","Chilmark town, MA",22,585,607
"1516","Chilmark","Dukes County","MA","Chilmark","2010","Chilmark town, MA",36,549,585
"1517","Chilmark","Dukes County","MA","Chilmark","2011","Chilmark town, MA",32,554,586
"1518","Chilmark","Dukes County","MA","Chilmark","2012","Chilmark town, MA",30,559,589
"1519","Clarksburg","Berkshire County","MA","Clarksburg","1990","Clarksburg town, MA",50,879,929
"1520","Clarksburg","Berkshire County","MA","Clarksburg","1991","Clarksburg town, MA",102,855,957
"1521","Clarksburg","Berkshire County","MA","Clarksburg","1992","Clarksburg town, MA",96,844,940
"1522","Clarksburg","Berkshire County","MA","Clarksburg","1993","Clarksburg town, MA",81,888,969
"1523","Clarksburg","Berkshire County","MA","Clarksburg","1994","Clarksburg town, MA",72,884,956
"1524","Clarksburg","Berkshire County","MA","Clarksburg","1995","Clarksburg town, MA",56,842,898
"1525","Clarksburg","Berkshire County","MA","Clarksburg","1996","Clarksburg town, MA",58,852,910
"1526","Clarksburg","Berkshire County","MA","Clarksburg","1997","Clarksburg town, MA",40,863,903
"1527","Clarksburg","Berkshire County","MA","Clarksburg","1998","Clarksburg town, MA",39,798,837
"1528","Clarksburg","Berkshire County","MA","Clarksburg","1999","Clarksburg town, MA",40,808,848
"1529","Clarksburg","Berkshire County","MA","Clarksburg","2000","Clarksburg town, MA",26,888,914
"1530","Clarksburg","Berkshire County","MA","Clarksburg","2001","Clarksburg town, MA",32,895,927
"1531","Clarksburg","Berkshire County","MA","Clarksburg","2002","Clarksburg town, MA",42,894,936
"1532","Clarksburg","Berkshire County","MA","Clarksburg","2003","Clarksburg town, MA",47,886,933
"1533","Clarksburg","Berkshire County","MA","Clarksburg","2004","Clarksburg town, MA",52,880,932
"1534","Clarksburg","Berkshire County","MA","Clarksburg","2005","Clarksburg town, MA",49,885,934
"1535","Clarksburg","Berkshire County","MA","Clarksburg","2006","Clarksburg town, MA",43,893,936
"1536","Clarksburg","Berkshire County","MA","Clarksburg","2007","Clarksburg town, MA",43,893,936
"1537","Clarksburg","Berkshire County","MA","Clarksburg","2008","Clarksburg town, MA",55,888,943
"1538","Clarksburg","Berkshire County","MA","Clarksburg","2009","Clarksburg town, MA",92,866,958
"1539","Clarksburg","Berkshire County","MA","Clarksburg","2010","Clarksburg town, MA",82,898,980
"1540","Clarksburg","Berkshire County","MA","Clarksburg","2011","Clarksburg town, MA",76,896,972
"1541","Clarksburg","Berkshire County","MA","Clarksburg","2012","Clarksburg town, MA",63,885,948
"1542","Clinton","Worcester County","MA","Clinton","1990","Clinton town, MA",523,6828,7351
"1543","Clinton","Worcester County","MA","Clinton","1991","Clinton town, MA",722,6458,7180
"1544","Clinton","Worcester County","MA","Clinton","1992","Clinton town, MA",724,6446,7170
"1545","Clinton","Worcester County","MA","Clinton","1993","Clinton town, MA",600,6567,7167
"1546","Clinton","Worcester County","MA","Clinton","1994","Clinton town, MA",504,6605,7109
"1547","Clinton","Worcester County","MA","Clinton","1995","Clinton town, MA",474,6721,7195
"1548","Clinton","Worcester County","MA","Clinton","1996","Clinton town, MA",377,6794,7171
"1549","Clinton","Worcester County","MA","Clinton","1997","Clinton town, MA",268,6931,7199
"1550","Clinton","Worcester County","MA","Clinton","1998","Clinton town, MA",241,7060,7301
"1551","Clinton","Worcester County","MA","Clinton","1999","Clinton town, MA",276,7009,7285
"1552","Clinton","Worcester County","MA","Clinton","2000","Clinton town, MA",194,7072,7266
"1553","Clinton","Worcester County","MA","Clinton","2001","Clinton town, MA",302,7086,7388
"1554","Clinton","Worcester County","MA","Clinton","2002","Clinton town, MA",443,7050,7493
"1555","Clinton","Worcester County","MA","Clinton","2003","Clinton town, MA",494,7004,7498
"1556","Clinton","Worcester County","MA","Clinton","2004","Clinton town, MA",464,7049,7513
"1557","Clinton","Worcester County","MA","Clinton","2005","Clinton town, MA",425,7079,7504
"1558","Clinton","Worcester County","MA","Clinton","2006","Clinton town, MA",418,7220,7638
"1559","Clinton","Worcester County","MA","Clinton","2007","Clinton town, MA",396,7205,7601
"1560","Clinton","Worcester County","MA","Clinton","2008","Clinton town, MA",469,7048,7517
"1561","Clinton","Worcester County","MA","Clinton","2009","Clinton town, MA",715,6851,7566
"1562","Clinton","Worcester County","MA","Clinton","2010","Clinton town, MA",748,6588,7336
"1563","Clinton","Worcester County","MA","Clinton","2011","Clinton town, MA",666,6646,7312
"1564","Clinton","Worcester County","MA","Clinton","2012","Clinton town, MA",616,6644,7260
"1565","Cohasset","Norfolk County","MA","Cohasset","1990","Cohasset town, MA",255,3766,4021
"1566","Cohasset","Norfolk County","MA","Cohasset","1991","Cohasset town, MA",264,3681,3945
"1567","Cohasset","Norfolk County","MA","Cohasset","1992","Cohasset town, MA",235,3708,3943
"1568","Cohasset","Norfolk County","MA","Cohasset","1993","Cohasset town, MA",167,3775,3942
"1569","Cohasset","Norfolk County","MA","Cohasset","1994","Cohasset town, MA",137,3903,4040
"1570","Cohasset","Norfolk County","MA","Cohasset","1995","Cohasset town, MA",114,3714,3828
"1571","Cohasset","Norfolk County","MA","Cohasset","1996","Cohasset town, MA",117,3774,3891
"1572","Cohasset","Norfolk County","MA","Cohasset","1997","Cohasset town, MA",86,3864,3950
"1573","Cohasset","Norfolk County","MA","Cohasset","1998","Cohasset town, MA",82,3922,4004
"1574","Cohasset","Norfolk County","MA","Cohasset","1999","Cohasset town, MA",60,3961,4021
"1575","Cohasset","Norfolk County","MA","Cohasset","2000","Cohasset town, MA",77,3625,3702
"1576","Cohasset","Norfolk County","MA","Cohasset","2001","Cohasset town, MA",105,3618,3723
"1577","Cohasset","Norfolk County","MA","Cohasset","2002","Cohasset town, MA",148,3559,3707
"1578","Cohasset","Norfolk County","MA","Cohasset","2003","Cohasset town, MA",164,3504,3668
"1579","Cohasset","Norfolk County","MA","Cohasset","2004","Cohasset town, MA",152,3495,3647
"1580","Cohasset","Norfolk County","MA","Cohasset","2005","Cohasset town, MA",127,3506,3633
"1581","Cohasset","Norfolk County","MA","Cohasset","2006","Cohasset town, MA",115,3506,3621
"1582","Cohasset","Norfolk County","MA","Cohasset","2007","Cohasset town, MA",120,3531,3651
"1583","Cohasset","Norfolk County","MA","Cohasset","2008","Cohasset town, MA",146,3534,3680
"1584","Cohasset","Norfolk County","MA","Cohasset","2009","Cohasset town, MA",232,3433,3665
"1585","Cohasset","Norfolk County","MA","Cohasset","2010","Cohasset town, MA",210,3547,3757
"1586","Cohasset","Norfolk County","MA","Cohasset","2011","Cohasset town, MA",189,3586,3775
"1587","Cohasset","Norfolk County","MA","Cohasset","2012","Cohasset town, MA",182,3626,3808
"1588","Colrain","Franklin County","MA","Colrain","1990","Colrain town, MA",43,822,865
"1589","Colrain","Franklin County","MA","Colrain","1991","Colrain town, MA",67,805,872
"1590","Colrain","Franklin County","MA","Colrain","1992","Colrain town, MA",64,804,868
"1591","Colrain","Franklin County","MA","Colrain","1993","Colrain town, MA",63,811,874
"1592","Colrain","Franklin County","MA","Colrain","1994","Colrain town, MA",47,837,884
"1593","Colrain","Franklin County","MA","Colrain","1995","Colrain town, MA",47,861,908
"1594","Colrain","Franklin County","MA","Colrain","1996","Colrain town, MA",41,863,904
"1595","Colrain","Franklin County","MA","Colrain","1997","Colrain town, MA",57,882,939
"1596","Colrain","Franklin County","MA","Colrain","1998","Colrain town, MA",48,907,955
"1597","Colrain","Franklin County","MA","Colrain","1999","Colrain town, MA",30,927,957
"1598","Colrain","Franklin County","MA","Colrain","2000","Colrain town, MA",25,944,969
"1599","Colrain","Franklin County","MA","Colrain","2001","Colrain town, MA",30,946,976
"1600","Colrain","Franklin County","MA","Colrain","2002","Colrain town, MA",38,966,1004
"1601","Colrain","Franklin County","MA","Colrain","2003","Colrain town, MA",50,974,1024
"1602","Colrain","Franklin County","MA","Colrain","2004","Colrain town, MA",55,956,1011
"1603","Colrain","Franklin County","MA","Colrain","2005","Colrain town, MA",45,954,999
"1604","Colrain","Franklin County","MA","Colrain","2006","Colrain town, MA",48,955,1003
"1605","Colrain","Franklin County","MA","Colrain","2007","Colrain town, MA",38,943,981
"1606","Colrain","Franklin County","MA","Colrain","2008","Colrain town, MA",51,948,999
"1607","Colrain","Franklin County","MA","Colrain","2009","Colrain town, MA",76,929,1005
"1608","Colrain","Franklin County","MA","Colrain","2010","Colrain town, MA",84,834,918
"1609","Colrain","Franklin County","MA","Colrain","2011","Colrain town, MA",59,836,895
"1610","Colrain","Franklin County","MA","Colrain","2012","Colrain town, MA",61,838,899
"1611","Concord","Middlesex County","MA","Concord","1990","Concord town, MA",285,8211,8496
"1612","Concord","Middlesex County","MA","Concord","1991","Concord town, MA",312,8063,8375
"1613","Concord","Middlesex County","MA","Concord","1992","Concord town, MA",340,8072,8412
"1614","Concord","Middlesex County","MA","Concord","1993","Concord town, MA",309,8101,8410
"1615","Concord","Middlesex County","MA","Concord","1994","Concord town, MA",263,8263,8526
"1616","Concord","Middlesex County","MA","Concord","1995","Concord town, MA",215,8426,8641
"1617","Concord","Middlesex County","MA","Concord","1996","Concord town, MA",179,8590,8769
"1618","Concord","Middlesex County","MA","Concord","1997","Concord town, MA",151,8801,8952
"1619","Concord","Middlesex County","MA","Concord","1998","Concord town, MA",141,8885,9026
"1620","Concord","Middlesex County","MA","Concord","1999","Concord town, MA",142,8966,9108
"1621","Concord","Middlesex County","MA","Concord","2000","Concord town, MA",152,7712,7864
"1622","Concord","Middlesex County","MA","Concord","2001","Concord town, MA",231,7663,7894
"1623","Concord","Middlesex County","MA","Concord","2002","Concord town, MA",346,7508,7854
"1624","Concord","Middlesex County","MA","Concord","2003","Concord town, MA",346,7384,7730
"1625","Concord","Middlesex County","MA","Concord","2004","Concord town, MA",304,7390,7694
"1626","Concord","Middlesex County","MA","Concord","2005","Concord town, MA",275,7431,7706
"1627","Concord","Middlesex County","MA","Concord","2006","Concord town, MA",261,7712,7973
"1628","Concord","Middlesex County","MA","Concord","2007","Concord town, MA",233,7682,7915
"1629","Concord","Middlesex County","MA","Concord","2008","Concord town, MA",300,7672,7972
"1630","Concord","Middlesex County","MA","Concord","2009","Concord town, MA",460,7405,7865
"1631","Concord","Middlesex County","MA","Concord","2010","Concord town, MA",463,7554,8017
"1632","Concord","Middlesex County","MA","Concord","2011","Concord town, MA",389,7658,8047
"1633","Concord","Middlesex County","MA","Concord","2012","Concord town, MA",385,7742,8127
"1634","Conway","Franklin County","MA","Conway","1990","Conway town, MA",46,836,882
"1635","Conway","Franklin County","MA","Conway","1991","Conway town, MA",56,835,891
"1636","Conway","Franklin County","MA","Conway","1992","Conway town, MA",71,828,899
"1637","Conway","Franklin County","MA","Conway","1993","Conway town, MA",50,864,914
"1638","Conway","Franklin County","MA","Conway","1994","Conway town, MA",36,928,964
"1639","Conway","Franklin County","MA","Conway","1995","Conway town, MA",36,892,928
"1640","Conway","Franklin County","MA","Conway","1996","Conway town, MA",27,903,930
"1641","Conway","Franklin County","MA","Conway","1997","Conway town, MA",23,925,948
"1642","Conway","Franklin County","MA","Conway","1998","Conway town, MA",22,946,968
"1643","Conway","Franklin County","MA","Conway","1999","Conway town, MA",30,972,1002
"1644","Conway","Franklin County","MA","Conway","2000","Conway town, MA",21,1095,1116
"1645","Conway","Franklin County","MA","Conway","2001","Conway town, MA",28,1112,1140
"1646","Conway","Franklin County","MA","Conway","2002","Conway town, MA",30,1119,1149
"1647","Conway","Franklin County","MA","Conway","2003","Conway town, MA",39,1114,1153
"1648","Conway","Franklin County","MA","Conway","2004","Conway town, MA",36,1118,1154
"1649","Conway","Franklin County","MA","Conway","2005","Conway town, MA",37,1132,1169
"1650","Conway","Franklin County","MA","Conway","2006","Conway town, MA",38,1136,1174
"1651","Conway","Franklin County","MA","Conway","2007","Conway town, MA",32,1130,1162
"1652","Conway","Franklin County","MA","Conway","2008","Conway town, MA",40,1127,1167
"1653","Conway","Franklin County","MA","Conway","2009","Conway town, MA",56,1076,1132
"1654","Conway","Franklin County","MA","Conway","2010","Conway town, MA",62,1079,1141
"1655","Conway","Franklin County","MA","Conway","2011","Conway town, MA",58,1071,1129
"1656","Conway","Franklin County","MA","Conway","2012","Conway town, MA",44,1072,1116
"1657","Cummington","Hampshire County","MA","Cummington","1990","Cummington town, MA",32,448,480
"1658","Cummington","Hampshire County","MA","Cummington","1991","Cummington town, MA",53,422,475
"1659","Cummington","Hampshire County","MA","Cummington","1992","Cummington town, MA",68,475,543
"1660","Cummington","Hampshire County","MA","Cummington","1993","Cummington town, MA",45,485,530
"1661","Cummington","Hampshire County","MA","Cummington","1994","Cummington town, MA",39,517,556
"1662","Cummington","Hampshire County","MA","Cummington","1995","Cummington town, MA",28,521,549
"1663","Cummington","Hampshire County","MA","Cummington","1996","Cummington town, MA",30,505,535
"1664","Cummington","Hampshire County","MA","Cummington","1997","Cummington town, MA",24,508,532
"1665","Cummington","Hampshire County","MA","Cummington","1998","Cummington town, MA",16,531,547
"1666","Cummington","Hampshire County","MA","Cummington","1999","Cummington town, MA",19,574,593
"1667","Cummington","Hampshire County","MA","Cummington","2000","Cummington town, MA",13,499,512
"1668","Cummington","Hampshire County","MA","Cummington","2001","Cummington town, MA",18,499,517
"1669","Cummington","Hampshire County","MA","Cummington","2002","Cummington town, MA",27,496,523
"1670","Cummington","Hampshire County","MA","Cummington","2003","Cummington town, MA",29,496,525
"1671","Cummington","Hampshire County","MA","Cummington","2004","Cummington town, MA",30,497,527
"1672","Cummington","Hampshire County","MA","Cummington","2005","Cummington town, MA",29,496,525
"1673","Cummington","Hampshire County","MA","Cummington","2006","Cummington town, MA",36,497,533
"1674","Cummington","Hampshire County","MA","Cummington","2007","Cummington town, MA",27,494,521
"1675","Cummington","Hampshire County","MA","Cummington","2008","Cummington town, MA",32,484,516
"1676","Cummington","Hampshire County","MA","Cummington","2009","Cummington town, MA",43,465,508
"1677","Cummington","Hampshire County","MA","Cummington","2010","Cummington town, MA",38,419,457
"1678","Cummington","Hampshire County","MA","Cummington","2011","Cummington town, MA",38,414,452
"1679","Cummington","Hampshire County","MA","Cummington","2012","Cummington town, MA",32,414,446
"1680","Dalton","Berkshire County","MA","Dalton","1990","Dalton town, MA",189,3538,3727
"1681","Dalton","Berkshire County","MA","Dalton","1991","Dalton town, MA",302,3386,3688
"1682","Dalton","Berkshire County","MA","Dalton","1992","Dalton town, MA",348,3353,3701
"1683","Dalton","Berkshire County","MA","Dalton","1993","Dalton town, MA",289,3358,3647
"1684","Dalton","Berkshire County","MA","Dalton","1994","Dalton town, MA",238,3338,3576
"1685","Dalton","Berkshire County","MA","Dalton","1995","Dalton town, MA",173,3256,3429
"1686","Dalton","Berkshire County","MA","Dalton","1996","Dalton town, MA",152,3309,3461
"1687","Dalton","Berkshire County","MA","Dalton","1997","Dalton town, MA",146,3333,3479
"1688","Dalton","Berkshire County","MA","Dalton","1998","Dalton town, MA",125,3310,3435
"1689","Dalton","Berkshire County","MA","Dalton","1999","Dalton town, MA",120,3311,3431
"1690","Dalton","Berkshire County","MA","Dalton","2000","Dalton town, MA",89,3605,3694
"1691","Dalton","Berkshire County","MA","Dalton","2001","Dalton town, MA",123,3591,3714
"1692","Dalton","Berkshire County","MA","Dalton","2002","Dalton town, MA",151,3632,3783
"1693","Dalton","Berkshire County","MA","Dalton","2003","Dalton town, MA",171,3604,3775
"1694","Dalton","Berkshire County","MA","Dalton","2004","Dalton town, MA",145,3602,3747
"1695","Dalton","Berkshire County","MA","Dalton","2005","Dalton town, MA",148,3646,3794
"1696","Dalton","Berkshire County","MA","Dalton","2006","Dalton town, MA",149,3702,3851
"1697","Dalton","Berkshire County","MA","Dalton","2007","Dalton town, MA",151,3670,3821
"1698","Dalton","Berkshire County","MA","Dalton","2008","Dalton town, MA",170,3651,3821
"1699","Dalton","Berkshire County","MA","Dalton","2009","Dalton town, MA",287,3527,3814
"1700","Dalton","Berkshire County","MA","Dalton","2010","Dalton town, MA",290,3508,3798
"1701","Dalton","Berkshire County","MA","Dalton","2011","Dalton town, MA",249,3539,3788
"1702","Dalton","Berkshire County","MA","Dalton","2012","Dalton town, MA",240,3523,3763
"1703","Danvers","Essex County","MA","Danvers","1990","Danvers town, MA",702,13101,13803
"1704","Danvers","Essex County","MA","Danvers","1991","Danvers town, MA",946,12795,13741
"1705","Danvers","Essex County","MA","Danvers","1992","Danvers town, MA",1067,12636,13703
"1706","Danvers","Essex County","MA","Danvers","1993","Danvers town, MA",830,12783,13613
"1707","Danvers","Essex County","MA","Danvers","1994","Danvers town, MA",627,13059,13686
"1708","Danvers","Essex County","MA","Danvers","1995","Danvers town, MA",531,13041,13572
"1709","Danvers","Essex County","MA","Danvers","1996","Danvers town, MA",426,13346,13772
"1710","Danvers","Essex County","MA","Danvers","1997","Danvers town, MA",418,13790,14208
"1711","Danvers","Essex County","MA","Danvers","1998","Danvers town, MA",398,14271,14669
"1712","Danvers","Essex County","MA","Danvers","1999","Danvers town, MA",340,14509,14849
"1713","Danvers","Essex County","MA","Danvers","2000","Danvers town, MA",296,13297,13593
"1714","Danvers","Essex County","MA","Danvers","2001","Danvers town, MA",440,13348,13788
"1715","Danvers","Essex County","MA","Danvers","2002","Danvers town, MA",648,13172,13820
"1716","Danvers","Essex County","MA","Danvers","2003","Danvers town, MA",738,13094,13832
"1717","Danvers","Essex County","MA","Danvers","2004","Danvers town, MA",696,13048,13744
"1718","Danvers","Essex County","MA","Danvers","2005","Danvers town, MA",611,13379,13990
"1719","Danvers","Essex County","MA","Danvers","2006","Danvers town, MA",601,13431,14032
"1720","Danvers","Essex County","MA","Danvers","2007","Danvers town, MA",560,13953,14513
"1721","Danvers","Essex County","MA","Danvers","2008","Danvers town, MA",702,13985,14687
"1722","Danvers","Essex County","MA","Danvers","2009","Danvers town, MA",1133,13806,14939
"1723","Danvers","Essex County","MA","Danvers","2010","Danvers town, MA",1071,13459,14530
"1724","Danvers","Essex County","MA","Danvers","2011","Danvers town, MA",913,13612,14525
"1725","Danvers","Essex County","MA","Danvers","2012","Danvers town, MA",895,13717,14612
"1726","Dartmouth","Bristol County","MA","Dartmouth","1990","Dartmouth town, MA",1126,12676,13802
"1727","Dartmouth","Bristol County","MA","Dartmouth","1991","Dartmouth town, MA",1541,12258,13799
"1728","Dartmouth","Bristol County","MA","Dartmouth","1992","Dartmouth town, MA",1499,12245,13744
"1729","Dartmouth","Bristol County","MA","Dartmouth","1993","Dartmouth town, MA",1272,12675,13947
"1730","Dartmouth","Bristol County","MA","Dartmouth","1994","Dartmouth town, MA",1211,13013,14224
"1731","Dartmouth","Bristol County","MA","Dartmouth","1995","Dartmouth town, MA",1080,12769,13849
"1732","Dartmouth","Bristol County","MA","Dartmouth","1996","Dartmouth town, MA",963,12743,13706
"1733","Dartmouth","Bristol County","MA","Dartmouth","1997","Dartmouth town, MA",878,13121,13999
"1734","Dartmouth","Bristol County","MA","Dartmouth","1998","Dartmouth town, MA",735,13757,14492
"1735","Dartmouth","Bristol County","MA","Dartmouth","1999","Dartmouth town, MA",658,13937,14595
"1736","Dartmouth","Bristol County","MA","Dartmouth","2000","Dartmouth town, MA",544,14810,15354
"1737","Dartmouth","Bristol County","MA","Dartmouth","2001","Dartmouth town, MA",633,14453,15086
"1738","Dartmouth","Bristol County","MA","Dartmouth","2002","Dartmouth town, MA",810,14675,15485
"1739","Dartmouth","Bristol County","MA","Dartmouth","2003","Dartmouth town, MA",933,14453,15386
"1740","Dartmouth","Bristol County","MA","Dartmouth","2004","Dartmouth town, MA",867,14609,15476
"1741","Dartmouth","Bristol County","MA","Dartmouth","2005","Dartmouth town, MA",882,14871,15753
"1742","Dartmouth","Bristol County","MA","Dartmouth","2006","Dartmouth town, MA",852,15118,15970
"1743","Dartmouth","Bristol County","MA","Dartmouth","2007","Dartmouth town, MA",875,15100,15975
"1744","Dartmouth","Bristol County","MA","Dartmouth","2008","Dartmouth town, MA",1082,15955,17037
"1745","Dartmouth","Bristol County","MA","Dartmouth","2009","Dartmouth town, MA",1592,15754,17346
"1746","Dartmouth","Bristol County","MA","Dartmouth","2010","Dartmouth town, MA",1688,15357,17045
"1747","Dartmouth","Bristol County","MA","Dartmouth","2011","Dartmouth town, MA",1504,15513,17017
"1748","Dartmouth","Bristol County","MA","Dartmouth","2012","Dartmouth town, MA",1388,15696,17084
"1749","Dedham","Norfolk County","MA","Dedham","1990","Dedham town, MA",661,12245,12906
"1750","Dedham","Norfolk County","MA","Dedham","1991","Dedham town, MA",934,11821,12755
"1751","Dedham","Norfolk County","MA","Dedham","1992","Dedham town, MA",1005,11705,12710
"1752","Dedham","Norfolk County","MA","Dedham","1993","Dedham town, MA",863,11838,12701
"1753","Dedham","Norfolk County","MA","Dedham","1994","Dedham town, MA",728,11901,12629
"1754","Dedham","Norfolk County","MA","Dedham","1995","Dedham town, MA",615,16581,17196
"1755","Dedham","Norfolk County","MA","Dedham","1996","Dedham town, MA",532,16854,17386
"1756","Dedham","Norfolk County","MA","Dedham","1997","Dedham town, MA",510,12592,13102
"1757","Dedham","Norfolk County","MA","Dedham","1998","Dedham town, MA",381,12714,13095
"1758","Dedham","Norfolk County","MA","Dedham","1999","Dedham town, MA",332,12760,13092
"1759","Dedham","Norfolk County","MA","Dedham","2000","Dedham town, MA",324,12139,12463
"1760","Dedham","Norfolk County","MA","Dedham","2001","Dedham town, MA",411,12040,12451
"1761","Dedham","Norfolk County","MA","Dedham","2002","Dedham town, MA",622,11791,12413
"1762","Dedham","Norfolk County","MA","Dedham","2003","Dedham town, MA",651,11565,12216
"1763","Dedham","Norfolk County","MA","Dedham","2004","Dedham town, MA",622,11573,12195
"1764","Dedham","Norfolk County","MA","Dedham","2005","Dedham town, MA",538,11949,12487
"1765","Dedham","Norfolk County","MA","Dedham","2006","Dedham town, MA",547,11867,12414
"1766","Dedham","Norfolk County","MA","Dedham","2007","Dedham town, MA",503,12237,12740
"1767","Dedham","Norfolk County","MA","Dedham","2008","Dedham town, MA",623,12356,12979
"1768","Dedham","Norfolk County","MA","Dedham","2009","Dedham town, MA",960,11919,12879
"1769","Dedham","Norfolk County","MA","Dedham","2010","Dedham town, MA",992,12059,13051
"1770","Dedham","Norfolk County","MA","Dedham","2011","Dedham town, MA",824,12191,13015
"1771","Dedham","Norfolk County","MA","Dedham","2012","Dedham town, MA",766,12325,13091
"1772","Deerfield","Franklin County","MA","Deerfield","1990","Deerfield town, MA",111,2869,2980
"1773","Deerfield","Franklin County","MA","Deerfield","1991","Deerfield town, MA",182,2835,3017
"1774","Deerfield","Franklin County","MA","Deerfield","1992","Deerfield town, MA",193,2782,2975
"1775","Deerfield","Franklin County","MA","Deerfield","1993","Deerfield town, MA",161,2805,2966
"1776","Deerfield","Franklin County","MA","Deerfield","1994","Deerfield town, MA",158,2915,3073
"1777","Deerfield","Franklin County","MA","Deerfield","1995","Deerfield town, MA",127,2847,2974
"1778","Deerfield","Franklin County","MA","Deerfield","1996","Deerfield town, MA",94,2858,2952
"1779","Deerfield","Franklin County","MA","Deerfield","1997","Deerfield town, MA",100,2922,3022
"1780","Deerfield","Franklin County","MA","Deerfield","1998","Deerfield town, MA",89,3094,3183
"1781","Deerfield","Franklin County","MA","Deerfield","1999","Deerfield town, MA",74,3144,3218
"1782","Deerfield","Franklin County","MA","Deerfield","2000","Deerfield town, MA",66,2738,2804
"1783","Deerfield","Franklin County","MA","Deerfield","2001","Deerfield town, MA",80,2748,2828
"1784","Deerfield","Franklin County","MA","Deerfield","2002","Deerfield town, MA",109,2735,2844
"1785","Deerfield","Franklin County","MA","Deerfield","2003","Deerfield town, MA",136,2700,2836
"1786","Deerfield","Franklin County","MA","Deerfield","2004","Deerfield town, MA",103,2713,2816
"1787","Deerfield","Franklin County","MA","Deerfield","2005","Deerfield town, MA",105,2716,2821
"1788","Deerfield","Franklin County","MA","Deerfield","2006","Deerfield town, MA",114,2718,2832
"1789","Deerfield","Franklin County","MA","Deerfield","2007","Deerfield town, MA",111,2711,2822
"1790","Deerfield","Franklin County","MA","Deerfield","2008","Deerfield town, MA",120,2666,2786
"1791","Deerfield","Franklin County","MA","Deerfield","2009","Deerfield town, MA",204,2537,2741
"1792","Deerfield","Franklin County","MA","Deerfield","2010","Deerfield town, MA",197,2784,2981
"1793","Deerfield","Franklin County","MA","Deerfield","2011","Deerfield town, MA",177,2763,2940
"1794","Deerfield","Franklin County","MA","Deerfield","2012","Deerfield town, MA",172,2765,2937
"1795","Dennis","Barnstable County","MA","Dennis","1990","Dennis town, MA",387,6027,6414
"1796","Dennis","Barnstable County","MA","Dennis","1991","Dennis town, MA",607,5687,6294
"1797","Dennis","Barnstable County","MA","Dennis","1992","Dennis town, MA",797,5609,6406
"1798","Dennis","Barnstable County","MA","Dennis","1993","Dennis town, MA",641,5712,6353
"1799","Dennis","Barnstable County","MA","Dennis","1994","Dennis town, MA",596,5817,6413
"1800","Dennis","Barnstable County","MA","Dennis","1995","Dennis town, MA",488,6090,6578
"1801","Dennis","Barnstable County","MA","Dennis","1996","Dennis town, MA",414,6208,6622
"1802","Dennis","Barnstable County","MA","Dennis","1997","Dennis town, MA",405,6267,6672
"1803","Dennis","Barnstable County","MA","Dennis","1998","Dennis town, MA",366,6362,6728
"1804","Dennis","Barnstable County","MA","Dennis","1999","Dennis town, MA",342,6564,6906
"1805","Dennis","Barnstable County","MA","Dennis","2000","Dennis town, MA",301,7543,7844
"1806","Dennis","Barnstable County","MA","Dennis","2001","Dennis town, MA",337,7586,7923
"1807","Dennis","Barnstable County","MA","Dennis","2002","Dennis town, MA",421,7693,8114
"1808","Dennis","Barnstable County","MA","Dennis","2003","Dennis town, MA",483,7838,8321
"1809","Dennis","Barnstable County","MA","Dennis","2004","Dennis town, MA",443,7881,8324
"1810","Dennis","Barnstable County","MA","Dennis","2005","Dennis town, MA",447,7812,8259
"1811","Dennis","Barnstable County","MA","Dennis","2006","Dennis town, MA",439,7788,8227
"1812","Dennis","Barnstable County","MA","Dennis","2007","Dennis town, MA",424,7724,8148
"1813","Dennis","Barnstable County","MA","Dennis","2008","Dennis town, MA",499,7653,8152
"1814","Dennis","Barnstable County","MA","Dennis","2009","Dennis town, MA",723,7482,8205
"1815","Dennis","Barnstable County","MA","Dennis","2010","Dennis town, MA",771,6985,7756
"1816","Dennis","Barnstable County","MA","Dennis","2011","Dennis town, MA",649,6973,7622
"1817","Dennis","Barnstable County","MA","Dennis","2012","Dennis town, MA",571,7090,7661
"1818","Dighton","Bristol County","MA","Dighton","1990","Dighton town, MA",215,2858,3073
"1819","Dighton","Bristol County","MA","Dighton","1991","Dighton town, MA",298,2793,3091
"1820","Dighton","Bristol County","MA","Dighton","1992","Dighton town, MA",315,2809,3124
"1821","Dighton","Bristol County","MA","Dighton","1993","Dighton town, MA",252,2782,3034
"1822","Dighton","Bristol County","MA","Dighton","1994","Dighton town, MA",231,2859,3090
"1823","Dighton","Bristol County","MA","Dighton","1995","Dighton town, MA",190,2926,3116
"1824","Dighton","Bristol County","MA","Dighton","1996","Dighton town, MA",153,2990,3143
"1825","Dighton","Bristol County","MA","Dighton","1997","Dighton town, MA",152,3070,3222
"1826","Dighton","Bristol County","MA","Dighton","1998","Dighton town, MA",111,3113,3224
"1827","Dighton","Bristol County","MA","Dighton","1999","Dighton town, MA",101,3162,3263
"1828","Dighton","Bristol County","MA","Dighton","2000","Dighton town, MA",96,3406,3502
"1829","Dighton","Bristol County","MA","Dighton","2001","Dighton town, MA",125,3453,3578
"1830","Dighton","Bristol County","MA","Dighton","2002","Dighton town, MA",174,3488,3662
"1831","Dighton","Bristol County","MA","Dighton","2003","Dighton town, MA",192,3519,3711
"1832","Dighton","Bristol County","MA","Dighton","2004","Dighton town, MA",191,3533,3724
"1833","Dighton","Bristol County","MA","Dighton","2005","Dighton town, MA",173,3617,3790
"1834","Dighton","Bristol County","MA","Dighton","2006","Dighton town, MA",180,3690,3870
"1835","Dighton","Bristol County","MA","Dighton","2007","Dighton town, MA",178,3739,3917
"1836","Dighton","Bristol County","MA","Dighton","2008","Dighton town, MA",228,3721,3949
"1837","Dighton","Bristol County","MA","Dighton","2009","Dighton town, MA",335,3608,3943
"1838","Dighton","Bristol County","MA","Dighton","2010","Dighton town, MA",360,3757,4117
"1839","Dighton","Bristol County","MA","Dighton","2011","Dighton town, MA",281,3795,4076
"1840","Dighton","Bristol County","MA","Dighton","2012","Dighton town, MA",272,3784,4056
"1841","Douglas","Worcester County","MA","Douglas","1990","Douglas town, MA",231,2696,2927
"1842","Douglas","Worcester County","MA","Douglas","1991","Douglas town, MA",303,2683,2986
"1843","Douglas","Worcester County","MA","Douglas","1992","Douglas town, MA",307,2832,3139
"1844","Douglas","Worcester County","MA","Douglas","1993","Douglas town, MA",170,3034,3204
"1845","Douglas","Worcester County","MA","Douglas","1994","Douglas town, MA",169,3194,3363
"1846","Douglas","Worcester County","MA","Douglas","1995","Douglas town, MA",138,2912,3050
"1847","Douglas","Worcester County","MA","Douglas","1996","Douglas town, MA",131,3048,3179
"1848","Douglas","Worcester County","MA","Douglas","1997","Douglas town, MA",108,3231,3339
"1849","Douglas","Worcester County","MA","Douglas","1998","Douglas town, MA",100,3533,3633
"1850","Douglas","Worcester County","MA","Douglas","1999","Douglas town, MA",116,3608,3724
"1851","Douglas","Worcester County","MA","Douglas","2000","Douglas town, MA",102,4024,4126
"1852","Douglas","Worcester County","MA","Douglas","2001","Douglas town, MA",139,4122,4261
"1853","Douglas","Worcester County","MA","Douglas","2002","Douglas town, MA",223,4161,4384
"1854","Douglas","Worcester County","MA","Douglas","2003","Douglas town, MA",240,4203,4443
"1855","Douglas","Worcester County","MA","Douglas","2004","Douglas town, MA",215,4250,4465
"1856","Douglas","Worcester County","MA","Douglas","2005","Douglas town, MA",213,4305,4518
"1857","Douglas","Worcester County","MA","Douglas","2006","Douglas town, MA",215,4373,4588
"1858","Douglas","Worcester County","MA","Douglas","2007","Douglas town, MA",222,4389,4611
"1859","Douglas","Worcester County","MA","Douglas","2008","Douglas town, MA",246,4324,4570
"1860","Douglas","Worcester County","MA","Douglas","2009","Douglas town, MA",394,4217,4611
"1861","Douglas","Worcester County","MA","Douglas","2010","Douglas town, MA",365,4427,4792
"1862","Douglas","Worcester County","MA","Douglas","2011","Douglas town, MA",334,4466,4800
"1863","Douglas","Worcester County","MA","Douglas","2012","Douglas town, MA",308,4464,4772
"1864","Dover","Norfolk County","MA","Dover","1990","Dover town, MA",74,2453,2527
"1865","Dover","Norfolk County","MA","Dover","1991","Dover town, MA",114,2408,2522
"1866","Dover","Norfolk County","MA","Dover","1992","Dover town, MA",128,2460,2588
"1867","Dover","Norfolk County","MA","Dover","1993","Dover town, MA",74,2544,2618
"1868","Dover","Norfolk County","MA","Dover","1994","Dover town, MA",94,2681,2775
"1869","Dover","Norfolk County","MA","Dover","1995","Dover town, MA",72,2604,2676
"1870","Dover","Norfolk County","MA","Dover","1996","Dover town, MA",46,2693,2739
"1871","Dover","Norfolk County","MA","Dover","1997","Dover town, MA",50,2782,2832
"1872","Dover","Norfolk County","MA","Dover","1998","Dover town, MA",38,2831,2869
"1873","Dover","Norfolk County","MA","Dover","1999","Dover town, MA",27,2869,2896
"1874","Dover","Norfolk County","MA","Dover","2000","Dover town, MA",43,2796,2839
"1875","Dover","Norfolk County","MA","Dover","2001","Dover town, MA",70,2810,2880
"1876","Dover","Norfolk County","MA","Dover","2002","Dover town, MA",102,2776,2878
"1877","Dover","Norfolk County","MA","Dover","2003","Dover town, MA",97,2743,2840
"1878","Dover","Norfolk County","MA","Dover","2004","Dover town, MA",84,2734,2818
"1879","Dover","Norfolk County","MA","Dover","2005","Dover town, MA",76,2755,2831
"1880","Dover","Norfolk County","MA","Dover","2006","Dover town, MA",72,2715,2787
"1881","Dover","Norfolk County","MA","Dover","2007","Dover town, MA",65,2739,2804
"1882","Dover","Norfolk County","MA","Dover","2008","Dover town, MA",88,2748,2836
"1883","Dover","Norfolk County","MA","Dover","2009","Dover town, MA",145,2671,2816
"1884","Dover","Norfolk County","MA","Dover","2010","Dover town, MA",135,2644,2779
"1885","Dover","Norfolk County","MA","Dover","2011","Dover town, MA",117,2673,2790
"1886","Dover","Norfolk County","MA","Dover","2012","Dover town, MA",110,2703,2813
"1887","Dracut","Middlesex County","MA","Dracut","1990","Dracut town, MA",1149,14209,15358
"1888","Dracut","Middlesex County","MA","Dracut","1991","Dracut town, MA",1585,13860,15445
"1889","Dracut","Middlesex County","MA","Dracut","1992","Dracut town, MA",1765,14008,15773
"1890","Dracut","Middlesex County","MA","Dracut","1993","Dracut town, MA",1498,14141,15639
"1891","Dracut","Middlesex County","MA","Dracut","1994","Dracut town, MA",1206,14443,15649
"1892","Dracut","Middlesex County","MA","Dracut","1995","Dracut town, MA",970,14530,15500
"1893","Dracut","Middlesex County","MA","Dracut","1996","Dracut town, MA",749,15071,15820
"1894","Dracut","Middlesex County","MA","Dracut","1997","Dracut town, MA",658,15693,16351
"1895","Dracut","Middlesex County","MA","Dracut","1998","Dracut town, MA",541,16088,16629
"1896","Dracut","Middlesex County","MA","Dracut","1999","Dracut town, MA",563,16563,17126
"1897","Dracut","Middlesex County","MA","Dracut","2000","Dracut town, MA",413,15877,16290
"1898","Dracut","Middlesex County","MA","Dracut","2001","Dracut town, MA",584,15966,16550
"1899","Dracut","Middlesex County","MA","Dracut","2002","Dracut town, MA",995,15640,16635
"1900","Dracut","Middlesex County","MA","Dracut","2003","Dracut town, MA",994,15398,16392
"1901","Dracut","Middlesex County","MA","Dracut","2004","Dracut town, MA",930,15271,16201
"1902","Dracut","Middlesex County","MA","Dracut","2005","Dracut town, MA",799,15494,16293
"1903","Dracut","Middlesex County","MA","Dracut","2006","Dracut town, MA",781,15741,16522
"1904","Dracut","Middlesex County","MA","Dracut","2007","Dracut town, MA",777,15796,16573
"1905","Dracut","Middlesex County","MA","Dracut","2008","Dracut town, MA",892,15755,16647
"1906","Dracut","Middlesex County","MA","Dracut","2009","Dracut town, MA",1438,15252,16690
"1907","Dracut","Middlesex County","MA","Dracut","2010","Dracut town, MA",1470,15387,16857
"1908","Dracut","Middlesex County","MA","Dracut","2011","Dracut town, MA",1217,15555,16772
"1909","Dracut","Middlesex County","MA","Dracut","2012","Dracut town, MA",1132,15726,16858
"1910","Dudley","Worcester County","MA","Dudley","1990","Dudley town, MA",337,4863,5200
"1911","Dudley","Worcester County","MA","Dudley","1991","Dudley town, MA",489,4745,5234
"1912","Dudley","Worcester County","MA","Dudley","1992","Dudley town, MA",519,4699,5218
"1913","Dudley","Worcester County","MA","Dudley","1993","Dudley town, MA",399,4789,5188
"1914","Dudley","Worcester County","MA","Dudley","1994","Dudley town, MA",295,4858,5153
"1915","Dudley","Worcester County","MA","Dudley","1995","Dudley town, MA",252,4880,5132
"1916","Dudley","Worcester County","MA","Dudley","1996","Dudley town, MA",225,4974,5199
"1917","Dudley","Worcester County","MA","Dudley","1997","Dudley town, MA",212,5111,5323
"1918","Dudley","Worcester County","MA","Dudley","1998","Dudley town, MA",220,4967,5187
"1919","Dudley","Worcester County","MA","Dudley","1999","Dudley town, MA",191,4958,5149
"1920","Dudley","Worcester County","MA","Dudley","2000","Dudley town, MA",149,5421,5570
"1921","Dudley","Worcester County","MA","Dudley","2001","Dudley town, MA",214,5471,5685
"1922","Dudley","Worcester County","MA","Dudley","2002","Dudley town, MA",305,5520,5825
"1923","Dudley","Worcester County","MA","Dudley","2003","Dudley town, MA",379,5578,5957
"1924","Dudley","Worcester County","MA","Dudley","2004","Dudley town, MA",334,5595,5929
"1925","Dudley","Worcester County","MA","Dudley","2005","Dudley town, MA",321,5597,5918
"1926","Dudley","Worcester County","MA","Dudley","2006","Dudley town, MA",324,5648,5972
"1927","Dudley","Worcester County","MA","Dudley","2007","Dudley town, MA",301,5695,5996
"1928","Dudley","Worcester County","MA","Dudley","2008","Dudley town, MA",355,5719,6074
"1929","Dudley","Worcester County","MA","Dudley","2009","Dudley town, MA",556,5548,6104
"1930","Dudley","Worcester County","MA","Dudley","2010","Dudley town, MA",547,5644,6191
"1931","Dudley","Worcester County","MA","Dudley","2011","Dudley town, MA",471,5692,6163
"1932","Dudley","Worcester County","MA","Dudley","2012","Dudley town, MA",435,5690,6125
"1933",NA,"Dukes County","MA","Dukes County","1990","Dukes County, MA",382,7149,7531
"1934",NA,"Dukes County","MA","Dukes County","1991","Dukes County, MA",562,7292,7854
"1935",NA,"Dukes County","MA","Dukes County","1992","Dukes County, MA",596,6916,7512
"1936",NA,"Dukes County","MA","Dukes County","1993","Dukes County, MA",583,7180,7763
"1937",NA,"Dukes County","MA","Dukes County","1994","Dukes County, MA",565,7772,8337
"1938",NA,"Dukes County","MA","Dukes County","1995","Dukes County, MA",496,8217,8713
"1939",NA,"Dukes County","MA","Dukes County","1996","Dukes County, MA",486,8582,9068
"1940",NA,"Dukes County","MA","Dukes County","1997","Dukes County, MA",468,8815,9283
"1941",NA,"Dukes County","MA","Dukes County","1998","Dukes County, MA",382,9009,9391
"1942",NA,"Dukes County","MA","Dukes County","1999","Dukes County, MA",370,9164,9534
"1943",NA,"Dukes County","MA","Dukes County","2000","Dukes County, MA",281,9794,10075
"1944",NA,"Dukes County","MA","Dukes County","2001","Dukes County, MA",296,9855,10151
"1945",NA,"Dukes County","MA","Dukes County","2002","Dukes County, MA",407,10228,10635
"1946",NA,"Dukes County","MA","Dukes County","2003","Dukes County, MA",469,10607,11076
"1947",NA,"Dukes County","MA","Dukes County","2004","Dukes County, MA",450,10685,11135
"1948",NA,"Dukes County","MA","Dukes County","2005","Dukes County, MA",431,10543,10974
"1949",NA,"Dukes County","MA","Dukes County","2006","Dukes County, MA",430,10639,11069
"1950",NA,"Dukes County","MA","Dukes County","2007","Dukes County, MA",393,10752,11145
"1951",NA,"Dukes County","MA","Dukes County","2008","Dukes County, MA",466,10758,11224
"1952",NA,"Dukes County","MA","Dukes County","2009","Dukes County, MA",727,10604,11331
"1953",NA,"Dukes County","MA","Dukes County","2010","Dukes County, MA",877,10670,11547
"1954",NA,"Dukes County","MA","Dukes County","2011","Dukes County, MA",843,10752,11595
"1955",NA,"Dukes County","MA","Dukes County","2012","Dukes County, MA",805,10860,11665
"1956","Dunstable","Middlesex County","MA","Dunstable","1990","Dunstable town, MA",78,1272,1350
"1957","Dunstable","Middlesex County","MA","Dunstable","1991","Dunstable town, MA",108,1269,1377
"1958","Dunstable","Middlesex County","MA","Dunstable","1992","Dunstable town, MA",114,1298,1412
"1959","Dunstable","Middlesex County","MA","Dunstable","1993","Dunstable town, MA",65,1331,1396
"1960","Dunstable","Middlesex County","MA","Dunstable","1994","Dunstable town, MA",69,1356,1425
"1961","Dunstable","Middlesex County","MA","Dunstable","1995","Dunstable town, MA",61,1351,1412
"1962","Dunstable","Middlesex County","MA","Dunstable","1996","Dunstable town, MA",52,1432,1484
"1963","Dunstable","Middlesex County","MA","Dunstable","1997","Dunstable town, MA",50,1522,1572
"1964","Dunstable","Middlesex County","MA","Dunstable","1998","Dunstable town, MA",44,1592,1636
"1965","Dunstable","Middlesex County","MA","Dunstable","1999","Dunstable town, MA",40,1679,1719
"1966","Dunstable","Middlesex County","MA","Dunstable","2000","Dunstable town, MA",35,1638,1673
"1967","Dunstable","Middlesex County","MA","Dunstable","2001","Dunstable town, MA",52,1685,1737
"1968","Dunstable","Middlesex County","MA","Dunstable","2002","Dunstable town, MA",88,1684,1772
"1969","Dunstable","Middlesex County","MA","Dunstable","2003","Dunstable town, MA",90,1693,1783
"1970","Dunstable","Middlesex County","MA","Dunstable","2004","Dunstable town, MA",75,1711,1786
"1971","Dunstable","Middlesex County","MA","Dunstable","2005","Dunstable town, MA",64,1752,1816
"1972","Dunstable","Middlesex County","MA","Dunstable","2006","Dunstable town, MA",64,1788,1852
"1973","Dunstable","Middlesex County","MA","Dunstable","2007","Dunstable town, MA",62,1825,1887
"1974","Dunstable","Middlesex County","MA","Dunstable","2008","Dunstable town, MA",74,1838,1912
"1975","Dunstable","Middlesex County","MA","Dunstable","2009","Dunstable town, MA",119,1819,1938
"1976","Dunstable","Middlesex County","MA","Dunstable","2010","Dunstable town, MA",110,1720,1830
"1977","Dunstable","Middlesex County","MA","Dunstable","2011","Dunstable town, MA",102,1739,1841
"1978","Dunstable","Middlesex County","MA","Dunstable","2012","Dunstable town, MA",98,1758,1856
"1979","Duxbury","Plymouth County","MA","Duxbury","1990","Duxbury town, MA",320,6829,7149
"1980","Duxbury","Plymouth County","MA","Duxbury","1991","Duxbury town, MA",409,6643,7052
"1981","Duxbury","Plymouth County","MA","Duxbury","1992","Duxbury town, MA",459,6624,7083
"1982","Duxbury","Plymouth County","MA","Duxbury","1993","Duxbury town, MA",362,6786,7148
"1983","Duxbury","Plymouth County","MA","Duxbury","1994","Duxbury town, MA",324,7014,7338
"1984","Duxbury","Plymouth County","MA","Duxbury","1995","Duxbury town, MA",265,7227,7492
"1985","Duxbury","Plymouth County","MA","Duxbury","1996","Duxbury town, MA",219,7422,7641
"1986","Duxbury","Plymouth County","MA","Duxbury","1997","Duxbury town, MA",196,7670,7866
"1987","Duxbury","Plymouth County","MA","Duxbury","1998","Duxbury town, MA",177,7859,8036
"1988","Duxbury","Plymouth County","MA","Duxbury","1999","Duxbury town, MA",182,8013,8195
"1989","Duxbury","Plymouth County","MA","Duxbury","2000","Duxbury town, MA",158,7050,7208
"1990","Duxbury","Plymouth County","MA","Duxbury","2001","Duxbury town, MA",221,7074,7295
"1991","Duxbury","Plymouth County","MA","Duxbury","2002","Duxbury town, MA",315,7019,7334
"1992","Duxbury","Plymouth County","MA","Duxbury","2003","Duxbury town, MA",322,6964,7286
"1993","Duxbury","Plymouth County","MA","Duxbury","2004","Duxbury town, MA",292,6983,7275
"1994","Duxbury","Plymouth County","MA","Duxbury","2005","Duxbury town, MA",283,7042,7325
"1995","Duxbury","Plymouth County","MA","Duxbury","2006","Duxbury town, MA",255,6724,6979
"1996","Duxbury","Plymouth County","MA","Duxbury","2007","Duxbury town, MA",255,6773,7028
"1997","Duxbury","Plymouth County","MA","Duxbury","2008","Duxbury town, MA",313,6775,7088
"1998","Duxbury","Plymouth County","MA","Duxbury","2009","Duxbury town, MA",491,6584,7075
"1999","Duxbury","Plymouth County","MA","Duxbury","2010","Duxbury town, MA",502,7007,7509
"2000","Duxbury","Plymouth County","MA","Duxbury","2011","Duxbury town, MA",404,7075,7479
"2001","Duxbury","Plymouth County","MA","Duxbury","2012","Duxbury town, MA",395,7152,7547
"2002","East Bridgewater","Plymouth County","MA","East Bridgewater","1990","East Bridgewater town, MA",401,5748,6149
"2003","East Bridgewater","Plymouth County","MA","East Bridgewater","1991","East Bridgewater town, MA",759,5616,6375
"2004","East Bridgewater","Plymouth County","MA","East Bridgewater","1992","East Bridgewater town, MA",689,5673,6362
"2005","East Bridgewater","Plymouth County","MA","East Bridgewater","1993","East Bridgewater town, MA",475,5927,6402
"2006","East Bridgewater","Plymouth County","MA","East Bridgewater","1994","East Bridgewater town, MA",426,6283,6709
"2007","East Bridgewater","Plymouth County","MA","East Bridgewater","1995","East Bridgewater town, MA",380,6306,6686
"2008","East Bridgewater","Plymouth County","MA","East Bridgewater","1996","East Bridgewater town, MA",319,6403,6722
"2009","East Bridgewater","Plymouth County","MA","East Bridgewater","1997","East Bridgewater town, MA",314,6664,6978
"2010","East Bridgewater","Plymouth County","MA","East Bridgewater","1998","East Bridgewater town, MA",216,6811,7027
"2011","East Bridgewater","Plymouth County","MA","East Bridgewater","1999","East Bridgewater town, MA",201,6991,7192
"2012","East Bridgewater","Plymouth County","MA","East Bridgewater","2000","East Bridgewater town, MA",179,6977,7156
"2013","East Bridgewater","Plymouth County","MA","East Bridgewater","2001","East Bridgewater town, MA",228,7030,7258
"2014","East Bridgewater","Plymouth County","MA","East Bridgewater","2002","East Bridgewater town, MA",339,7022,7361
"2015","East Bridgewater","Plymouth County","MA","East Bridgewater","2003","East Bridgewater town, MA",389,6938,7327
"2016","East Bridgewater","Plymouth County","MA","East Bridgewater","2004","East Bridgewater town, MA",352,6934,7286
"2017","East Bridgewater","Plymouth County","MA","East Bridgewater","2005","East Bridgewater town, MA",344,7041,7385
"2018","East Bridgewater","Plymouth County","MA","East Bridgewater","2006","East Bridgewater town, MA",360,7172,7532
"2019","East Bridgewater","Plymouth County","MA","East Bridgewater","2007","East Bridgewater town, MA",338,7241,7579
"2020","East Bridgewater","Plymouth County","MA","East Bridgewater","2008","East Bridgewater town, MA",431,7251,7682
"2021","East Bridgewater","Plymouth County","MA","East Bridgewater","2009","East Bridgewater town, MA",666,7057,7723
"2022","East Bridgewater","Plymouth County","MA","East Bridgewater","2010","East Bridgewater town, MA",664,6898,7562
"2023","East Bridgewater","Plymouth County","MA","East Bridgewater","2011","East Bridgewater town, MA",612,6960,7572
"2024","East Bridgewater","Plymouth County","MA","East Bridgewater","2012","East Bridgewater town, MA",543,7022,7565
"2025","East Brookfield","Worcester County","MA","East Brookfield","1990","East Brookfield town, MA",72,984,1056
"2026","East Brookfield","Worcester County","MA","East Brookfield","1991","East Brookfield town, MA",151,975,1126
"2027","East Brookfield","Worcester County","MA","East Brookfield","1992","East Brookfield town, MA",112,934,1046
"2028","East Brookfield","Worcester County","MA","East Brookfield","1993","East Brookfield town, MA",86,971,1057
"2029","East Brookfield","Worcester County","MA","East Brookfield","1994","East Brookfield town, MA",51,978,1029
"2030","East Brookfield","Worcester County","MA","East Brookfield","1995","East Brookfield town, MA",59,968,1027
"2031","East Brookfield","Worcester County","MA","East Brookfield","1996","East Brookfield town, MA",64,978,1042
"2032","East Brookfield","Worcester County","MA","East Brookfield","1997","East Brookfield town, MA",48,1001,1049
"2033","East Brookfield","Worcester County","MA","East Brookfield","1998","East Brookfield town, MA",39,1018,1057
"2034","East Brookfield","Worcester County","MA","East Brookfield","1999","East Brookfield town, MA",40,1015,1055
"2035","East Brookfield","Worcester County","MA","East Brookfield","2000","East Brookfield town, MA",35,1168,1203
"2036","East Brookfield","Worcester County","MA","East Brookfield","2001","East Brookfield town, MA",37,1164,1201
"2037","East Brookfield","Worcester County","MA","East Brookfield","2002","East Brookfield town, MA",52,1154,1206
"2038","East Brookfield","Worcester County","MA","East Brookfield","2003","East Brookfield town, MA",63,1145,1208
"2039","East Brookfield","Worcester County","MA","East Brookfield","2004","East Brookfield town, MA",67,1139,1206
"2040","East Brookfield","Worcester County","MA","East Brookfield","2005","East Brookfield town, MA",48,1130,1178
"2041","East Brookfield","Worcester County","MA","East Brookfield","2006","East Brookfield town, MA",51,1129,1180
"2042","East Brookfield","Worcester County","MA","East Brookfield","2007","East Brookfield town, MA",51,1125,1176
"2043","East Brookfield","Worcester County","MA","East Brookfield","2008","East Brookfield town, MA",59,1097,1156
"2044","East Brookfield","Worcester County","MA","East Brookfield","2009","East Brookfield town, MA",107,1066,1173
"2045","East Brookfield","Worcester County","MA","East Brookfield","2010","East Brookfield town, MA",98,1119,1217
"2046","East Brookfield","Worcester County","MA","East Brookfield","2011","East Brookfield town, MA",95,1128,1223
"2047","East Brookfield","Worcester County","MA","East Brookfield","2012","East Brookfield town, MA",80,1128,1208
"2048","East Longmeadow","Hampden County","MA","East Longmeadow","1990","East Longmeadow town, MA",299,6585,6884
"2049","East Longmeadow","Hampden County","MA","East Longmeadow","1991","East Longmeadow town, MA",460,6440,6900
"2050","East Longmeadow","Hampden County","MA","East Longmeadow","1992","East Longmeadow town, MA",530,6493,7023
"2051","East Longmeadow","Hampden County","MA","East Longmeadow","1993","East Longmeadow town, MA",461,6585,7046
"2052","East Longmeadow","Hampden County","MA","East Longmeadow","1994","East Longmeadow town, MA",378,6737,7115
"2053","East Longmeadow","Hampden County","MA","East Longmeadow","1995","East Longmeadow town, MA",315,6601,6916
"2054","East Longmeadow","Hampden County","MA","East Longmeadow","1996","East Longmeadow town, MA",251,6742,6993
"2055","East Longmeadow","Hampden County","MA","East Longmeadow","1997","East Longmeadow town, MA",258,6938,7196
"2056","East Longmeadow","Hampden County","MA","East Longmeadow","1998","East Longmeadow town, MA",208,6970,7178
"2057","East Longmeadow","Hampden County","MA","East Longmeadow","1999","East Longmeadow town, MA",201,7004,7205
"2058","East Longmeadow","Hampden County","MA","East Longmeadow","2000","East Longmeadow town, MA",188,7166,7354
"2059","East Longmeadow","Hampden County","MA","East Longmeadow","2001","East Longmeadow town, MA",216,7247,7463
"2060","East Longmeadow","Hampden County","MA","East Longmeadow","2002","East Longmeadow town, MA",294,7301,7595
"2061","East Longmeadow","Hampden County","MA","East Longmeadow","2003","East Longmeadow town, MA",359,7304,7663
"2062","East Longmeadow","Hampden County","MA","East Longmeadow","2004","East Longmeadow town, MA",334,7358,7692
"2063","East Longmeadow","Hampden County","MA","East Longmeadow","2005","East Longmeadow town, MA",325,7424,7749
"2064","East Longmeadow","Hampden County","MA","East Longmeadow","2006","East Longmeadow town, MA",297,7500,7797
"2065","East Longmeadow","Hampden County","MA","East Longmeadow","2007","East Longmeadow town, MA",318,7664,7982
"2066","East Longmeadow","Hampden County","MA","East Longmeadow","2008","East Longmeadow town, MA",367,7652,8019
"2067","East Longmeadow","Hampden County","MA","East Longmeadow","2009","East Longmeadow town, MA",523,7577,8100
"2068","East Longmeadow","Hampden County","MA","East Longmeadow","2010","East Longmeadow town, MA",572,7506,8078
"2069","East Longmeadow","Hampden County","MA","East Longmeadow","2011","East Longmeadow town, MA",489,7432,7921
"2070","East Longmeadow","Hampden County","MA","East Longmeadow","2012","East Longmeadow town, MA",472,7437,7909
"2071","Eastham","Barnstable County","MA","Eastham","1990","Eastham town, MA",137,2191,2328
"2072","Eastham","Barnstable County","MA","Eastham","1991","Eastham town, MA",213,2119,2332
"2073","Eastham","Barnstable County","MA","Eastham","1992","Eastham town, MA",224,2094,2318
"2074","Eastham","Barnstable County","MA","Eastham","1993","Eastham town, MA",206,2141,2347
"2075","Eastham","Barnstable County","MA","Eastham","1994","Eastham town, MA",187,2187,2374
"2076","Eastham","Barnstable County","MA","Eastham","1995","Eastham town, MA",168,2306,2474
"2077","Eastham","Barnstable County","MA","Eastham","1996","Eastham town, MA",142,2362,2504
"2078","Eastham","Barnstable County","MA","Eastham","1997","Eastham town, MA",150,2399,2549
"2079","Eastham","Barnstable County","MA","Eastham","1998","Eastham town, MA",131,2458,2589
"2080","Eastham","Barnstable County","MA","Eastham","1999","Eastham town, MA",113,2571,2684
"2081","Eastham","Barnstable County","MA","Eastham","2000","Eastham town, MA",106,2510,2616
"2082","Eastham","Barnstable County","MA","Eastham","2001","Eastham town, MA",114,2550,2664
"2083","Eastham","Barnstable County","MA","Eastham","2002","Eastham town, MA",144,2596,2740
"2084","Eastham","Barnstable County","MA","Eastham","2003","Eastham town, MA",157,2648,2805
"2085","Eastham","Barnstable County","MA","Eastham","2004","Eastham town, MA",154,2670,2824
"2086","Eastham","Barnstable County","MA","Eastham","2005","Eastham town, MA",153,2652,2805
"2087","Eastham","Barnstable County","MA","Eastham","2006","Eastham town, MA",148,2658,2806
"2088","Eastham","Barnstable County","MA","Eastham","2007","Eastham town, MA",136,2643,2779
"2089","Eastham","Barnstable County","MA","Eastham","2008","Eastham town, MA",175,2636,2811
"2090","Eastham","Barnstable County","MA","Eastham","2009","Eastham town, MA",253,2574,2827
"2091","Eastham","Barnstable County","MA","Eastham","2010","Eastham town, MA",280,2368,2648
"2092","Eastham","Barnstable County","MA","Eastham","2011","Eastham town, MA",234,2365,2599
"2093","Eastham","Barnstable County","MA","Eastham","2012","Eastham town, MA",235,2404,2639
"2094","Easthampton","Hampshire County","MA","Easthampton","1990","Easthampton Town city, MA",498,8136,8634
"2095","Easthampton","Hampshire County","MA","Easthampton","1991","Easthampton Town city, MA",764,7822,8586
"2096","Easthampton","Hampshire County","MA","Easthampton","1992","Easthampton Town city, MA",748,7795,8543
"2097","Easthampton","Hampshire County","MA","Easthampton","1993","Easthampton Town city, MA",564,7814,8378
"2098","Easthampton","Hampshire County","MA","Easthampton","1994","Easthampton Town city, MA",516,7857,8373
"2099","Easthampton","Hampshire County","MA","Easthampton","1995","Easthampton Town city, MA",500,7990,8490
"2100","Easthampton","Hampshire County","MA","Easthampton","1996","Easthampton Town city, MA",347,8127,8474
"2101","Easthampton","Hampshire County","MA","Easthampton","1997","Easthampton Town city, MA",330,8294,8624
"2102","Easthampton","Hampshire County","MA","Easthampton","1998","Easthampton Town city, MA",317,8248,8565
"2103","Easthampton","Hampshire County","MA","Easthampton","1999","Easthampton Town city, MA",265,8303,8568
"2104","Easthampton","Hampshire County","MA","Easthampton","2000","Easthampton Town city, MA",216,9220,9436
"2105","Easthampton","Hampshire County","MA","Easthampton","2001","Easthampton Town city, MA",272,9216,9488
"2106","Easthampton","Hampshire County","MA","Easthampton","2002","Easthampton Town city, MA",365,9191,9556
"2107","Easthampton","Hampshire County","MA","Easthampton","2003","Easthampton Town city, MA",417,9139,9556
"2108","Easthampton","Hampshire County","MA","Easthampton","2004","Easthampton Town city, MA",393,9077,9470
"2109","Easthampton","Hampshire County","MA","Easthampton","2005","Easthampton Town city, MA",384,9077,9461
"2110","Easthampton","Hampshire County","MA","Easthampton","2006","Easthampton Town city, MA",375,9182,9557
"2111","Easthampton","Hampshire County","MA","Easthampton","2007","Easthampton Town city, MA",371,9198,9569
"2112","Easthampton","Hampshire County","MA","Easthampton","2008","Easthampton Town city, MA",460,9191,9651
"2113","Easthampton","Hampshire County","MA","Easthampton","2009","Easthampton Town city, MA",729,8807,9536
"2114","Easthampton","Hampshire County","MA","Easthampton","2010","Easthampton Town city, MA",737,8716,9453
"2115","Easthampton","Hampshire County","MA","Easthampton","2011","Easthampton Town city, MA",625,8608,9233
"2116","Easthampton","Hampshire County","MA","Easthampton","2012","Easthampton Town city, MA",563,8613,9176
"2117","Easton","Bristol County","MA","Easton","1990","Easton town, MA",672,10667,11339
"2118","Easton","Bristol County","MA","Easton","1991","Easton town, MA",992,10263,11255
"2119","Easton","Bristol County","MA","Easton","1992","Easton town, MA",1012,10173,11185
"2120","Easton","Bristol County","MA","Easton","1993","Easton town, MA",776,10712,11488
"2121","Easton","Bristol County","MA","Easton","1994","Easton town, MA",720,11362,12082
"2122","Easton","Bristol County","MA","Easton","1995","Easton town, MA",557,11462,12019
"2123","Easton","Bristol County","MA","Easton","1996","Easton town, MA",531,11574,12105
"2124","Easton","Bristol County","MA","Easton","1997","Easton town, MA",468,11939,12407
"2125","Easton","Bristol County","MA","Easton","1998","Easton town, MA",367,12094,12461
"2126","Easton","Bristol County","MA","Easton","1999","Easton town, MA",383,12283,12666
"2127","Easton","Bristol County","MA","Easton","2000","Easton town, MA",300,12782,13082
"2128","Easton","Bristol County","MA","Easton","2001","Easton town, MA",404,12698,13102
"2129","Easton","Bristol County","MA","Easton","2002","Easton town, MA",563,12637,13200
"2130","Easton","Bristol County","MA","Easton","2003","Easton town, MA",630,12458,13088
"2131","Easton","Bristol County","MA","Easton","2004","Easton town, MA",586,12477,13063
"2132","Easton","Bristol County","MA","Easton","2005","Easton town, MA",535,12501,13036
"2133","Easton","Bristol County","MA","Easton","2006","Easton town, MA",535,12665,13200
"2134","Easton","Bristol County","MA","Easton","2007","Easton town, MA",495,12805,13300
"2135","Easton","Bristol County","MA","Easton","2008","Easton town, MA",631,12848,13479
"2136","Easton","Bristol County","MA","Easton","2009","Easton town, MA",953,12297,13250
"2137","Easton","Bristol County","MA","Easton","2010","Easton town, MA",978,12350,13328
"2138","Easton","Bristol County","MA","Easton","2011","Easton town, MA",817,12412,13229
"2139","Easton","Bristol County","MA","Easton","2012","Easton town, MA",787,12521,13308
"2140","Edgartown","Dukes County","MA","Edgartown","1990","Edgartown town, MA",142,2007,2149
"2141","Edgartown","Dukes County","MA","Edgartown","1991","Edgartown town, MA",224,2042,2266
"2142","Edgartown","Dukes County","MA","Edgartown","1992","Edgartown town, MA",212,1936,2148
"2143","Edgartown","Dukes County","MA","Edgartown","1993","Edgartown town, MA",192,2051,2243
"2144","Edgartown","Dukes County","MA","Edgartown","1994","Edgartown town, MA",203,2209,2412
"2145","Edgartown","Dukes County","MA","Edgartown","1995","Edgartown town, MA",187,2330,2517
"2146","Edgartown","Dukes County","MA","Edgartown","1996","Edgartown town, MA",173,2432,2605
"2147","Edgartown","Dukes County","MA","Edgartown","1997","Edgartown town, MA",164,2498,2662
"2148","Edgartown","Dukes County","MA","Edgartown","1998","Edgartown town, MA",130,2594,2724
"2149","Edgartown","Dukes County","MA","Edgartown","1999","Edgartown town, MA",126,2636,2762
"2150","Edgartown","Dukes County","MA","Edgartown","2000","Edgartown town, MA",81,2484,2565
"2151","Edgartown","Dukes County","MA","Edgartown","2001","Edgartown town, MA",96,2491,2587
"2152","Edgartown","Dukes County","MA","Edgartown","2002","Edgartown town, MA",126,2584,2710
"2153","Edgartown","Dukes County","MA","Edgartown","2003","Edgartown town, MA",135,2687,2822
"2154","Edgartown","Dukes County","MA","Edgartown","2004","Edgartown town, MA",123,2705,2828
"2155","Edgartown","Dukes County","MA","Edgartown","2005","Edgartown town, MA",126,2678,2804
"2156","Edgartown","Dukes County","MA","Edgartown","2006","Edgartown town, MA",128,2704,2832
"2157","Edgartown","Dukes County","MA","Edgartown","2007","Edgartown town, MA",115,2740,2855
"2158","Edgartown","Dukes County","MA","Edgartown","2008","Edgartown town, MA",136,2741,2877
"2159","Edgartown","Dukes County","MA","Edgartown","2009","Edgartown town, MA",215,2717,2932
"2160","Edgartown","Dukes County","MA","Edgartown","2010","Edgartown town, MA",247,2644,2891
"2161","Edgartown","Dukes County","MA","Edgartown","2011","Edgartown town, MA",248,2665,2913
"2162","Edgartown","Dukes County","MA","Edgartown","2012","Edgartown town, MA",228,2692,2920
"2163","Egremont","Berkshire County","MA","Egremont","1990","Egremont town, MA",19,661,680
"2164","Egremont","Berkshire County","MA","Egremont","1991","Egremont town, MA",35,650,685
"2165","Egremont","Berkshire County","MA","Egremont","1992","Egremont town, MA",35,675,710
"2166","Egremont","Berkshire County","MA","Egremont","1993","Egremont town, MA",21,660,681
"2167","Egremont","Berkshire County","MA","Egremont","1994","Egremont town, MA",18,672,690
"2168","Egremont","Berkshire County","MA","Egremont","1995","Egremont town, MA",15,718,733
"2169","Egremont","Berkshire County","MA","Egremont","1996","Egremont town, MA",20,737,757
"2170","Egremont","Berkshire County","MA","Egremont","1997","Egremont town, MA",16,754,770
"2171","Egremont","Berkshire County","MA","Egremont","1998","Egremont town, MA",15,724,739
"2172","Egremont","Berkshire County","MA","Egremont","1999","Egremont town, MA",14,723,737
"2173","Egremont","Berkshire County","MA","Egremont","2000","Egremont town, MA",12,771,783
"2174","Egremont","Berkshire County","MA","Egremont","2001","Egremont town, MA",16,797,813
"2175","Egremont","Berkshire County","MA","Egremont","2002","Egremont town, MA",23,821,844
"2176","Egremont","Berkshire County","MA","Egremont","2003","Egremont town, MA",25,823,848
"2177","Egremont","Berkshire County","MA","Egremont","2004","Egremont town, MA",28,821,849
"2178","Egremont","Berkshire County","MA","Egremont","2005","Egremont town, MA",29,843,872
"2179","Egremont","Berkshire County","MA","Egremont","2006","Egremont town, MA",25,852,877
"2180","Egremont","Berkshire County","MA","Egremont","2007","Egremont town, MA",25,835,860
"2181","Egremont","Berkshire County","MA","Egremont","2008","Egremont town, MA",30,836,866
"2182","Egremont","Berkshire County","MA","Egremont","2009","Egremont town, MA",41,809,850
"2183","Egremont","Berkshire County","MA","Egremont","2010","Egremont town, MA",44,744,788
"2184","Egremont","Berkshire County","MA","Egremont","2011","Egremont town, MA",35,748,783
"2185","Egremont","Berkshire County","MA","Egremont","2012","Egremont town, MA",28,742,770
"2186","Erving","Franklin County","MA","Erving","1990","Erving town, MA",28,700,728
"2187","Erving","Franklin County","MA","Erving","1991","Erving town, MA",55,674,729
"2188","Erving","Franklin County","MA","Erving","1992","Erving town, MA",55,647,702
"2189","Erving","Franklin County","MA","Erving","1993","Erving town, MA",40,659,699
"2190","Erving","Franklin County","MA","Erving","1994","Erving town, MA",25,674,699
"2191","Erving","Franklin County","MA","Erving","1995","Erving town, MA",26,707,733
"2192","Erving","Franklin County","MA","Erving","1996","Erving town, MA",22,713,735
"2193","Erving","Franklin County","MA","Erving","1997","Erving town, MA",23,730,753
"2194","Erving","Franklin County","MA","Erving","1998","Erving town, MA",23,743,766
"2195","Erving","Franklin County","MA","Erving","1999","Erving town, MA",23,751,774
"2196","Erving","Franklin County","MA","Erving","2000","Erving town, MA",20,777,797
"2197","Erving","Franklin County","MA","Erving","2001","Erving town, MA",28,779,807
"2198","Erving","Franklin County","MA","Erving","2002","Erving town, MA",46,791,837
"2199","Erving","Franklin County","MA","Erving","2003","Erving town, MA",38,804,842
"2200","Erving","Franklin County","MA","Erving","2004","Erving town, MA",32,800,832
"2201","Erving","Franklin County","MA","Erving","2005","Erving town, MA",43,805,848
"2202","Erving","Franklin County","MA","Erving","2006","Erving town, MA",37,818,855
"2203","Erving","Franklin County","MA","Erving","2007","Erving town, MA",39,802,841
"2204","Erving","Franklin County","MA","Erving","2008","Erving town, MA",46,796,842
"2205","Erving","Franklin County","MA","Erving","2009","Erving town, MA",78,772,850
"2206","Erving","Franklin County","MA","Erving","2010","Erving town, MA",76,914,990
"2207","Erving","Franklin County","MA","Erving","2011","Erving town, MA",69,915,984
"2208","Erving","Franklin County","MA","Erving","2012","Erving town, MA",56,918,974
"2209","Essex","Essex County","MA","Essex","1990","Essex town, MA",101,1761,1862
"2210","Essex","Essex County","MA","Essex","1991","Essex town, MA",136,1702,1838
"2211","Essex","Essex County","MA","Essex","1992","Essex town, MA",146,1733,1879
"2212","Essex","Essex County","MA","Essex","1993","Essex town, MA",113,1809,1922
"2213","Essex","Essex County","MA","Essex","1994","Essex town, MA",89,1879,1968
"2214","Essex","Essex County","MA","Essex","1995","Essex town, MA",96,1785,1881
"2215","Essex","Essex County","MA","Essex","1996","Essex town, MA",66,1827,1893
"2216","Essex","Essex County","MA","Essex","1997","Essex town, MA",63,1873,1936
"2217","Essex","Essex County","MA","Essex","1998","Essex town, MA",60,1914,1974
"2218","Essex","Essex County","MA","Essex","1999","Essex town, MA",56,1934,1990
"2219","Essex","Essex County","MA","Essex","2000","Essex town, MA",46,1777,1823
"2220","Essex","Essex County","MA","Essex","2001","Essex town, MA",61,1794,1855
"2221","Essex","Essex County","MA","Essex","2002","Essex town, MA",86,1768,1854
"2222","Essex","Essex County","MA","Essex","2003","Essex town, MA",96,1750,1846
"2223","Essex","Essex County","MA","Essex","2004","Essex town, MA",91,1750,1841
"2224","Essex","Essex County","MA","Essex","2005","Essex town, MA",78,1764,1842
"2225","Essex","Essex County","MA","Essex","2006","Essex town, MA",74,1708,1782
"2226","Essex","Essex County","MA","Essex","2007","Essex town, MA",74,1725,1799
"2227","Essex","Essex County","MA","Essex","2008","Essex town, MA",93,1732,1825
"2228","Essex","Essex County","MA","Essex","2009","Essex town, MA",133,1680,1813
"2229","Essex","Essex County","MA","Essex","2010","Essex town, MA",147,1789,1936
"2230","Essex","Essex County","MA","Essex","2011","Essex town, MA",131,1812,1943
"2231","Essex","Essex County","MA","Essex","2012","Essex town, MA",115,1832,1947
"2232",NA,"Essex County","MA","Essex County","1990","Essex County, MA",23368,326511,349879
"2233",NA,"Essex County","MA","Essex County","1991","Essex County, MA",31376,317592,348968
"2234",NA,"Essex County","MA","Essex County","1992","Essex County, MA",32281,317089,349370
"2235",NA,"Essex County","MA","Essex County","1993","Essex County, MA",26357,321811,348168
"2236",NA,"Essex County","MA","Essex County","1994","Essex County, MA",22915,327915,350830
"2237",NA,"Essex County","MA","Essex County","1995","Essex County, MA",19475,333162,352637
"2238",NA,"Essex County","MA","Essex County","1996","Essex County, MA",16741,341478,358219
"2239",NA,"Essex County","MA","Essex County","1997","Essex County, MA",15774,349896,365670
"2240",NA,"Essex County","MA","Essex County","1998","Essex County, MA",13968,358353,372321
"2241",NA,"Essex County","MA","Essex County","1999","Essex County, MA",13495,364053,377548
"2242",NA,"Essex County","MA","Essex County","2000","Essex County, MA",10407,362525,372932
"2243",NA,"Essex County","MA","Essex County","2001","Essex County, MA",15305,363684,378989
"2244",NA,"Essex County","MA","Essex County","2002","Essex County, MA",22565,358960,381525
"2245",NA,"Essex County","MA","Essex County","2003","Essex County, MA",24247,354844,379091
"2246",NA,"Essex County","MA","Essex County","2004","Essex County, MA",21693,353660,375353
"2247",NA,"Essex County","MA","Essex County","2005","Essex County, MA",19700,355977,375677
"2248",NA,"Essex County","MA","Essex County","2006","Essex County, MA",19133,355217,374350
"2249",NA,"Essex County","MA","Essex County","2007","Essex County, MA",17838,356503,374341
"2250",NA,"Essex County","MA","Essex County","2008","Essex County, MA",21418,356798,378216
"2251",NA,"Essex County","MA","Essex County","2009","Essex County, MA",33230,347911,381141
"2252",NA,"Essex County","MA","Essex County","2010","Essex County, MA",33384,349156,382540
"2253",NA,"Essex County","MA","Essex County","2011","Essex County, MA",29642,353716,383358
"2254",NA,"Essex County","MA","Essex County","2012","Essex County, MA",27467,357483,384950
"2255","Everett","Middlesex County","MA","Everett","1990","Everett city, MA",1339,17695,19034
"2256","Everett","Middlesex County","MA","Everett","1991","Everett city, MA",1811,16899,18710
"2257","Everett","Middlesex County","MA","Everett","1992","Everett city, MA",1850,16596,18446
"2258","Everett","Middlesex County","MA","Everett","1993","Everett city, MA",1424,16480,17904
"2259","Everett","Middlesex County","MA","Everett","1994","Everett city, MA",1264,16611,17875
"2260","Everett","Middlesex County","MA","Everett","1995","Everett city, MA",1211,17220,18431
"2261","Everett","Middlesex County","MA","Everett","1996","Everett city, MA",910,17481,18391
"2262","Everett","Middlesex County","MA","Everett","1997","Everett city, MA",839,17882,18721
"2263","Everett","Middlesex County","MA","Everett","1998","Everett city, MA",708,18051,18759
"2264","Everett","Middlesex County","MA","Everett","1999","Everett city, MA",761,18110,18871
"2265","Everett","Middlesex County","MA","Everett","2000","Everett city, MA",593,18813,19406
"2266","Everett","Middlesex County","MA","Everett","2001","Everett city, MA",755,18674,19429
"2267","Everett","Middlesex County","MA","Everett","2002","Everett city, MA",1140,18220,19360
"2268","Everett","Middlesex County","MA","Everett","2003","Everett city, MA",1361,17861,19222
"2269","Everett","Middlesex County","MA","Everett","2004","Everett city, MA",1079,17721,18800
"2270","Everett","Middlesex County","MA","Everett","2005","Everett city, MA",1006,17736,18742
"2271","Everett","Middlesex County","MA","Everett","2006","Everett city, MA",1000,17702,18702
"2272","Everett","Middlesex County","MA","Everett","2007","Everett city, MA",940,17922,18862
"2273","Everett","Middlesex County","MA","Everett","2008","Everett city, MA",1102,17973,19075
"2274","Everett","Middlesex County","MA","Everett","2009","Everett city, MA",1639,17597,19236
"2275","Everett","Middlesex County","MA","Everett","2010","Everett city, MA",1756,19432,21188
"2276","Everett","Middlesex County","MA","Everett","2011","Everett city, MA",1651,19718,21369
"2277","Everett","Middlesex County","MA","Everett","2012","Everett city, MA",1475,19934,21409
"2278","Fairhaven","Bristol County","MA","Fairhaven","1990","Fairhaven town, MA",662,7465,8127
"2279","Fairhaven","Bristol County","MA","Fairhaven","1991","Fairhaven town, MA",1012,7251,8263
"2280","Fairhaven","Bristol County","MA","Fairhaven","1992","Fairhaven town, MA",967,7236,8203
"2281","Fairhaven","Bristol County","MA","Fairhaven","1993","Fairhaven town, MA",823,7412,8235
"2282","Fairhaven","Bristol County","MA","Fairhaven","1994","Fairhaven town, MA",768,7568,8336
"2283","Fairhaven","Bristol County","MA","Fairhaven","1995","Fairhaven town, MA",689,7286,7975
"2284","Fairhaven","Bristol County","MA","Fairhaven","1996","Fairhaven town, MA",614,7212,7826
"2285","Fairhaven","Bristol County","MA","Fairhaven","1997","Fairhaven town, MA",516,7364,7880
"2286","Fairhaven","Bristol County","MA","Fairhaven","1998","Fairhaven town, MA",441,7393,7834
"2287","Fairhaven","Bristol County","MA","Fairhaven","1999","Fairhaven town, MA",411,7436,7847
"2288","Fairhaven","Bristol County","MA","Fairhaven","2000","Fairhaven town, MA",304,8149,8453
"2289","Fairhaven","Bristol County","MA","Fairhaven","2001","Fairhaven town, MA",354,8085,8439
"2290","Fairhaven","Bristol County","MA","Fairhaven","2002","Fairhaven town, MA",500,8130,8630
"2291","Fairhaven","Bristol County","MA","Fairhaven","2003","Fairhaven town, MA",540,7941,8481
"2292","Fairhaven","Bristol County","MA","Fairhaven","2004","Fairhaven town, MA",486,7961,8447
"2293","Fairhaven","Bristol County","MA","Fairhaven","2005","Fairhaven town, MA",488,8036,8524
"2294","Fairhaven","Bristol County","MA","Fairhaven","2006","Fairhaven town, MA",492,8197,8689
"2295","Fairhaven","Bristol County","MA","Fairhaven","2007","Fairhaven town, MA",485,8149,8634
"2296","Fairhaven","Bristol County","MA","Fairhaven","2008","Fairhaven town, MA",605,7929,8534
"2297","Fairhaven","Bristol County","MA","Fairhaven","2009","Fairhaven town, MA",866,7703,8569
"2298","Fairhaven","Bristol County","MA","Fairhaven","2010","Fairhaven town, MA",908,7489,8397
"2299","Fairhaven","Bristol County","MA","Fairhaven","2011","Fairhaven town, MA",785,7567,8352
"2300","Fairhaven","Bristol County","MA","Fairhaven","2012","Fairhaven town, MA",760,7656,8416
"2301","Fall River","Bristol County","MA","Fall River","1990","Fall River city, MA",5898,40138,46036
"2302","Fall River","Bristol County","MA","Fall River","1991","Fall River city, MA",7872,38242,46114
"2303","Fall River","Bristol County","MA","Fall River","1992","Fall River city, MA",7034,38221,45255
"2304","Fall River","Bristol County","MA","Fall River","1993","Fall River city, MA",6781,38500,45281
"2305","Fall River","Bristol County","MA","Fall River","1994","Fall River city, MA",5093,38592,43685
"2306","Fall River","Bristol County","MA","Fall River","1995","Fall River city, MA",4819,39720,44539
"2307","Fall River","Bristol County","MA","Fall River","1996","Fall River city, MA",4512,39754,44266
"2308","Fall River","Bristol County","MA","Fall River","1997","Fall River city, MA",3834,40391,44225
"2309","Fall River","Bristol County","MA","Fall River","1998","Fall River city, MA",2850,40738,43588
"2310","Fall River","Bristol County","MA","Fall River","1999","Fall River city, MA",2744,40917,43661
"2311","Fall River","Bristol County","MA","Fall River","2000","Fall River city, MA",2224,41047,43271
"2312","Fall River","Bristol County","MA","Fall River","2001","Fall River city, MA",2699,40668,43367
"2313","Fall River","Bristol County","MA","Fall River","2002","Fall River city, MA",3474,40888,44362
"2314","Fall River","Bristol County","MA","Fall River","2003","Fall River city, MA",3707,41038,44745
"2315","Fall River","Bristol County","MA","Fall River","2004","Fall River city, MA",3680,40952,44632
"2316","Fall River","Bristol County","MA","Fall River","2005","Fall River city, MA",3604,40902,44506
"2317","Fall River","Bristol County","MA","Fall River","2006","Fall River city, MA",3698,41183,44881
"2318","Fall River","Bristol County","MA","Fall River","2007","Fall River city, MA",3744,41030,44774
"2319","Fall River","Bristol County","MA","Fall River","2008","Fall River city, MA",4248,40428,44676
"2320","Fall River","Bristol County","MA","Fall River","2009","Fall River city, MA",6368,38526,44894
"2321","Fall River","Bristol County","MA","Fall River","2010","Fall River city, MA",6369,37546,43915
"2322","Fall River","Bristol County","MA","Fall River","2011","Fall River city, MA",6149,37821,43970
"2323","Fall River","Bristol County","MA","Fall River","2012","Fall River city, MA",5641,37881,43522
"2324","Falmouth","Barnstable County","MA","Falmouth","1990","Falmouth town, MA",885,13673,14558
"2325","Falmouth","Barnstable County","MA","Falmouth","1991","Falmouth town, MA",1256,13343,14599
"2326","Falmouth","Barnstable County","MA","Falmouth","1992","Falmouth town, MA",1322,13235,14557
"2327","Falmouth","Barnstable County","MA","Falmouth","1993","Falmouth town, MA",1162,14037,15199
"2328","Falmouth","Barnstable County","MA","Falmouth","1994","Falmouth town, MA",1030,14346,15376
"2329","Falmouth","Barnstable County","MA","Falmouth","1995","Falmouth town, MA",886,14699,15585
"2330","Falmouth","Barnstable County","MA","Falmouth","1996","Falmouth town, MA",823,15037,15860
"2331","Falmouth","Barnstable County","MA","Falmouth","1997","Falmouth town, MA",793,15549,16342
"2332","Falmouth","Barnstable County","MA","Falmouth","1998","Falmouth town, MA",689,15847,16536
"2333","Falmouth","Barnstable County","MA","Falmouth","1999","Falmouth town, MA",575,16053,16628
"2334","Falmouth","Barnstable County","MA","Falmouth","2000","Falmouth town, MA",484,16212,16696
"2335","Falmouth","Barnstable County","MA","Falmouth","2001","Falmouth town, MA",571,16413,16984
"2336","Falmouth","Barnstable County","MA","Falmouth","2002","Falmouth town, MA",728,16742,17470
"2337","Falmouth","Barnstable County","MA","Falmouth","2003","Falmouth town, MA",852,17111,17963
"2338","Falmouth","Barnstable County","MA","Falmouth","2004","Falmouth town, MA",829,17337,18166
"2339","Falmouth","Barnstable County","MA","Falmouth","2005","Falmouth town, MA",780,17356,18136
"2340","Falmouth","Barnstable County","MA","Falmouth","2006","Falmouth town, MA",799,17495,18294
"2341","Falmouth","Barnstable County","MA","Falmouth","2007","Falmouth town, MA",774,17417,18191
"2342","Falmouth","Barnstable County","MA","Falmouth","2008","Falmouth town, MA",941,17330,18271
"2343","Falmouth","Barnstable County","MA","Falmouth","2009","Falmouth town, MA",1321,16694,18015
"2344","Falmouth","Barnstable County","MA","Falmouth","2010","Falmouth town, MA",1432,16266,17698
"2345","Falmouth","Barnstable County","MA","Falmouth","2011","Falmouth town, MA",1302,16239,17541
"2346","Falmouth","Barnstable County","MA","Falmouth","2012","Falmouth town, MA",1175,16512,17687
"2347","Fitchburg","Worcester County","MA","Fitchburg","1990","Fitchburg city, MA",1818,17663,19481
"2348","Fitchburg","Worcester County","MA","Fitchburg","1991","Fitchburg city, MA",2236,16585,18821
"2349","Fitchburg","Worcester County","MA","Fitchburg","1992","Fitchburg city, MA",1967,16186,18153
"2350","Fitchburg","Worcester County","MA","Fitchburg","1993","Fitchburg city, MA",1428,16011,17439
"2351","Fitchburg","Worcester County","MA","Fitchburg","1994","Fitchburg city, MA",1237,15864,17101
"2352","Fitchburg","Worcester County","MA","Fitchburg","1995","Fitchburg city, MA",1145,17211,18356
"2353","Fitchburg","Worcester County","MA","Fitchburg","1996","Fitchburg city, MA",1110,17102,18212
"2354","Fitchburg","Worcester County","MA","Fitchburg","1997","Fitchburg city, MA",1048,17431,18479
"2355","Fitchburg","Worcester County","MA","Fitchburg","1998","Fitchburg city, MA",851,17471,18322
"2356","Fitchburg","Worcester County","MA","Fitchburg","1999","Fitchburg city, MA",837,17387,18224
"2357","Fitchburg","Worcester County","MA","Fitchburg","2000","Fitchburg city, MA",658,17890,18548
"2358","Fitchburg","Worcester County","MA","Fitchburg","2001","Fitchburg city, MA",895,17633,18528
"2359","Fitchburg","Worcester County","MA","Fitchburg","2002","Fitchburg city, MA",1321,17543,18864
"2360","Fitchburg","Worcester County","MA","Fitchburg","2003","Fitchburg city, MA",1484,17408,18892
"2361","Fitchburg","Worcester County","MA","Fitchburg","2004","Fitchburg city, MA",1317,17281,18598
"2362","Fitchburg","Worcester County","MA","Fitchburg","2005","Fitchburg city, MA",1294,17149,18443
"2363","Fitchburg","Worcester County","MA","Fitchburg","2006","Fitchburg city, MA",1258,17299,18557
"2364","Fitchburg","Worcester County","MA","Fitchburg","2007","Fitchburg city, MA",1175,17279,18454
"2365","Fitchburg","Worcester County","MA","Fitchburg","2008","Fitchburg city, MA",1361,17220,18581
"2366","Fitchburg","Worcester County","MA","Fitchburg","2009","Fitchburg city, MA",2131,17031,19162
"2367","Fitchburg","Worcester County","MA","Fitchburg","2010","Fitchburg city, MA",2200,16637,18837
"2368","Fitchburg","Worcester County","MA","Fitchburg","2011","Fitchburg city, MA",2058,16626,18684
"2369","Fitchburg","Worcester County","MA","Fitchburg","2012","Fitchburg city, MA",1851,16614,18465
"2370","Florida","Berkshire County","MA","Florida","1990","Florida town, MA",42,348,390
"2371","Florida","Berkshire County","MA","Florida","1991","Florida town, MA",24,346,370
"2372","Florida","Berkshire County","MA","Florida","1992","Florida town, MA",50,350,400
"2373","Florida","Berkshire County","MA","Florida","1993","Florida town, MA",35,386,421
"2374","Florida","Berkshire County","MA","Florida","1994","Florida town, MA",22,374,396
"2375","Florida","Berkshire County","MA","Florida","1995","Florida town, MA",18,345,363
"2376","Florida","Berkshire County","MA","Florida","1996","Florida town, MA",20,351,371
"2377","Florida","Berkshire County","MA","Florida","1997","Florida town, MA",29,357,386
"2378","Florida","Berkshire County","MA","Florida","1998","Florida town, MA",19,349,368
"2379","Florida","Berkshire County","MA","Florida","1999","Florida town, MA",17,351,368
"2380","Florida","Berkshire County","MA","Florida","2000","Florida town, MA",14,367,381
"2381","Florida","Berkshire County","MA","Florida","2001","Florida town, MA",21,369,390
"2382","Florida","Berkshire County","MA","Florida","2002","Florida town, MA",26,367,393
"2383","Florida","Berkshire County","MA","Florida","2003","Florida town, MA",37,363,400
"2384","Florida","Berkshire County","MA","Florida","2004","Florida town, MA",31,360,391
"2385","Florida","Berkshire County","MA","Florida","2005","Florida town, MA",27,366,393
"2386","Florida","Berkshire County","MA","Florida","2006","Florida town, MA",27,377,404
"2387","Florida","Berkshire County","MA","Florida","2007","Florida town, MA",30,383,413
"2388","Florida","Berkshire County","MA","Florida","2008","Florida town, MA",22,381,403
"2389","Florida","Berkshire County","MA","Florida","2009","Florida town, MA",41,373,414
"2390","Florida","Berkshire County","MA","Florida","2010","Florida town, MA",41,410,451
"2391","Florida","Berkshire County","MA","Florida","2011","Florida town, MA",36,409,445
"2392","Florida","Berkshire County","MA","Florida","2012","Florida town, MA",31,404,435
"2393","Foxborough","Norfolk County","MA","Foxborough","1990","Foxborough town, MA",443,7965,8408
"2394","Foxborough","Norfolk County","MA","Foxborough","1991","Foxborough town, MA",655,7717,8372
"2395","Foxborough","Norfolk County","MA","Foxborough","1992","Foxborough town, MA",697,7748,8445
"2396","Foxborough","Norfolk County","MA","Foxborough","1993","Foxborough town, MA",534,7877,8411
"2397","Foxborough","Norfolk County","MA","Foxborough","1994","Foxborough town, MA",444,8275,8719
"2398","Foxborough","Norfolk County","MA","Foxborough","1995","Foxborough town, MA",403,8462,8865
"2399","Foxborough","Norfolk County","MA","Foxborough","1996","Foxborough town, MA",317,8755,9072
"2400","Foxborough","Norfolk County","MA","Foxborough","1997","Foxborough town, MA",316,9077,9393
"2401","Foxborough","Norfolk County","MA","Foxborough","1998","Foxborough town, MA",229,9255,9484
"2402","Foxborough","Norfolk County","MA","Foxborough","1999","Foxborough town, MA",250,9375,9625
"2403","Foxborough","Norfolk County","MA","Foxborough","2000","Foxborough town, MA",202,8959,9161
"2404","Foxborough","Norfolk County","MA","Foxborough","2001","Foxborough town, MA",285,8965,9250
"2405","Foxborough","Norfolk County","MA","Foxborough","2002","Foxborough town, MA",441,8810,9251
"2406","Foxborough","Norfolk County","MA","Foxborough","2003","Foxborough town, MA",472,8682,9154
"2407","Foxborough","Norfolk County","MA","Foxborough","2004","Foxborough town, MA",423,8677,9100
"2408","Foxborough","Norfolk County","MA","Foxborough","2005","Foxborough town, MA",388,8744,9132
"2409","Foxborough","Norfolk County","MA","Foxborough","2006","Foxborough town, MA",357,8599,8956
"2410","Foxborough","Norfolk County","MA","Foxborough","2007","Foxborough town, MA",361,8714,9075
"2411","Foxborough","Norfolk County","MA","Foxborough","2008","Foxborough town, MA",451,8737,9188
"2412","Foxborough","Norfolk County","MA","Foxborough","2009","Foxborough town, MA",695,8754,9449
"2413","Foxborough","Norfolk County","MA","Foxborough","2010","Foxborough town, MA",694,8755,9449
"2414","Foxborough","Norfolk County","MA","Foxborough","2011","Foxborough town, MA",607,8854,9461
"2415","Foxborough","Norfolk County","MA","Foxborough","2012","Foxborough town, MA",535,8951,9486
"2416","Framingham","Middlesex County","MA","Framingham","1990","Framingham town, MA",2015,36371,38386
"2417","Framingham","Middlesex County","MA","Framingham","1991","Framingham town, MA",2658,34988,37646
"2418","Framingham","Middlesex County","MA","Framingham","1992","Framingham town, MA",2772,34347,37119
"2419","Framingham","Middlesex County","MA","Framingham","1993","Framingham town, MA",2107,34528,36635
"2420","Framingham","Middlesex County","MA","Framingham","1994","Framingham town, MA",1832,34899,36731
"2421","Framingham","Middlesex County","MA","Framingham","1995","Framingham town, MA",1569,35810,37379
"2422","Framingham","Middlesex County","MA","Framingham","1996","Framingham town, MA",1313,36477,37790
"2423","Framingham","Middlesex County","MA","Framingham","1997","Framingham town, MA",1037,37339,38376
"2424","Framingham","Middlesex County","MA","Framingham","1998","Framingham town, MA",859,38051,38910
"2425","Framingham","Middlesex County","MA","Framingham","1999","Framingham town, MA",950,38317,39267
"2426","Framingham","Middlesex County","MA","Framingham","2000","Framingham town, MA",841,36987,37828
"2427","Framingham","Middlesex County","MA","Framingham","2001","Framingham town, MA",1137,36791,37928
"2428","Framingham","Middlesex County","MA","Framingham","2002","Framingham town, MA",1713,35759,37472
"2429","Framingham","Middlesex County","MA","Framingham","2003","Framingham town, MA",1787,34961,36748
"2430","Framingham","Middlesex County","MA","Framingham","2004","Framingham town, MA",1527,34925,36452
"2431","Framingham","Middlesex County","MA","Framingham","2005","Framingham town, MA",1331,35185,36516
"2432","Framingham","Middlesex County","MA","Framingham","2006","Framingham town, MA",1355,35225,36580
"2433","Framingham","Middlesex County","MA","Framingham","2007","Framingham town, MA",1237,35670,36907
"2434","Framingham","Middlesex County","MA","Framingham","2008","Framingham town, MA",1504,36050,37554
"2435","Framingham","Middlesex County","MA","Framingham","2009","Framingham town, MA",2352,35600,37952
"2436","Framingham","Middlesex County","MA","Framingham","2010","Framingham town, MA",2375,35828,38203
"2437","Framingham","Middlesex County","MA","Framingham","2011","Framingham town, MA",2041,36157,38198
"2438","Framingham","Middlesex County","MA","Framingham","2012","Framingham town, MA",1903,36488,38391
"2439","Franklin","Norfolk County","MA","Franklin","1990","Franklin Town city, MA",750,11764,12514
"2440","Franklin","Norfolk County","MA","Franklin","1991","Franklin Town city, MA",1019,11771,12790
"2441","Franklin","Norfolk County","MA","Franklin","1992","Franklin Town city, MA",971,12159,13130
"2442","Franklin","Norfolk County","MA","Franklin","1993","Franklin Town city, MA",811,12677,13488
"2443","Franklin","Norfolk County","MA","Franklin","1994","Franklin Town city, MA",653,13369,14022
"2444","Franklin","Norfolk County","MA","Franklin","1995","Franklin Town city, MA",654,13525,14179
"2445","Franklin","Norfolk County","MA","Franklin","1996","Franklin Town city, MA",514,14170,14684
"2446","Franklin","Norfolk County","MA","Franklin","1997","Franklin Town city, MA",458,14937,15395
"2447","Franklin","Norfolk County","MA","Franklin","1998","Franklin Town city, MA",373,15445,15818
"2448","Franklin","Norfolk County","MA","Franklin","1999","Franklin Town city, MA",383,16007,16390
"2449","Franklin","Norfolk County","MA","Franklin","2000","Franklin Town city, MA",335,15521,15856
"2450","Franklin","Norfolk County","MA","Franklin","2001","Franklin Town city, MA",496,15559,16055
"2451","Franklin","Norfolk County","MA","Franklin","2002","Franklin Town city, MA",744,15339,16083
"2452","Franklin","Norfolk County","MA","Franklin","2003","Franklin Town city, MA",814,15250,16064
"2453","Franklin","Norfolk County","MA","Franklin","2004","Franklin Town city, MA",696,15246,15942
"2454","Franklin","Norfolk County","MA","Franklin","2005","Franklin Town city, MA",635,15756,16391
"2455","Franklin","Norfolk County","MA","Franklin","2006","Franklin Town city, MA",629,15590,16219
"2456","Franklin","Norfolk County","MA","Franklin","2007","Franklin Town city, MA",636,15807,16443
"2457","Franklin","Norfolk County","MA","Franklin","2008","Franklin Town city, MA",759,15892,16651
"2458","Franklin","Norfolk County","MA","Franklin","2009","Franklin Town city, MA",1245,15606,16851
"2459","Franklin","Norfolk County","MA","Franklin","2010","Franklin Town city, MA",1238,15628,16866
"2460","Franklin","Norfolk County","MA","Franklin","2011","Franklin Town city, MA",1059,15802,16861
"2461","Franklin","Norfolk County","MA","Franklin","2012","Franklin Town city, MA",954,15975,16929
"2462",NA,"Franklin County","MA","Franklin County","1990","Franklin County, MA",1929,35274,37203
"2463",NA,"Franklin County","MA","Franklin County","1991","Franklin County, MA",2966,34752,37718
"2464",NA,"Franklin County","MA","Franklin County","1992","Franklin County, MA",2984,33983,36967
"2465",NA,"Franklin County","MA","Franklin County","1993","Franklin County, MA",2344,34192,36536
"2466",NA,"Franklin County","MA","Franklin County","1994","Franklin County, MA",1987,35047,37034
"2467",NA,"Franklin County","MA","Franklin County","1995","Franklin County, MA",1803,35621,37424
"2468",NA,"Franklin County","MA","Franklin County","1996","Franklin County, MA",1490,35764,37254
"2469",NA,"Franklin County","MA","Franklin County","1997","Franklin County, MA",1477,36499,37976
"2470",NA,"Franklin County","MA","Franklin County","1998","Franklin County, MA",1277,37076,38353
"2471",NA,"Franklin County","MA","Franklin County","1999","Franklin County, MA",1169,37644,38813
"2472",NA,"Franklin County","MA","Franklin County","2000","Franklin County, MA",972,38052,39024
"2473",NA,"Franklin County","MA","Franklin County","2001","Franklin County, MA",1205,38006,39211
"2474",NA,"Franklin County","MA","Franklin County","2002","Franklin County, MA",1596,38304,39900
"2475",NA,"Franklin County","MA","Franklin County","2003","Franklin County, MA",1828,38259,40087
"2476",NA,"Franklin County","MA","Franklin County","2004","Franklin County, MA",1702,37888,39590
"2477",NA,"Franklin County","MA","Franklin County","2005","Franklin County, MA",1696,37872,39568
"2478",NA,"Franklin County","MA","Franklin County","2006","Franklin County, MA",1713,37987,39700
"2479",NA,"Franklin County","MA","Franklin County","2007","Franklin County, MA",1634,37532,39166
"2480",NA,"Franklin County","MA","Franklin County","2008","Franklin County, MA",1956,37106,39062
"2481",NA,"Franklin County","MA","Franklin County","2009","Franklin County, MA",2973,35943,38916
"2482",NA,"Franklin County","MA","Franklin County","2010","Franklin County, MA",3018,35916,38934
"2483",NA,"Franklin County","MA","Franklin County","2011","Franklin County, MA",2582,35941,38523
"2484",NA,"Franklin County","MA","Franklin County","2012","Franklin County, MA",2411,36055,38466
"2485","Freetown","Bristol County","MA","Freetown","1990","Freetown town, MA",332,4295,4627
"2486","Freetown","Bristol County","MA","Freetown","1991","Freetown town, MA",494,4110,4604
"2487","Freetown","Bristol County","MA","Freetown","1992","Freetown town, MA",510,4113,4623
"2488","Freetown","Bristol County","MA","Freetown","1993","Freetown town, MA",394,4225,4619
"2489","Freetown","Bristol County","MA","Freetown","1994","Freetown town, MA",368,4284,4652
"2490","Freetown","Bristol County","MA","Freetown","1995","Freetown town, MA",361,4316,4677
"2491","Freetown","Bristol County","MA","Freetown","1996","Freetown town, MA",310,4290,4600
"2492","Freetown","Bristol County","MA","Freetown","1997","Freetown town, MA",289,4404,4693
"2493","Freetown","Bristol County","MA","Freetown","1998","Freetown town, MA",249,4434,4683
"2494","Freetown","Bristol County","MA","Freetown","1999","Freetown town, MA",218,4499,4717
"2495","Freetown","Bristol County","MA","Freetown","2000","Freetown town, MA",154,5049,5203
"2496","Freetown","Bristol County","MA","Freetown","2001","Freetown town, MA",189,5052,5241
"2497","Freetown","Bristol County","MA","Freetown","2002","Freetown town, MA",250,5117,5367
"2498","Freetown","Bristol County","MA","Freetown","2003","Freetown town, MA",293,5068,5361
"2499","Freetown","Bristol County","MA","Freetown","2004","Freetown town, MA",283,5157,5440
"2500","Freetown","Bristol County","MA","Freetown","2005","Freetown town, MA",281,5246,5527
"2501","Freetown","Bristol County","MA","Freetown","2006","Freetown town, MA",264,5327,5591
"2502","Freetown","Bristol County","MA","Freetown","2007","Freetown town, MA",265,5325,5590
"2503","Freetown","Bristol County","MA","Freetown","2008","Freetown town, MA",330,5239,5569
"2504","Freetown","Bristol County","MA","Freetown","2009","Freetown town, MA",477,5118,5595
"2505","Freetown","Bristol County","MA","Freetown","2010","Freetown town, MA",491,4936,5427
"2506","Freetown","Bristol County","MA","Freetown","2011","Freetown town, MA",444,4987,5431
"2507","Freetown","Bristol County","MA","Freetown","2012","Freetown town, MA",398,5046,5444
"2508","Gardner","Worcester County","MA","Gardner","1990","Gardner city, MA",887,8664,9551
"2509","Gardner","Worcester County","MA","Gardner","1991","Gardner city, MA",1177,8497,9674
"2510","Gardner","Worcester County","MA","Gardner","1992","Gardner city, MA",957,8592,9549
"2511","Gardner","Worcester County","MA","Gardner","1993","Gardner city, MA",715,8810,9525
"2512","Gardner","Worcester County","MA","Gardner","1994","Gardner city, MA",705,8777,9482
"2513","Gardner","Worcester County","MA","Gardner","1995","Gardner city, MA",657,8699,9356
"2514","Gardner","Worcester County","MA","Gardner","1996","Gardner city, MA",563,8647,9210
"2515","Gardner","Worcester County","MA","Gardner","1997","Gardner city, MA",497,8803,9300
"2516","Gardner","Worcester County","MA","Gardner","1998","Gardner city, MA",387,8782,9169
"2517","Gardner","Worcester County","MA","Gardner","1999","Gardner city, MA",401,8764,9165
"2518","Gardner","Worcester County","MA","Gardner","2000","Gardner city, MA",330,9815,10145
"2519","Gardner","Worcester County","MA","Gardner","2001","Gardner city, MA",487,9672,10159
"2520","Gardner","Worcester County","MA","Gardner","2002","Gardner city, MA",651,9565,10216
"2521","Gardner","Worcester County","MA","Gardner","2003","Gardner city, MA",713,9468,10181
"2522","Gardner","Worcester County","MA","Gardner","2004","Gardner city, MA",673,9375,10048
"2523","Gardner","Worcester County","MA","Gardner","2005","Gardner city, MA",706,9246,9952
"2524","Gardner","Worcester County","MA","Gardner","2006","Gardner city, MA",614,9280,9894
"2525","Gardner","Worcester County","MA","Gardner","2007","Gardner city, MA",590,9233,9823
"2526","Gardner","Worcester County","MA","Gardner","2008","Gardner city, MA",758,9139,9897
"2527","Gardner","Worcester County","MA","Gardner","2009","Gardner city, MA",1094,8740,9834
"2528","Gardner","Worcester County","MA","Gardner","2010","Gardner city, MA",1092,8620,9712
"2529","Gardner","Worcester County","MA","Gardner","2011","Gardner city, MA",997,8614,9611
"2530","Gardner","Worcester County","MA","Gardner","2012","Gardner city, MA",888,8607,9495
"2531","Georgetown","Essex County","MA","Georgetown","1990","Georgetown town, MA",184,3368,3552
"2532","Georgetown","Essex County","MA","Georgetown","1991","Georgetown town, MA",267,3355,3622
"2533","Georgetown","Essex County","MA","Georgetown","1992","Georgetown town, MA",283,3429,3712
"2534","Georgetown","Essex County","MA","Georgetown","1993","Georgetown town, MA",192,3539,3731
"2535","Georgetown","Essex County","MA","Georgetown","1994","Georgetown town, MA",203,3799,4002
"2536","Georgetown","Essex County","MA","Georgetown","1995","Georgetown town, MA",167,3732,3899
"2537","Georgetown","Essex County","MA","Georgetown","1996","Georgetown town, MA",129,3866,3995
"2538","Georgetown","Essex County","MA","Georgetown","1997","Georgetown town, MA",130,3955,4085
"2539","Georgetown","Essex County","MA","Georgetown","1998","Georgetown town, MA",113,4218,4331
"2540","Georgetown","Essex County","MA","Georgetown","1999","Georgetown town, MA",107,4381,4488
"2541","Georgetown","Essex County","MA","Georgetown","2000","Georgetown town, MA",89,4020,4109
"2542","Georgetown","Essex County","MA","Georgetown","2001","Georgetown town, MA",127,4069,4196
"2543","Georgetown","Essex County","MA","Georgetown","2002","Georgetown town, MA",176,3975,4151
"2544","Georgetown","Essex County","MA","Georgetown","2003","Georgetown town, MA",191,3929,4120
"2545","Georgetown","Essex County","MA","Georgetown","2004","Georgetown town, MA",177,3956,4133
"2546","Georgetown","Essex County","MA","Georgetown","2005","Georgetown town, MA",170,4029,4199
"2547","Georgetown","Essex County","MA","Georgetown","2006","Georgetown town, MA",153,4100,4253
"2548","Georgetown","Essex County","MA","Georgetown","2007","Georgetown town, MA",158,4125,4283
"2549","Georgetown","Essex County","MA","Georgetown","2008","Georgetown town, MA",195,4304,4499
"2550","Georgetown","Essex County","MA","Georgetown","2009","Georgetown town, MA",312,4210,4522
"2551","Georgetown","Essex County","MA","Georgetown","2010","Georgetown town, MA",291,4047,4338
"2552","Georgetown","Essex County","MA","Georgetown","2011","Georgetown town, MA",256,4099,4355
"2553","Georgetown","Essex County","MA","Georgetown","2012","Georgetown town, MA",223,4153,4376
"2554","Gill","Franklin County","MA","Gill","1990","Gill town, MA",40,909,949
"2555","Gill","Franklin County","MA","Gill","1991","Gill town, MA",64,907,971
"2556","Gill","Franklin County","MA","Gill","1992","Gill town, MA",34,863,897
"2557","Gill","Franklin County","MA","Gill","1993","Gill town, MA",34,867,901
"2558","Gill","Franklin County","MA","Gill","1994","Gill town, MA",32,920,952
"2559","Gill","Franklin County","MA","Gill","1995","Gill town, MA",29,917,946
"2560","Gill","Franklin County","MA","Gill","1996","Gill town, MA",28,923,951
"2561","Gill","Franklin County","MA","Gill","1997","Gill town, MA",25,947,972
"2562","Gill","Franklin County","MA","Gill","1998","Gill town, MA",19,941,960
"2563","Gill","Franklin County","MA","Gill","1999","Gill town, MA",19,968,987
"2564","Gill","Franklin County","MA","Gill","2000","Gill town, MA",15,772,787
"2565","Gill","Franklin County","MA","Gill","2001","Gill town, MA",17,770,787
"2566","Gill","Franklin County","MA","Gill","2002","Gill town, MA",20,779,799
"2567","Gill","Franklin County","MA","Gill","2003","Gill town, MA",28,782,810
"2568","Gill","Franklin County","MA","Gill","2004","Gill town, MA",29,779,808
"2569","Gill","Franklin County","MA","Gill","2005","Gill town, MA",30,778,808
"2570","Gill","Franklin County","MA","Gill","2006","Gill town, MA",30,776,806
"2571","Gill","Franklin County","MA","Gill","2007","Gill town, MA",26,770,796
"2572","Gill","Franklin County","MA","Gill","2008","Gill town, MA",41,762,803
"2573","Gill","Franklin County","MA","Gill","2009","Gill town, MA",63,745,808
"2574","Gill","Franklin County","MA","Gill","2010","Gill town, MA",65,815,880
"2575","Gill","Franklin County","MA","Gill","2011","Gill town, MA",57,816,873
"2576","Gill","Franklin County","MA","Gill","2012","Gill town, MA",45,818,863
"2577","Gloucester","Essex County","MA","Gloucester","1990","Gloucester city, MA",1742,14409,16151
"2578","Gloucester","Essex County","MA","Gloucester","1991","Gloucester city, MA",2152,13958,16110
"2579","Gloucester","Essex County","MA","Gloucester","1992","Gloucester city, MA",2387,13873,16260
"2580","Gloucester","Essex County","MA","Gloucester","1993","Gloucester city, MA",1954,14023,15977
"2581","Gloucester","Essex County","MA","Gloucester","1994","Gloucester city, MA",1579,14314,15893
"2582","Gloucester","Essex County","MA","Gloucester","1995","Gloucester city, MA",1343,14488,15831
"2583","Gloucester","Essex County","MA","Gloucester","1996","Gloucester city, MA",1030,14776,15806
"2584","Gloucester","Essex County","MA","Gloucester","1997","Gloucester city, MA",938,15217,16155
"2585","Gloucester","Essex County","MA","Gloucester","1998","Gloucester city, MA",884,15518,16402
"2586","Gloucester","Essex County","MA","Gloucester","1999","Gloucester city, MA",733,15662,16395
"2587","Gloucester","Essex County","MA","Gloucester","2000","Gloucester city, MA",601,15844,16445
"2588","Gloucester","Essex County","MA","Gloucester","2001","Gloucester city, MA",815,15900,16715
"2589","Gloucester","Essex County","MA","Gloucester","2002","Gloucester city, MA",1059,15710,16769
"2590","Gloucester","Essex County","MA","Gloucester","2003","Gloucester city, MA",1150,15509,16659
"2591","Gloucester","Essex County","MA","Gloucester","2004","Gloucester city, MA",1048,15484,16532
"2592","Gloucester","Essex County","MA","Gloucester","2005","Gloucester city, MA",987,15608,16595
"2593","Gloucester","Essex County","MA","Gloucester","2006","Gloucester city, MA",959,15164,16123
"2594","Gloucester","Essex County","MA","Gloucester","2007","Gloucester city, MA",877,15250,16127
"2595","Gloucester","Essex County","MA","Gloucester","2008","Gloucester city, MA",1079,15264,16343
"2596","Gloucester","Essex County","MA","Gloucester","2009","Gloucester city, MA",1589,14804,16393
"2597","Gloucester","Essex County","MA","Gloucester","2010","Gloucester city, MA",1575,14170,15745
"2598","Gloucester","Essex County","MA","Gloucester","2011","Gloucester city, MA",1360,14342,15702
"2599","Gloucester","Essex County","MA","Gloucester","2012","Gloucester city, MA",1232,14499,15731
"2600","Goshen","Hampshire County","MA","Goshen","1990","Goshen town, MA",26,493,519
"2601","Goshen","Hampshire County","MA","Goshen","1991","Goshen town, MA",28,478,506
"2602","Goshen","Hampshire County","MA","Goshen","1992","Goshen town, MA",29,511,540
"2603","Goshen","Hampshire County","MA","Goshen","1993","Goshen town, MA",23,532,555
"2604","Goshen","Hampshire County","MA","Goshen","1994","Goshen town, MA",27,567,594
"2605","Goshen","Hampshire County","MA","Goshen","1995","Goshen town, MA",15,587,602
"2606","Goshen","Hampshire County","MA","Goshen","1996","Goshen town, MA",11,573,584
"2607","Goshen","Hampshire County","MA","Goshen","1997","Goshen town, MA",18,577,595
"2608","Goshen","Hampshire County","MA","Goshen","1998","Goshen town, MA",11,557,568
"2609","Goshen","Hampshire County","MA","Goshen","1999","Goshen town, MA",11,604,615
"2610","Goshen","Hampshire County","MA","Goshen","2000","Goshen town, MA",8,564,572
"2611","Goshen","Hampshire County","MA","Goshen","2001","Goshen town, MA",10,569,579
"2612","Goshen","Hampshire County","MA","Goshen","2002","Goshen town, MA",14,570,584
"2613","Goshen","Hampshire County","MA","Goshen","2003","Goshen town, MA",22,572,594
"2614","Goshen","Hampshire County","MA","Goshen","2004","Goshen town, MA",20,573,593
"2615","Goshen","Hampshire County","MA","Goshen","2005","Goshen town, MA",15,574,589
"2616","Goshen","Hampshire County","MA","Goshen","2006","Goshen town, MA",20,580,600
"2617","Goshen","Hampshire County","MA","Goshen","2007","Goshen town, MA",16,580,596
"2618","Goshen","Hampshire County","MA","Goshen","2008","Goshen town, MA",29,585,614
"2619","Goshen","Hampshire County","MA","Goshen","2009","Goshen town, MA",38,560,598
"2620","Goshen","Hampshire County","MA","Goshen","2010","Goshen town, MA",36,606,642
"2621","Goshen","Hampshire County","MA","Goshen","2011","Goshen town, MA",28,599,627
"2622","Goshen","Hampshire County","MA","Goshen","2012","Goshen town, MA",32,599,631
"2623","Gosnold","Dukes County","MA","Gosnold","1990","Gosnold town, MA",0,89,89
"2624","Gosnold","Dukes County","MA","Gosnold","1991","Gosnold town, MA",0,86,86
"2625","Gosnold","Dukes County","MA","Gosnold","1992","Gosnold town, MA",0,73,73
"2626","Gosnold","Dukes County","MA","Gosnold","1993","Gosnold town, MA",2,84,86
"2627","Gosnold","Dukes County","MA","Gosnold","1994","Gosnold town, MA",0,87,87
"2628","Gosnold","Dukes County","MA","Gosnold","1995","Gosnold town, MA",0,88,88
"2629","Gosnold","Dukes County","MA","Gosnold","1996","Gosnold town, MA",0,90,90
"2630","Gosnold","Dukes County","MA","Gosnold","1997","Gosnold town, MA",1,90,91
"2631","Gosnold","Dukes County","MA","Gosnold","1998","Gosnold town, MA",0,90,90
"2632","Gosnold","Dukes County","MA","Gosnold","1999","Gosnold town, MA",0,89,89
"2633","Gosnold","Dukes County","MA","Gosnold","2000","Gosnold town, MA",2,35,37
"2634","Gosnold","Dukes County","MA","Gosnold","2001","Gosnold town, MA",0,35,35
"2635","Gosnold","Dukes County","MA","Gosnold","2002","Gosnold town, MA",1,35,36
"2636","Gosnold","Dukes County","MA","Gosnold","2003","Gosnold town, MA",1,34,35
"2637","Gosnold","Dukes County","MA","Gosnold","2004","Gosnold town, MA",1,34,35
"2638","Gosnold","Dukes County","MA","Gosnold","2005","Gosnold town, MA",1,35,36
"2639","Gosnold","Dukes County","MA","Gosnold","2006","Gosnold town, MA",1,35,36
"2640","Gosnold","Dukes County","MA","Gosnold","2007","Gosnold town, MA",2,34,36
"2641","Gosnold","Dukes County","MA","Gosnold","2008","Gosnold town, MA",1,33,34
"2642","Gosnold","Dukes County","MA","Gosnold","2009","Gosnold town, MA",1,33,34
"2643","Gosnold","Dukes County","MA","Gosnold","2010","Gosnold town, MA",4,29,33
"2644","Gosnold","Dukes County","MA","Gosnold","2011","Gosnold town, MA",2,29,31
"2645","Gosnold","Dukes County","MA","Gosnold","2012","Gosnold town, MA",2,30,32
"2646","Grafton","Worcester County","MA","Grafton","1990","Grafton town, MA",410,6752,7162
"2647","Grafton","Worcester County","MA","Grafton","1991","Grafton town, MA",732,6532,7264
"2648","Grafton","Worcester County","MA","Grafton","1992","Grafton town, MA",586,6570,7156
"2649","Grafton","Worcester County","MA","Grafton","1993","Grafton town, MA",455,6821,7276
"2650","Grafton","Worcester County","MA","Grafton","1994","Grafton town, MA",333,6898,7231
"2651","Grafton","Worcester County","MA","Grafton","1995","Grafton town, MA",332,6771,7103
"2652","Grafton","Worcester County","MA","Grafton","1996","Grafton town, MA",279,6915,7194
"2653","Grafton","Worcester County","MA","Grafton","1997","Grafton town, MA",244,7166,7410
"2654","Grafton","Worcester County","MA","Grafton","1998","Grafton town, MA",221,7217,7438
"2655","Grafton","Worcester County","MA","Grafton","1999","Grafton town, MA",223,7343,7566
"2656","Grafton","Worcester County","MA","Grafton","2000","Grafton town, MA",206,8184,8390
"2657","Grafton","Worcester County","MA","Grafton","2001","Grafton town, MA",271,8293,8564
"2658","Grafton","Worcester County","MA","Grafton","2002","Grafton town, MA",433,8414,8847
"2659","Grafton","Worcester County","MA","Grafton","2003","Grafton town, MA",488,8464,8952
"2660","Grafton","Worcester County","MA","Grafton","2004","Grafton town, MA",440,8609,9049
"2661","Grafton","Worcester County","MA","Grafton","2005","Grafton town, MA",402,8896,9298
"2662","Grafton","Worcester County","MA","Grafton","2006","Grafton town, MA",395,9211,9606
"2663","Grafton","Worcester County","MA","Grafton","2007","Grafton town, MA",426,9341,9767
"2664","Grafton","Worcester County","MA","Grafton","2008","Grafton town, MA",478,9182,9660
"2665","Grafton","Worcester County","MA","Grafton","2009","Grafton town, MA",802,8942,9744
"2666","Grafton","Worcester County","MA","Grafton","2010","Grafton town, MA",733,8956,9689
"2667","Grafton","Worcester County","MA","Grafton","2011","Grafton town, MA",593,9036,9629
"2668","Grafton","Worcester County","MA","Grafton","2012","Grafton town, MA",602,9033,9635
"2669","Granby","Hampshire County","MA","Granby","1990","Granby town, MA",187,2949,3136
"2670","Granby","Hampshire County","MA","Granby","1991","Granby town, MA",264,2895,3159
"2671","Granby","Hampshire County","MA","Granby","1992","Granby town, MA",265,2942,3207
"2672","Granby","Hampshire County","MA","Granby","1993","Granby town, MA",233,2958,3191
"2673","Granby","Hampshire County","MA","Granby","1994","Granby town, MA",209,3069,3278
"2674","Granby","Hampshire County","MA","Granby","1995","Granby town, MA",162,2972,3134
"2675","Granby","Hampshire County","MA","Granby","1996","Granby town, MA",157,3038,3195
"2676","Granby","Hampshire County","MA","Granby","1997","Granby town, MA",152,3114,3266
"2677","Granby","Hampshire County","MA","Granby","1998","Granby town, MA",132,3150,3282
"2678","Granby","Hampshire County","MA","Granby","1999","Granby town, MA",99,3190,3289
"2679","Granby","Hampshire County","MA","Granby","2000","Granby town, MA",90,3384,3474
"2680","Granby","Hampshire County","MA","Granby","2001","Granby town, MA",109,3403,3512
"2681","Granby","Hampshire County","MA","Granby","2002","Granby town, MA",157,3402,3559
"2682","Granby","Hampshire County","MA","Granby","2003","Granby town, MA",172,3396,3568
"2683","Granby","Hampshire County","MA","Granby","2004","Granby town, MA",168,3418,3586
"2684","Granby","Hampshire County","MA","Granby","2005","Granby town, MA",151,3440,3591
"2685","Granby","Hampshire County","MA","Granby","2006","Granby town, MA",157,3464,3621
"2686","Granby","Hampshire County","MA","Granby","2007","Granby town, MA",163,3440,3603
"2687","Granby","Hampshire County","MA","Granby","2008","Granby town, MA",178,3408,3586
"2688","Granby","Hampshire County","MA","Granby","2009","Granby town, MA",274,3251,3525
"2689","Granby","Hampshire County","MA","Granby","2010","Granby town, MA",255,3239,3494
"2690","Granby","Hampshire County","MA","Granby","2011","Granby town, MA",232,3198,3430
"2691","Granby","Hampshire County","MA","Granby","2012","Granby town, MA",234,3200,3434
"2692","Granville","Hampden County","MA","Granville","1990","Granville town, MA",29,734,763
"2693","Granville","Hampden County","MA","Granville","1991","Granville town, MA",59,718,777
"2694","Granville","Hampden County","MA","Granville","1992","Granville town, MA",57,819,876
"2695","Granville","Hampden County","MA","Granville","1993","Granville town, MA",62,845,907
"2696","Granville","Hampden County","MA","Granville","1994","Granville town, MA",59,904,963
"2697","Granville","Hampden County","MA","Granville","1995","Granville town, MA",51,849,900
"2698","Granville","Hampden County","MA","Granville","1996","Granville town, MA",45,831,876
"2699","Granville","Hampden County","MA","Granville","1997","Granville town, MA",33,841,874
"2700","Granville","Hampden County","MA","Granville","1998","Granville town, MA",28,887,915
"2701","Granville","Hampden County","MA","Granville","1999","Granville town, MA",29,967,996
"2702","Granville","Hampden County","MA","Granville","2000","Granville town, MA",20,850,870
"2703","Granville","Hampden County","MA","Granville","2001","Granville town, MA",21,861,882
"2704","Granville","Hampden County","MA","Granville","2002","Granville town, MA",32,869,901
"2705","Granville","Hampden County","MA","Granville","2003","Granville town, MA",32,873,905
"2706","Granville","Hampden County","MA","Granville","2004","Granville town, MA",29,887,916
"2707","Granville","Hampden County","MA","Granville","2005","Granville town, MA",32,902,934
"2708","Granville","Hampden County","MA","Granville","2006","Granville town, MA",31,920,951
"2709","Granville","Hampden County","MA","Granville","2007","Granville town, MA",32,927,959
"2710","Granville","Hampden County","MA","Granville","2008","Granville town, MA",44,924,968
"2711","Granville","Hampden County","MA","Granville","2009","Granville town, MA",76,861,937
"2712","Granville","Hampden County","MA","Granville","2010","Granville town, MA",83,821,904
"2713","Granville","Hampden County","MA","Granville","2011","Granville town, MA",69,813,882
"2714","Granville","Hampden County","MA","Granville","2012","Granville town, MA",64,814,878
"2715","Great Barrington","Berkshire County","MA","Great Barrington","1990","Great Barrington town, MA",241,3704,3945
"2716","Great Barrington","Berkshire County","MA","Great Barrington","1991","Great Barrington town, MA",327,3588,3915
"2717","Great Barrington","Berkshire County","MA","Great Barrington","1992","Great Barrington town, MA",331,3572,3903
"2718","Great Barrington","Berkshire County","MA","Great Barrington","1993","Great Barrington town, MA",291,3699,3990
"2719","Great Barrington","Berkshire County","MA","Great Barrington","1994","Great Barrington town, MA",241,3682,3923
"2720","Great Barrington","Berkshire County","MA","Great Barrington","1995","Great Barrington town, MA",211,3985,4196
"2721","Great Barrington","Berkshire County","MA","Great Barrington","1996","Great Barrington town, MA",163,4070,4233
"2722","Great Barrington","Berkshire County","MA","Great Barrington","1997","Great Barrington town, MA",151,4160,4311
"2723","Great Barrington","Berkshire County","MA","Great Barrington","1998","Great Barrington town, MA",120,4212,4332
"2724","Great Barrington","Berkshire County","MA","Great Barrington","1999","Great Barrington town, MA",115,4195,4310
"2725","Great Barrington","Berkshire County","MA","Great Barrington","2000","Great Barrington town, MA",103,3984,4087
"2726","Great Barrington","Berkshire County","MA","Great Barrington","2001","Great Barrington town, MA",121,4118,4239
"2727","Great Barrington","Berkshire County","MA","Great Barrington","2002","Great Barrington town, MA",153,4230,4383
"2728","Great Barrington","Berkshire County","MA","Great Barrington","2003","Great Barrington town, MA",179,4212,4391
"2729","Great Barrington","Berkshire County","MA","Great Barrington","2004","Great Barrington town, MA",163,4185,4348
"2730","Great Barrington","Berkshire County","MA","Great Barrington","2005","Great Barrington town, MA",153,4272,4425
"2731","Great Barrington","Berkshire County","MA","Great Barrington","2006","Great Barrington town, MA",156,4304,4460
"2732","Great Barrington","Berkshire County","MA","Great Barrington","2007","Great Barrington town, MA",164,4210,4374
"2733","Great Barrington","Berkshire County","MA","Great Barrington","2008","Great Barrington town, MA",206,4224,4430
"2734","Great Barrington","Berkshire County","MA","Great Barrington","2009","Great Barrington town, MA",300,4093,4393
"2735","Great Barrington","Berkshire County","MA","Great Barrington","2010","Great Barrington town, MA",299,3987,4286
"2736","Great Barrington","Berkshire County","MA","Great Barrington","2011","Great Barrington town, MA",267,4010,4277
"2737","Great Barrington","Berkshire County","MA","Great Barrington","2012","Great Barrington town, MA",247,3977,4224
"2738","Greenfield","Franklin County","MA","Greenfield","1990","Greenfield Town city, MA",463,8768,9231
"2739","Greenfield","Franklin County","MA","Greenfield","1991","Greenfield Town city, MA",768,8652,9420
"2740","Greenfield","Franklin County","MA","Greenfield","1992","Greenfield Town city, MA",789,8314,9103
"2741","Greenfield","Franklin County","MA","Greenfield","1993","Greenfield Town city, MA",600,8265,8865
"2742","Greenfield","Franklin County","MA","Greenfield","1994","Greenfield Town city, MA",491,8389,8880
"2743","Greenfield","Franklin County","MA","Greenfield","1995","Greenfield Town city, MA",471,8805,9276
"2744","Greenfield","Franklin County","MA","Greenfield","1996","Greenfield Town city, MA",385,8804,9189
"2745","Greenfield","Franklin County","MA","Greenfield","1997","Greenfield Town city, MA",354,8955,9309
"2746","Greenfield","Franklin County","MA","Greenfield","1998","Greenfield Town city, MA",334,9063,9397
"2747","Greenfield","Franklin County","MA","Greenfield","1999","Greenfield Town city, MA",318,9182,9500
"2748","Greenfield","Franklin County","MA","Greenfield","2000","Greenfield Town city, MA",248,8975,9223
"2749","Greenfield","Franklin County","MA","Greenfield","2001","Greenfield Town city, MA",321,8905,9226
"2750","Greenfield","Franklin County","MA","Greenfield","2002","Greenfield Town city, MA",423,8979,9402
"2751","Greenfield","Franklin County","MA","Greenfield","2003","Greenfield Town city, MA",468,8954,9422
"2752","Greenfield","Franklin County","MA","Greenfield","2004","Greenfield Town city, MA",425,8762,9187
"2753","Greenfield","Franklin County","MA","Greenfield","2005","Greenfield Town city, MA",447,8701,9148
"2754","Greenfield","Franklin County","MA","Greenfield","2006","Greenfield Town city, MA",431,8683,9114
"2755","Greenfield","Franklin County","MA","Greenfield","2007","Greenfield Town city, MA",428,8636,9064
"2756","Greenfield","Franklin County","MA","Greenfield","2008","Greenfield Town city, MA",508,8559,9067
"2757","Greenfield","Franklin County","MA","Greenfield","2009","Greenfield Town city, MA",759,8336,9095
"2758","Greenfield","Franklin County","MA","Greenfield","2010","Greenfield Town city, MA",741,8290,9031
"2759","Greenfield","Franklin County","MA","Greenfield","2011","Greenfield Town city, MA",632,8301,8933
"2760","Greenfield","Franklin County","MA","Greenfield","2012","Greenfield Town city, MA",629,8324,8953
"2761","Groton","Middlesex County","MA","Groton","1990","Groton town, MA",200,4214,4414
"2762","Groton","Middlesex County","MA","Groton","1991","Groton town, MA",312,4169,4481
"2763","Groton","Middlesex County","MA","Groton","1992","Groton town, MA",319,4360,4679
"2764","Groton","Middlesex County","MA","Groton","1993","Groton town, MA",237,4449,4686
"2765","Groton","Middlesex County","MA","Groton","1994","Groton town, MA",232,4612,4844
"2766","Groton","Middlesex County","MA","Groton","1995","Groton town, MA",184,4578,4762
"2767","Groton","Middlesex County","MA","Groton","1996","Groton town, MA",145,4821,4966
"2768","Groton","Middlesex County","MA","Groton","1997","Groton town, MA",145,5087,5232
"2769","Groton","Middlesex County","MA","Groton","1998","Groton town, MA",140,5302,5442
"2770","Groton","Middlesex County","MA","Groton","1999","Groton town, MA",138,5584,5722
"2771","Groton","Middlesex County","MA","Groton","2000","Groton town, MA",105,5050,5155
"2772","Groton","Middlesex County","MA","Groton","2001","Groton town, MA",174,5139,5313
"2773","Groton","Middlesex County","MA","Groton","2002","Groton town, MA",300,5135,5435
"2774","Groton","Middlesex County","MA","Groton","2003","Groton town, MA",272,5162,5434
"2775","Groton","Middlesex County","MA","Groton","2004","Groton town, MA",229,5249,5478
"2776","Groton","Middlesex County","MA","Groton","2005","Groton town, MA",208,5339,5547
"2777","Groton","Middlesex County","MA","Groton","2006","Groton town, MA",188,5327,5515
"2778","Groton","Middlesex County","MA","Groton","2007","Groton town, MA",185,5386,5571
"2779","Groton","Middlesex County","MA","Groton","2008","Groton town, MA",238,5394,5632
"2780","Groton","Middlesex County","MA","Groton","2009","Groton town, MA",354,5262,5616
"2781","Groton","Middlesex County","MA","Groton","2010","Groton town, MA",356,5275,5631
"2782","Groton","Middlesex County","MA","Groton","2011","Groton town, MA",334,5352,5686
"2783","Groton","Middlesex County","MA","Groton","2012","Groton town, MA",293,5411,5704
"2784","Groveland","Essex County","MA","Groveland","1990","Groveland town, MA",194,2784,2978
"2785","Groveland","Essex County","MA","Groveland","1991","Groveland town, MA",248,2770,3018
"2786","Groveland","Essex County","MA","Groveland","1992","Groveland town, MA",215,2835,3050
"2787","Groveland","Essex County","MA","Groveland","1993","Groveland town, MA",212,2917,3129
"2788","Groveland","Essex County","MA","Groveland","1994","Groveland town, MA",191,2952,3143
"2789","Groveland","Essex County","MA","Groveland","1995","Groveland town, MA",160,2992,3152
"2790","Groveland","Essex County","MA","Groveland","1996","Groveland town, MA",144,3109,3253
"2791","Groveland","Essex County","MA","Groveland","1997","Groveland town, MA",122,3189,3311
"2792","Groveland","Essex County","MA","Groveland","1998","Groveland town, MA",99,3311,3410
"2793","Groveland","Essex County","MA","Groveland","1999","Groveland town, MA",98,3401,3499
"2794","Groveland","Essex County","MA","Groveland","2000","Groveland town, MA",75,3291,3366
"2795","Groveland","Essex County","MA","Groveland","2001","Groveland town, MA",109,3264,3373
"2796","Groveland","Essex County","MA","Groveland","2002","Groveland town, MA",155,3222,3377
"2797","Groveland","Essex County","MA","Groveland","2003","Groveland town, MA",161,3202,3363
"2798","Groveland","Essex County","MA","Groveland","2004","Groveland town, MA",158,3233,3391
"2799","Groveland","Essex County","MA","Groveland","2005","Groveland town, MA",144,3328,3472
"2800","Groveland","Essex County","MA","Groveland","2006","Groveland town, MA",147,3441,3588
"2801","Groveland","Essex County","MA","Groveland","2007","Groveland town, MA",135,3524,3659
"2802","Groveland","Essex County","MA","Groveland","2008","Groveland town, MA",157,3609,3766
"2803","Groveland","Essex County","MA","Groveland","2009","Groveland town, MA",264,3617,3881
"2804","Groveland","Essex County","MA","Groveland","2010","Groveland town, MA",251,3211,3462
"2805","Groveland","Essex County","MA","Groveland","2011","Groveland town, MA",204,3252,3456
"2806","Groveland","Essex County","MA","Groveland","2012","Groveland town, MA",203,3295,3498
"2807","Hadley","Hampshire County","MA","Hadley","1990","Hadley town, MA",110,2258,2368
"2808","Hadley","Hampshire County","MA","Hadley","1991","Hadley town, MA",174,2185,2359
"2809","Hadley","Hampshire County","MA","Hadley","1992","Hadley town, MA",151,2179,2330
"2810","Hadley","Hampshire County","MA","Hadley","1993","Hadley town, MA",104,2188,2292
"2811","Hadley","Hampshire County","MA","Hadley","1994","Hadley town, MA",114,2238,2352
"2812","Hadley","Hampshire County","MA","Hadley","1995","Hadley town, MA",78,2253,2331
"2813","Hadley","Hampshire County","MA","Hadley","1996","Hadley town, MA",75,2303,2378
"2814","Hadley","Hampshire County","MA","Hadley","1997","Hadley town, MA",65,2378,2443
"2815","Hadley","Hampshire County","MA","Hadley","1998","Hadley town, MA",54,2408,2462
"2816","Hadley","Hampshire County","MA","Hadley","1999","Hadley town, MA",53,2441,2494
"2817","Hadley","Hampshire County","MA","Hadley","2000","Hadley town, MA",54,2530,2584
"2818","Hadley","Hampshire County","MA","Hadley","2001","Hadley town, MA",62,2530,2592
"2819","Hadley","Hampshire County","MA","Hadley","2002","Hadley town, MA",92,2522,2614
"2820","Hadley","Hampshire County","MA","Hadley","2003","Hadley town, MA",130,2512,2642
"2821","Hadley","Hampshire County","MA","Hadley","2004","Hadley town, MA",116,2511,2627
"2822","Hadley","Hampshire County","MA","Hadley","2005","Hadley town, MA",117,2504,2621
"2823","Hadley","Hampshire County","MA","Hadley","2006","Hadley town, MA",108,2516,2624
"2824","Hadley","Hampshire County","MA","Hadley","2007","Hadley town, MA",104,2510,2614
"2825","Hadley","Hampshire County","MA","Hadley","2008","Hadley town, MA",109,2459,2568
"2826","Hadley","Hampshire County","MA","Hadley","2009","Hadley town, MA",157,2347,2504
"2827","Hadley","Hampshire County","MA","Hadley","2010","Hadley town, MA",184,2611,2795
"2828","Hadley","Hampshire County","MA","Hadley","2011","Hadley town, MA",161,2578,2739
"2829","Hadley","Hampshire County","MA","Hadley","2012","Hadley town, MA",155,2580,2735
"2830","Halifax","Plymouth County","MA","Halifax","1990","Halifax town, MA",285,3273,3558
"2831","Halifax","Plymouth County","MA","Halifax","1991","Halifax town, MA",387,3156,3543
"2832","Halifax","Plymouth County","MA","Halifax","1992","Halifax town, MA",375,3130,3505
"2833","Halifax","Plymouth County","MA","Halifax","1993","Halifax town, MA",316,3309,3625
"2834","Halifax","Plymouth County","MA","Halifax","1994","Halifax town, MA",252,3514,3766
"2835","Halifax","Plymouth County","MA","Halifax","1995","Halifax town, MA",201,3469,3670
"2836","Halifax","Plymouth County","MA","Halifax","1996","Halifax town, MA",226,3496,3722
"2837","Halifax","Plymouth County","MA","Halifax","1997","Halifax town, MA",195,3629,3824
"2838","Halifax","Plymouth County","MA","Halifax","1998","Halifax town, MA",130,3732,3862
"2839","Halifax","Plymouth County","MA","Halifax","1999","Halifax town, MA",134,3865,3999
"2840","Halifax","Plymouth County","MA","Halifax","2000","Halifax town, MA",111,4069,4180
"2841","Halifax","Plymouth County","MA","Halifax","2001","Halifax town, MA",144,4070,4214
"2842","Halifax","Plymouth County","MA","Halifax","2002","Halifax town, MA",200,4048,4248
"2843","Halifax","Plymouth County","MA","Halifax","2003","Halifax town, MA",237,3977,4214
"2844","Halifax","Plymouth County","MA","Halifax","2004","Halifax town, MA",221,3983,4204
"2845","Halifax","Plymouth County","MA","Halifax","2005","Halifax town, MA",221,4011,4232
"2846","Halifax","Plymouth County","MA","Halifax","2006","Halifax town, MA",228,4051,4279
"2847","Halifax","Plymouth County","MA","Halifax","2007","Halifax town, MA",214,4060,4274
"2848","Halifax","Plymouth County","MA","Halifax","2008","Halifax town, MA",254,4028,4282
"2849","Halifax","Plymouth County","MA","Halifax","2009","Halifax town, MA",381,3947,4328
"2850","Halifax","Plymouth County","MA","Halifax","2010","Halifax town, MA",395,3799,4194
"2851","Halifax","Plymouth County","MA","Halifax","2011","Halifax town, MA",329,3837,4166
"2852","Halifax","Plymouth County","MA","Halifax","2012","Halifax town, MA",318,3870,4188
"2853","Hamilton","Essex County","MA","Hamilton","1990","Hamilton town, MA",163,3526,3689
"2854","Hamilton","Essex County","MA","Hamilton","1991","Hamilton town, MA",222,3448,3670
"2855","Hamilton","Essex County","MA","Hamilton","1992","Hamilton town, MA",197,3439,3636
"2856","Hamilton","Essex County","MA","Hamilton","1993","Hamilton town, MA",176,3529,3705
"2857","Hamilton","Essex County","MA","Hamilton","1994","Hamilton town, MA",154,3599,3753
"2858","Hamilton","Essex County","MA","Hamilton","1995","Hamilton town, MA",119,3579,3698
"2859","Hamilton","Essex County","MA","Hamilton","1996","Hamilton town, MA",96,3653,3749
"2860","Hamilton","Essex County","MA","Hamilton","1997","Hamilton town, MA",88,3748,3836
"2861","Hamilton","Essex County","MA","Hamilton","1998","Hamilton town, MA",86,3826,3912
"2862","Hamilton","Essex County","MA","Hamilton","1999","Hamilton town, MA",76,3855,3931
"2863","Hamilton","Essex County","MA","Hamilton","2000","Hamilton town, MA",75,3926,4001
"2864","Hamilton","Essex County","MA","Hamilton","2001","Hamilton town, MA",116,3938,4054
"2865","Hamilton","Essex County","MA","Hamilton","2002","Hamilton town, MA",160,3887,4047
"2866","Hamilton","Essex County","MA","Hamilton","2003","Hamilton town, MA",191,3832,4023
"2867","Hamilton","Essex County","MA","Hamilton","2004","Hamilton town, MA",167,3820,3987
"2868","Hamilton","Essex County","MA","Hamilton","2005","Hamilton town, MA",152,3828,3980
"2869","Hamilton","Essex County","MA","Hamilton","2006","Hamilton town, MA",145,3709,3854
"2870","Hamilton","Essex County","MA","Hamilton","2007","Hamilton town, MA",137,3729,3866
"2871","Hamilton","Essex County","MA","Hamilton","2008","Hamilton town, MA",173,3729,3902
"2872","Hamilton","Essex County","MA","Hamilton","2009","Hamilton town, MA",259,3609,3868
"2873","Hamilton","Essex County","MA","Hamilton","2010","Hamilton town, MA",240,3448,3688
"2874","Hamilton","Essex County","MA","Hamilton","2011","Hamilton town, MA",196,3490,3686
"2875","Hamilton","Essex County","MA","Hamilton","2012","Hamilton town, MA",175,3529,3704
"2876","Hampden","Hampden County","MA","Hampden","1990","Hampden town, MA",125,2607,2732
"2877","Hampden","Hampden County","MA","Hampden","1991","Hampden town, MA",181,2530,2711
"2878","Hampden","Hampden County","MA","Hampden","1992","Hampden town, MA",209,2551,2760
"2879","Hampden","Hampden County","MA","Hampden","1993","Hampden town, MA",186,2560,2746
"2880","Hampden","Hampden County","MA","Hampden","1994","Hampden town, MA",147,2578,2725
"2881","Hampden","Hampden County","MA","Hampden","1995","Hampden town, MA",136,2551,2687
"2882","Hampden","Hampden County","MA","Hampden","1996","Hampden town, MA",109,2586,2695
"2883","Hampden","Hampden County","MA","Hampden","1997","Hampden town, MA",84,2650,2734
"2884","Hampden","Hampden County","MA","Hampden","1998","Hampden town, MA",64,2671,2735
"2885","Hampden","Hampden County","MA","Hampden","1999","Hampden town, MA",70,2691,2761
"2886","Hampden","Hampden County","MA","Hampden","2000","Hampden town, MA",68,2753,2821
"2887","Hampden","Hampden County","MA","Hampden","2001","Hampden town, MA",85,2777,2862
"2888","Hampden","Hampden County","MA","Hampden","2002","Hampden town, MA",122,2771,2893
"2889","Hampden","Hampden County","MA","Hampden","2003","Hampden town, MA",148,2765,2913
"2890","Hampden","Hampden County","MA","Hampden","2004","Hampden town, MA",149,2769,2918
"2891","Hampden","Hampden County","MA","Hampden","2005","Hampden town, MA",126,2781,2907
"2892","Hampden","Hampden County","MA","Hampden","2006","Hampden town, MA",116,2804,2920
"2893","Hampden","Hampden County","MA","Hampden","2007","Hampden town, MA",115,2800,2915
"2894","Hampden","Hampden County","MA","Hampden","2008","Hampden town, MA",140,2825,2965
"2895","Hampden","Hampden County","MA","Hampden","2009","Hampden town, MA",206,2683,2889
"2896","Hampden","Hampden County","MA","Hampden","2010","Hampden town, MA",218,2572,2790
"2897","Hampden","Hampden County","MA","Hampden","2011","Hampden town, MA",184,2547,2731
"2898","Hampden","Hampden County","MA","Hampden","2012","Hampden town, MA",172,2548,2720
"2899",NA,"Hampden County","MA","Hampden County","1990","Hampden County, MA",14857,208015,222872
"2900",NA,"Hampden County","MA","Hampden County","1991","Hampden County, MA",21582,200238,221820
"2901",NA,"Hampden County","MA","Hampden County","1992","Hampden County, MA",20835,199015,219850
"2902",NA,"Hampden County","MA","Hampden County","1993","Hampden County, MA",19341,198001,217342
"2903",NA,"Hampden County","MA","Hampden County","1994","Hampden County, MA",16961,197840,214801
"2904",NA,"Hampden County","MA","Hampden County","1995","Hampden County, MA",14143,197823,211966
"2905",NA,"Hampden County","MA","Hampden County","1996","Hampden County, MA",11172,199829,211001
"2906",NA,"Hampden County","MA","Hampden County","1997","Hampden County, MA",10382,204128,214510
"2907",NA,"Hampden County","MA","Hampden County","1998","Hampden County, MA",9270,204770,214040
"2908",NA,"Hampden County","MA","Hampden County","1999","Hampden County, MA",8783,205357,214140
"2909",NA,"Hampden County","MA","Hampden County","2000","Hampden County, MA",7318,211898,219216
"2910",NA,"Hampden County","MA","Hampden County","2001","Hampden County, MA",9304,212446,221750
"2911",NA,"Hampden County","MA","Hampden County","2002","Hampden County, MA",12856,211762,224618
"2912",NA,"Hampden County","MA","Hampden County","2003","Hampden County, MA",14732,210081,224813
"2913",NA,"Hampden County","MA","Hampden County","2004","Hampden County, MA",13901,210330,224231
"2914",NA,"Hampden County","MA","Hampden County","2005","Hampden County, MA",13029,211071,224100
"2915",NA,"Hampden County","MA","Hampden County","2006","Hampden County, MA",13201,212066,225267
"2916",NA,"Hampden County","MA","Hampden County","2007","Hampden County, MA",12489,211474,223963
"2917",NA,"Hampden County","MA","Hampden County","2008","Hampden County, MA",14579,210907,225486
"2918",NA,"Hampden County","MA","Hampden County","2009","Hampden County, MA",21263,205679,226942
"2919",NA,"Hampden County","MA","Hampden County","2010","Hampden County, MA",22466,202854,225320
"2920",NA,"Hampden County","MA","Hampden County","2011","Hampden County, MA",20404,200849,221253
"2921",NA,"Hampden County","MA","Hampden County","2012","Hampden County, MA",18729,200969,219698
"2922",NA,"Hampshire County","MA","Hampshire County","1990","Hampshire County, MA",4111,76100,80211
"2923",NA,"Hampshire County","MA","Hampshire County","1991","Hampshire County, MA",5589,73144,78733
"2924",NA,"Hampshire County","MA","Hampshire County","1992","Hampshire County, MA",5398,73514,78912
"2925",NA,"Hampshire County","MA","Hampshire County","1993","Hampshire County, MA",4368,74173,78541
"2926",NA,"Hampshire County","MA","Hampshire County","1994","Hampshire County, MA",3906,75448,79354
"2927",NA,"Hampshire County","MA","Hampshire County","1995","Hampshire County, MA",3308,75869,79177
"2928",NA,"Hampshire County","MA","Hampshire County","1996","Hampshire County, MA",2699,77109,79808
"2929",NA,"Hampshire County","MA","Hampshire County","1997","Hampshire County, MA",2402,78922,81324
"2930",NA,"Hampshire County","MA","Hampshire County","1998","Hampshire County, MA",2287,80014,82301
"2931",NA,"Hampshire County","MA","Hampshire County","1999","Hampshire County, MA",2094,81005,83099
"2932",NA,"Hampshire County","MA","Hampshire County","2000","Hampshire County, MA",1899,84104,86003
"2933",NA,"Hampshire County","MA","Hampshire County","2001","Hampshire County, MA",2334,84150,86484
"2934",NA,"Hampshire County","MA","Hampshire County","2002","Hampshire County, MA",3113,84068,87181
"2935",NA,"Hampshire County","MA","Hampshire County","2003","Hampshire County, MA",3718,84026,87744
"2936",NA,"Hampshire County","MA","Hampshire County","2004","Hampshire County, MA",3627,84168,87795
"2937",NA,"Hampshire County","MA","Hampshire County","2005","Hampshire County, MA",3547,84257,87804
"2938",NA,"Hampshire County","MA","Hampshire County","2006","Hampshire County, MA",3489,85011,88500
"2939",NA,"Hampshire County","MA","Hampshire County","2007","Hampshire County, MA",3345,85099,88444
"2940",NA,"Hampshire County","MA","Hampshire County","2008","Hampshire County, MA",3896,84818,88714
"2941",NA,"Hampshire County","MA","Hampshire County","2009","Hampshire County, MA",5672,81759,87431
"2942",NA,"Hampshire County","MA","Hampshire County","2010","Hampshire County, MA",5855,82485,88340
"2943",NA,"Hampshire County","MA","Hampshire County","2011","Hampshire County, MA",5186,81818,87004
"2944",NA,"Hampshire County","MA","Hampshire County","2012","Hampshire County, MA",4874,82030,86904
"2945","Hancock","Berkshire County","MA","Hancock","1990","Hancock town, MA",16,357,373
"2946","Hancock","Berkshire County","MA","Hancock","1991","Hancock town, MA",17,348,365
"2947","Hancock","Berkshire County","MA","Hancock","1992","Hancock town, MA",13,397,410
"2948","Hancock","Berkshire County","MA","Hancock","1993","Hancock town, MA",23,417,440
"2949","Hancock","Berkshire County","MA","Hancock","1994","Hancock town, MA",16,396,412
"2950","Hancock","Berkshire County","MA","Hancock","1995","Hancock town, MA",17,329,346
"2951","Hancock","Berkshire County","MA","Hancock","1996","Hancock town, MA",6,331,337
"2952","Hancock","Berkshire County","MA","Hancock","1997","Hancock town, MA",7,333,340
"2953","Hancock","Berkshire County","MA","Hancock","1998","Hancock town, MA",4,223,227
"2954","Hancock","Berkshire County","MA","Hancock","1999","Hancock town, MA",1,224,225
"2955","Hancock","Berkshire County","MA","Hancock","2000","Hancock town, MA",4,388,392
"2956","Hancock","Berkshire County","MA","Hancock","2001","Hancock town, MA",7,391,398
"2957","Hancock","Berkshire County","MA","Hancock","2002","Hancock town, MA",10,424,434
"2958","Hancock","Berkshire County","MA","Hancock","2003","Hancock town, MA",11,516,527
"2959","Hancock","Berkshire County","MA","Hancock","2004","Hancock town, MA",19,554,573
"2960","Hancock","Berkshire County","MA","Hancock","2005","Hancock town, MA",13,572,585
"2961","Hancock","Berkshire County","MA","Hancock","2006","Hancock town, MA",15,589,604
"2962","Hancock","Berkshire County","MA","Hancock","2007","Hancock town, MA",12,619,631
"2963","Hancock","Berkshire County","MA","Hancock","2008","Hancock town, MA",14,631,645
"2964","Hancock","Berkshire County","MA","Hancock","2009","Hancock town, MA",19,697,716
"2965","Hancock","Berkshire County","MA","Hancock","2010","Hancock town, MA",21,382,403
"2966","Hancock","Berkshire County","MA","Hancock","2011","Hancock town, MA",18,385,403
"2967","Hancock","Berkshire County","MA","Hancock","2012","Hancock town, MA",22,384,406
"2968","Hanover","Plymouth County","MA","Hanover","1990","Hanover town, MA",351,6374,6725
"2969","Hanover","Plymouth County","MA","Hanover","1991","Hanover town, MA",500,6309,6809
"2970","Hanover","Plymouth County","MA","Hanover","1992","Hanover town, MA",526,6309,6835
"2971","Hanover","Plymouth County","MA","Hanover","1993","Hanover town, MA",433,6446,6879
"2972","Hanover","Plymouth County","MA","Hanover","1994","Hanover town, MA",312,6564,6876
"2973","Hanover","Plymouth County","MA","Hanover","1995","Hanover town, MA",323,6714,7037
"2974","Hanover","Plymouth County","MA","Hanover","1996","Hanover town, MA",261,6917,7178
"2975","Hanover","Plymouth County","MA","Hanover","1997","Hanover town, MA",237,7180,7417
"2976","Hanover","Plymouth County","MA","Hanover","1998","Hanover town, MA",167,7386,7553
"2977","Hanover","Plymouth County","MA","Hanover","1999","Hanover town, MA",195,7540,7735
"2978","Hanover","Plymouth County","MA","Hanover","2000","Hanover town, MA",156,7055,7211
"2979","Hanover","Plymouth County","MA","Hanover","2001","Hanover town, MA",205,7106,7311
"2980","Hanover","Plymouth County","MA","Hanover","2002","Hanover town, MA",276,7094,7370
"2981","Hanover","Plymouth County","MA","Hanover","2003","Hanover town, MA",335,7047,7382
"2982","Hanover","Plymouth County","MA","Hanover","2004","Hanover town, MA",316,7126,7442
"2983","Hanover","Plymouth County","MA","Hanover","2005","Hanover town, MA",310,7330,7640
"2984","Hanover","Plymouth County","MA","Hanover","2006","Hanover town, MA",302,7152,7454
"2985","Hanover","Plymouth County","MA","Hanover","2007","Hanover town, MA",278,7189,7467
"2986","Hanover","Plymouth County","MA","Hanover","2008","Hanover town, MA",339,7209,7548
"2987","Hanover","Plymouth County","MA","Hanover","2009","Hanover town, MA",521,6998,7519
"2988","Hanover","Plymouth County","MA","Hanover","2010","Hanover town, MA",540,6988,7528
"2989","Hanover","Plymouth County","MA","Hanover","2011","Hanover town, MA",460,7056,7516
"2990","Hanover","Plymouth County","MA","Hanover","2012","Hanover town, MA",411,7133,7544
"2991","Hanson","Plymouth County","MA","Hanson","1990","Hanson town, MA",379,4727,5106
"2992","Hanson","Plymouth County","MA","Hanson","1991","Hanson town, MA",570,4586,5156
"2993","Hanson","Plymouth County","MA","Hanson","1992","Hanson town, MA",557,4562,5119
"2994","Hanson","Plymouth County","MA","Hanson","1993","Hanson town, MA",430,4795,5225
"2995","Hanson","Plymouth County","MA","Hanson","1994","Hanson town, MA",309,5098,5407
"2996","Hanson","Plymouth County","MA","Hanson","1995","Hanson town, MA",317,5034,5351
"2997","Hanson","Plymouth County","MA","Hanson","1996","Hanson town, MA",284,5087,5371
"2998","Hanson","Plymouth County","MA","Hanson","1997","Hanson town, MA",265,5253,5518
"2999","Hanson","Plymouth County","MA","Hanson","1998","Hanson town, MA",196,5324,5520
"3000","Hanson","Plymouth County","MA","Hanson","1999","Hanson town, MA",193,5460,5653
"3001","Hanson","Plymouth County","MA","Hanson","2000","Hanson town, MA",144,5230,5374
"3002","Hanson","Plymouth County","MA","Hanson","2001","Hanson town, MA",175,5252,5427
"3003","Hanson","Plymouth County","MA","Hanson","2002","Hanson town, MA",250,5235,5485
"3004","Hanson","Plymouth County","MA","Hanson","2003","Hanson town, MA",297,5126,5423
"3005","Hanson","Plymouth County","MA","Hanson","2004","Hanson town, MA",280,5138,5418
"3006","Hanson","Plymouth County","MA","Hanson","2005","Hanson town, MA",275,5169,5444
"3007","Hanson","Plymouth County","MA","Hanson","2006","Hanson town, MA",261,5270,5531
"3008","Hanson","Plymouth County","MA","Hanson","2007","Hanson town, MA",278,5324,5602
"3009","Hanson","Plymouth County","MA","Hanson","2008","Hanson town, MA",311,5321,5632
"3010","Hanson","Plymouth County","MA","Hanson","2009","Hanson town, MA",479,5203,5682
"3011","Hanson","Plymouth County","MA","Hanson","2010","Hanson town, MA",521,5233,5754
"3012","Hanson","Plymouth County","MA","Hanson","2011","Hanson town, MA",457,5282,5739
"3013","Hanson","Plymouth County","MA","Hanson","2012","Hanson town, MA",385,5329,5714
"3014","Hardwick","Worcester County","MA","Hardwick","1990","Hardwick town, MA",92,1092,1184
"3015","Hardwick","Worcester County","MA","Hardwick","1991","Hardwick town, MA",128,1058,1186
"3016","Hardwick","Worcester County","MA","Hardwick","1992","Hardwick town, MA",115,1052,1167
"3017","Hardwick","Worcester County","MA","Hardwick","1993","Hardwick town, MA",124,1068,1192
"3018","Hardwick","Worcester County","MA","Hardwick","1994","Hardwick town, MA",90,1060,1150
"3019","Hardwick","Worcester County","MA","Hardwick","1995","Hardwick town, MA",84,1093,1177
"3020","Hardwick","Worcester County","MA","Hardwick","1996","Hardwick town, MA",64,1088,1152
"3021","Hardwick","Worcester County","MA","Hardwick","1997","Hardwick town, MA",64,1120,1184
"3022","Hardwick","Worcester County","MA","Hardwick","1998","Hardwick town, MA",55,1120,1175
"3023","Hardwick","Worcester County","MA","Hardwick","1999","Hardwick town, MA",59,1127,1186
"3024","Hardwick","Worcester County","MA","Hardwick","2000","Hardwick town, MA",40,1282,1322
"3025","Hardwick","Worcester County","MA","Hardwick","2001","Hardwick town, MA",55,1283,1338
"3026","Hardwick","Worcester County","MA","Hardwick","2002","Hardwick town, MA",72,1273,1345
"3027","Hardwick","Worcester County","MA","Hardwick","2003","Hardwick town, MA",90,1263,1353
"3028","Hardwick","Worcester County","MA","Hardwick","2004","Hardwick town, MA",86,1257,1343
"3029","Hardwick","Worcester County","MA","Hardwick","2005","Hardwick town, MA",72,1248,1320
"3030","Hardwick","Worcester County","MA","Hardwick","2006","Hardwick town, MA",75,1264,1339
"3031","Hardwick","Worcester County","MA","Hardwick","2007","Hardwick town, MA",78,1265,1343
"3032","Hardwick","Worcester County","MA","Hardwick","2008","Hardwick town, MA",82,1235,1317
"3033","Hardwick","Worcester County","MA","Hardwick","2009","Hardwick town, MA",131,1199,1330
"3034","Hardwick","Worcester County","MA","Hardwick","2010","Hardwick town, MA",127,1346,1473
"3035","Hardwick","Worcester County","MA","Hardwick","2011","Hardwick town, MA",127,1357,1484
"3036","Hardwick","Worcester County","MA","Hardwick","2012","Hardwick town, MA",103,1357,1460
"3037","Harvard","Worcester County","MA","Harvard","1990","Harvard town, MA",140,3586,3726
"3038","Harvard","Worcester County","MA","Harvard","1991","Harvard town, MA",136,3563,3699
"3039","Harvard","Worcester County","MA","Harvard","1992","Harvard town, MA",139,3363,3502
"3040","Harvard","Worcester County","MA","Harvard","1993","Harvard town, MA",155,3175,3330
"3041","Harvard","Worcester County","MA","Harvard","1994","Harvard town, MA",116,3195,3311
"3042","Harvard","Worcester County","MA","Harvard","1995","Harvard town, MA",100,3333,3433
"3043","Harvard","Worcester County","MA","Harvard","1996","Harvard town, MA",61,3388,3449
"3044","Harvard","Worcester County","MA","Harvard","1997","Harvard town, MA",66,3685,3751
"3045","Harvard","Worcester County","MA","Harvard","1998","Harvard town, MA",72,3534,3606
"3046","Harvard","Worcester County","MA","Harvard","1999","Harvard town, MA",76,3590,3666
"3047","Harvard","Worcester County","MA","Harvard","2000","Harvard town, MA",52,2878,2930
"3048","Harvard","Worcester County","MA","Harvard","2001","Harvard town, MA",87,2894,2981
"3049","Harvard","Worcester County","MA","Harvard","2002","Harvard town, MA",151,2860,3011
"3050","Harvard","Worcester County","MA","Harvard","2003","Harvard town, MA",142,2822,2964
"3051","Harvard","Worcester County","MA","Harvard","2004","Harvard town, MA",123,2813,2936
"3052","Harvard","Worcester County","MA","Harvard","2005","Harvard town, MA",106,2837,2943
"3053","Harvard","Worcester County","MA","Harvard","2006","Harvard town, MA",101,2840,2941
"3054","Harvard","Worcester County","MA","Harvard","2007","Harvard town, MA",92,2867,2959
"3055","Harvard","Worcester County","MA","Harvard","2008","Harvard town, MA",111,2825,2936
"3056","Harvard","Worcester County","MA","Harvard","2009","Harvard town, MA",185,2742,2927
"3057","Harvard","Worcester County","MA","Harvard","2010","Harvard town, MA",180,2950,3130
"3058","Harvard","Worcester County","MA","Harvard","2011","Harvard town, MA",156,2971,3127
"3059","Harvard","Worcester County","MA","Harvard","2012","Harvard town, MA",154,3003,3157
"3060","Harwich","Barnstable County","MA","Harwich","1990","Harwich town, MA",354,4336,4690
"3061","Harwich","Barnstable County","MA","Harwich","1991","Harwich town, MA",510,4236,4746
"3062","Harwich","Barnstable County","MA","Harwich","1992","Harwich town, MA",446,4198,4644
"3063","Harwich","Barnstable County","MA","Harwich","1993","Harwich town, MA",449,4331,4780
"3064","Harwich","Barnstable County","MA","Harwich","1994","Harwich town, MA",376,4488,4864
"3065","Harwich","Barnstable County","MA","Harwich","1995","Harwich town, MA",334,4613,4947
"3066","Harwich","Barnstable County","MA","Harwich","1996","Harwich town, MA",294,4734,5028
"3067","Harwich","Barnstable County","MA","Harwich","1997","Harwich town, MA",287,4819,5106
"3068","Harwich","Barnstable County","MA","Harwich","1998","Harwich town, MA",245,4957,5202
"3069","Harwich","Barnstable County","MA","Harwich","1999","Harwich town, MA",217,5172,5389
"3070","Harwich","Barnstable County","MA","Harwich","2000","Harwich town, MA",210,5728,5938
"3071","Harwich","Barnstable County","MA","Harwich","2001","Harwich town, MA",238,5794,6032
"3072","Harwich","Barnstable County","MA","Harwich","2002","Harwich town, MA",303,5947,6250
"3073","Harwich","Barnstable County","MA","Harwich","2003","Harwich town, MA",343,6072,6415
"3074","Harwich","Barnstable County","MA","Harwich","2004","Harwich town, MA",330,6122,6452
"3075","Harwich","Barnstable County","MA","Harwich","2005","Harwich town, MA",343,6094,6437
"3076","Harwich","Barnstable County","MA","Harwich","2006","Harwich town, MA",323,6085,6408
"3077","Harwich","Barnstable County","MA","Harwich","2007","Harwich town, MA",320,6047,6367
"3078","Harwich","Barnstable County","MA","Harwich","2008","Harwich town, MA",396,5997,6393
"3079","Harwich","Barnstable County","MA","Harwich","2009","Harwich town, MA",568,5808,6376
"3080","Harwich","Barnstable County","MA","Harwich","2010","Harwich town, MA",627,5886,6513
"3081","Harwich","Barnstable County","MA","Harwich","2011","Harwich town, MA",563,5876,6439
"3082","Harwich","Barnstable County","MA","Harwich","2012","Harwich town, MA",489,5974,6463
"3083","Hatfield","Hampshire County","MA","Hatfield","1990","Hatfield town, MA",107,1677,1784
"3084","Hatfield","Hampshire County","MA","Hatfield","1991","Hatfield town, MA",130,1608,1738
"3085","Hatfield","Hampshire County","MA","Hatfield","1992","Hatfield town, MA",145,1627,1772
"3086","Hatfield","Hampshire County","MA","Hatfield","1993","Hatfield town, MA",119,1607,1726
"3087","Hatfield","Hampshire County","MA","Hatfield","1994","Hatfield town, MA",112,1608,1720
"3088","Hatfield","Hampshire County","MA","Hatfield","1995","Hatfield town, MA",69,1645,1714
"3089","Hatfield","Hampshire County","MA","Hatfield","1996","Hatfield town, MA",59,1674,1733
"3090","Hatfield","Hampshire County","MA","Hatfield","1997","Hatfield town, MA",56,1706,1762
"3091","Hatfield","Hampshire County","MA","Hatfield","1998","Hatfield town, MA",54,1709,1763
"3092","Hatfield","Hampshire County","MA","Hatfield","1999","Hatfield town, MA",55,1727,1782
"3093","Hatfield","Hampshire County","MA","Hatfield","2000","Hatfield town, MA",46,1977,2023
"3094","Hatfield","Hampshire County","MA","Hatfield","2001","Hatfield town, MA",49,1985,2034
"3095","Hatfield","Hampshire County","MA","Hatfield","2002","Hatfield town, MA",76,1991,2067
"3096","Hatfield","Hampshire County","MA","Hatfield","2003","Hatfield town, MA",90,1976,2066
"3097","Hatfield","Hampshire County","MA","Hatfield","2004","Hatfield town, MA",89,1970,2059
"3098","Hatfield","Hampshire County","MA","Hatfield","2005","Hatfield town, MA",80,1964,2044
"3099","Hatfield","Hampshire County","MA","Hatfield","2006","Hatfield town, MA",76,1964,2040
"3100","Hatfield","Hampshire County","MA","Hatfield","2007","Hatfield town, MA",81,1967,2048
"3101","Hatfield","Hampshire County","MA","Hatfield","2008","Hatfield town, MA",82,1931,2013
"3102","Hatfield","Hampshire County","MA","Hatfield","2009","Hatfield town, MA",118,1855,1973
"3103","Hatfield","Hampshire County","MA","Hatfield","2010","Hatfield town, MA",118,1878,1996
"3104","Hatfield","Hampshire County","MA","Hatfield","2011","Hatfield town, MA",114,1854,1968
"3105","Hatfield","Hampshire County","MA","Hatfield","2012","Hatfield town, MA",110,1855,1965
"3106","Haverhill","Essex County","MA","Haverhill","1990","Haverhill city, MA",1891,24679,26570
"3107","Haverhill","Essex County","MA","Haverhill","1991","Haverhill city, MA",2698,24289,26987
"3108","Haverhill","Essex County","MA","Haverhill","1992","Haverhill city, MA",2613,24545,27158
"3109","Haverhill","Essex County","MA","Haverhill","1993","Haverhill city, MA",2368,24982,27350
"3110","Haverhill","Essex County","MA","Haverhill","1994","Haverhill city, MA",2079,25460,27539
"3111","Haverhill","Essex County","MA","Haverhill","1995","Haverhill city, MA",1700,26091,27791
"3112","Haverhill","Essex County","MA","Haverhill","1996","Haverhill city, MA",1415,26976,28391
"3113","Haverhill","Essex County","MA","Haverhill","1997","Haverhill city, MA",1503,27403,28906
"3114","Haverhill","Essex County","MA","Haverhill","1998","Haverhill city, MA",1278,27881,29159
"3115","Haverhill","Essex County","MA","Haverhill","1999","Haverhill city, MA",1190,28610,29800
"3116","Haverhill","Essex County","MA","Haverhill","2000","Haverhill city, MA",840,30749,31589
"3117","Haverhill","Essex County","MA","Haverhill","2001","Haverhill city, MA",1322,30534,31856
"3118","Haverhill","Essex County","MA","Haverhill","2002","Haverhill city, MA",2038,29624,31662
"3119","Haverhill","Essex County","MA","Haverhill","2003","Haverhill city, MA",2052,29189,31241
"3120","Haverhill","Essex County","MA","Haverhill","2004","Haverhill city, MA",1783,28897,30680
"3121","Haverhill","Essex County","MA","Haverhill","2005","Haverhill city, MA",1630,29018,30648
"3122","Haverhill","Essex County","MA","Haverhill","2006","Haverhill city, MA",1542,29252,30794
"3123","Haverhill","Essex County","MA","Haverhill","2007","Haverhill city, MA",1478,29162,30640
"3124","Haverhill","Essex County","MA","Haverhill","2008","Haverhill city, MA",1852,29391,31243
"3125","Haverhill","Essex County","MA","Haverhill","2009","Haverhill city, MA",2878,28571,31449
"3126","Haverhill","Essex County","MA","Haverhill","2010","Haverhill city, MA",2885,28946,31831
"3127","Haverhill","Essex County","MA","Haverhill","2011","Haverhill city, MA",2600,29316,31916
"3128","Haverhill","Essex County","MA","Haverhill","2012","Haverhill city, MA",2328,29701,32029
"3129","Hawley","Franklin County","MA","Hawley","1990","Hawley town, MA",6,146,152
"3130","Hawley","Franklin County","MA","Hawley","1991","Hawley town, MA",11,140,151
"3131","Hawley","Franklin County","MA","Hawley","1992","Hawley town, MA",9,134,143
"3132","Hawley","Franklin County","MA","Hawley","1993","Hawley town, MA",10,130,140
"3133","Hawley","Franklin County","MA","Hawley","1994","Hawley town, MA",8,126,134
"3134","Hawley","Franklin County","MA","Hawley","1995","Hawley town, MA",11,155,166
"3135","Hawley","Franklin County","MA","Hawley","1996","Hawley town, MA",7,154,161
"3136","Hawley","Franklin County","MA","Hawley","1997","Hawley town, MA",7,157,164
"3137","Hawley","Franklin County","MA","Hawley","1998","Hawley town, MA",6,159,165
"3138","Hawley","Franklin County","MA","Hawley","1999","Hawley town, MA",4,162,166
"3139","Hawley","Franklin County","MA","Hawley","2000","Hawley town, MA",4,166,170
"3140","Hawley","Franklin County","MA","Hawley","2001","Hawley town, MA",5,167,172
"3141","Hawley","Franklin County","MA","Hawley","2002","Hawley town, MA",9,168,177
"3142","Hawley","Franklin County","MA","Hawley","2003","Hawley town, MA",11,171,182
"3143","Hawley","Franklin County","MA","Hawley","2004","Hawley town, MA",7,169,176
"3144","Hawley","Franklin County","MA","Hawley","2005","Hawley town, MA",7,168,175
"3145","Hawley","Franklin County","MA","Hawley","2006","Hawley town, MA",7,168,175
"3146","Hawley","Franklin County","MA","Hawley","2007","Hawley town, MA",7,164,171
"3147","Hawley","Franklin County","MA","Hawley","2008","Hawley town, MA",8,162,170
"3148","Hawley","Franklin County","MA","Hawley","2009","Hawley town, MA",10,157,167
"3149","Hawley","Franklin County","MA","Hawley","2010","Hawley town, MA",12,159,171
"3150","Hawley","Franklin County","MA","Hawley","2011","Hawley town, MA",12,160,172
"3151","Hawley","Franklin County","MA","Hawley","2012","Hawley town, MA",11,161,172
"3152","Heath","Franklin County","MA","Heath","1990","Heath town, MA",9,335,344
"3153","Heath","Franklin County","MA","Heath","1991","Heath town, MA",14,341,355
"3154","Heath","Franklin County","MA","Heath","1992","Heath town, MA",13,323,336
"3155","Heath","Franklin County","MA","Heath","1993","Heath town, MA",14,329,343
"3156","Heath","Franklin County","MA","Heath","1994","Heath town, MA",14,340,354
"3157","Heath","Franklin County","MA","Heath","1995","Heath town, MA",12,352,364
"3158","Heath","Franklin County","MA","Heath","1996","Heath town, MA",12,354,366
"3159","Heath","Franklin County","MA","Heath","1997","Heath town, MA",9,361,370
"3160","Heath","Franklin County","MA","Heath","1998","Heath town, MA",11,369,380
"3161","Heath","Franklin County","MA","Heath","1999","Heath town, MA",12,377,389
"3162","Heath","Franklin County","MA","Heath","2000","Heath town, MA",8,459,467
"3163","Heath","Franklin County","MA","Heath","2001","Heath town, MA",10,457,467
"3164","Heath","Franklin County","MA","Heath","2002","Heath town, MA",14,463,477
"3165","Heath","Franklin County","MA","Heath","2003","Heath town, MA",17,463,480
"3166","Heath","Franklin County","MA","Heath","2004","Heath town, MA",16,456,472
"3167","Heath","Franklin County","MA","Heath","2005","Heath town, MA",14,454,468
"3168","Heath","Franklin County","MA","Heath","2006","Heath town, MA",18,455,473
"3169","Heath","Franklin County","MA","Heath","2007","Heath town, MA",17,449,466
"3170","Heath","Franklin County","MA","Heath","2008","Heath town, MA",23,443,466
"3171","Heath","Franklin County","MA","Heath","2009","Heath town, MA",26,429,455
"3172","Heath","Franklin County","MA","Heath","2010","Heath town, MA",29,387,416
"3173","Heath","Franklin County","MA","Heath","2011","Heath town, MA",25,388,413
"3174","Heath","Franklin County","MA","Heath","2012","Heath town, MA",21,389,410
"3175","Hingham","Plymouth County","MA","Hingham","1990","Hingham town, MA",448,10063,10511
"3176","Hingham","Plymouth County","MA","Hingham","1991","Hingham town, MA",621,9761,10382
"3177","Hingham","Plymouth County","MA","Hingham","1992","Hingham town, MA",630,9647,10277
"3178","Hingham","Plymouth County","MA","Hingham","1993","Hingham town, MA",489,9796,10285
"3179","Hingham","Plymouth County","MA","Hingham","1994","Hingham town, MA",439,9982,10421
"3180","Hingham","Plymouth County","MA","Hingham","1995","Hingham town, MA",357,10137,10494
"3181","Hingham","Plymouth County","MA","Hingham","1996","Hingham town, MA",333,10353,10686
"3182","Hingham","Plymouth County","MA","Hingham","1997","Hingham town, MA",296,10628,10924
"3183","Hingham","Plymouth County","MA","Hingham","1998","Hingham town, MA",221,10803,11024
"3184","Hingham","Plymouth County","MA","Hingham","1999","Hingham town, MA",215,10938,11153
"3185","Hingham","Plymouth County","MA","Hingham","2000","Hingham town, MA",206,9969,10175
"3186","Hingham","Plymouth County","MA","Hingham","2001","Hingham town, MA",272,10005,10277
"3187","Hingham","Plymouth County","MA","Hingham","2002","Hingham town, MA",411,9877,10288
"3188","Hingham","Plymouth County","MA","Hingham","2003","Hingham town, MA",450,9798,10248
"3189","Hingham","Plymouth County","MA","Hingham","2004","Hingham town, MA",411,10210,10621
"3190","Hingham","Plymouth County","MA","Hingham","2005","Hingham town, MA",363,10468,10831
"3191","Hingham","Plymouth County","MA","Hingham","2006","Hingham town, MA",385,10393,10778
"3192","Hingham","Plymouth County","MA","Hingham","2007","Hingham town, MA",366,10821,11187
"3193","Hingham","Plymouth County","MA","Hingham","2008","Hingham town, MA",452,10864,11316
"3194","Hingham","Plymouth County","MA","Hingham","2009","Hingham town, MA",698,10827,11525
"3195","Hingham","Plymouth County","MA","Hingham","2010","Hingham town, MA",673,10446,11119
"3196","Hingham","Plymouth County","MA","Hingham","2011","Hingham town, MA",557,10548,11105
"3197","Hingham","Plymouth County","MA","Hingham","2012","Hingham town, MA",532,10664,11196
"3198","Hinsdale","Berkshire County","MA","Hinsdale","1990","Hinsdale town, MA",82,938,1020
"3199","Hinsdale","Berkshire County","MA","Hinsdale","1991","Hinsdale town, MA",118,904,1022
"3200","Hinsdale","Berkshire County","MA","Hinsdale","1992","Hinsdale town, MA",148,901,1049
"3201","Hinsdale","Berkshire County","MA","Hinsdale","1993","Hinsdale town, MA",113,909,1022
"3202","Hinsdale","Berkshire County","MA","Hinsdale","1994","Hinsdale town, MA",109,905,1014
"3203","Hinsdale","Berkshire County","MA","Hinsdale","1995","Hinsdale town, MA",74,850,924
"3204","Hinsdale","Berkshire County","MA","Hinsdale","1996","Hinsdale town, MA",75,862,937
"3205","Hinsdale","Berkshire County","MA","Hinsdale","1997","Hinsdale town, MA",72,868,940
"3206","Hinsdale","Berkshire County","MA","Hinsdale","1998","Hinsdale town, MA",62,865,927
"3207","Hinsdale","Berkshire County","MA","Hinsdale","1999","Hinsdale town, MA",67,866,933
"3208","Hinsdale","Berkshire County","MA","Hinsdale","2000","Hinsdale town, MA",37,995,1032
"3209","Hinsdale","Berkshire County","MA","Hinsdale","2001","Hinsdale town, MA",46,992,1038
"3210","Hinsdale","Berkshire County","MA","Hinsdale","2002","Hinsdale town, MA",61,1003,1064
"3211","Hinsdale","Berkshire County","MA","Hinsdale","2003","Hinsdale town, MA",61,995,1056
"3212","Hinsdale","Berkshire County","MA","Hinsdale","2004","Hinsdale town, MA",50,991,1041
"3213","Hinsdale","Berkshire County","MA","Hinsdale","2005","Hinsdale town, MA",46,1002,1048
"3214","Hinsdale","Berkshire County","MA","Hinsdale","2006","Hinsdale town, MA",49,1012,1061
"3215","Hinsdale","Berkshire County","MA","Hinsdale","2007","Hinsdale town, MA",48,1097,1145
"3216","Hinsdale","Berkshire County","MA","Hinsdale","2008","Hinsdale town, MA",75,1076,1151
"3217","Hinsdale","Berkshire County","MA","Hinsdale","2009","Hinsdale town, MA",119,1044,1163
"3218","Hinsdale","Berkshire County","MA","Hinsdale","2010","Hinsdale town, MA",130,1072,1202
"3219","Hinsdale","Berkshire County","MA","Hinsdale","2011","Hinsdale town, MA",115,1082,1197
"3220","Hinsdale","Berkshire County","MA","Hinsdale","2012","Hinsdale town, MA",99,1077,1176
"3221","Holbrook","Norfolk County","MA","Holbrook","1990","Holbrook town, MA",382,5711,6093
"3222","Holbrook","Norfolk County","MA","Holbrook","1991","Holbrook town, MA",546,5512,6058
"3223","Holbrook","Norfolk County","MA","Holbrook","1992","Holbrook town, MA",585,5490,6075
"3224","Holbrook","Norfolk County","MA","Holbrook","1993","Holbrook town, MA",503,5550,6053
"3225","Holbrook","Norfolk County","MA","Holbrook","1994","Holbrook town, MA",357,5651,6008
"3226","Holbrook","Norfolk County","MA","Holbrook","1995","Holbrook town, MA",315,5685,6000
"3227","Holbrook","Norfolk County","MA","Holbrook","1996","Holbrook town, MA",271,5786,6057
"3228","Holbrook","Norfolk County","MA","Holbrook","1997","Holbrook town, MA",252,5917,6169
"3229","Holbrook","Norfolk County","MA","Holbrook","1998","Holbrook town, MA",185,5995,6180
"3230","Holbrook","Norfolk County","MA","Holbrook","1999","Holbrook town, MA",181,6058,6239
"3231","Holbrook","Norfolk County","MA","Holbrook","2000","Holbrook town, MA",170,5658,5828
"3232","Holbrook","Norfolk County","MA","Holbrook","2001","Holbrook town, MA",210,5642,5852
"3233","Holbrook","Norfolk County","MA","Holbrook","2002","Holbrook town, MA",315,5558,5873
"3234","Holbrook","Norfolk County","MA","Holbrook","2003","Holbrook town, MA",350,5478,5828
"3235","Holbrook","Norfolk County","MA","Holbrook","2004","Holbrook town, MA",331,5472,5803
"3236","Holbrook","Norfolk County","MA","Holbrook","2005","Holbrook town, MA",322,5499,5821
"3237","Holbrook","Norfolk County","MA","Holbrook","2006","Holbrook town, MA",341,5389,5730
"3238","Holbrook","Norfolk County","MA","Holbrook","2007","Holbrook town, MA",320,5414,5734
"3239","Holbrook","Norfolk County","MA","Holbrook","2008","Holbrook town, MA",341,5407,5748
"3240","Holbrook","Norfolk County","MA","Holbrook","2009","Holbrook town, MA",517,5226,5743
"3241","Holbrook","Norfolk County","MA","Holbrook","2010","Holbrook town, MA",537,5334,5871
"3242","Holbrook","Norfolk County","MA","Holbrook","2011","Holbrook town, MA",470,5394,5864
"3243","Holbrook","Norfolk County","MA","Holbrook","2012","Holbrook town, MA",414,5453,5867
"3244","Holden","Worcester County","MA","Holden","1990","Holden town, MA",383,7469,7852
"3245","Holden","Worcester County","MA","Holden","1991","Holden town, MA",565,7261,7826
"3246","Holden","Worcester County","MA","Holden","1992","Holden town, MA",535,7335,7870
"3247","Holden","Worcester County","MA","Holden","1993","Holden town, MA",401,7568,7969
"3248","Holden","Worcester County","MA","Holden","1994","Holden town, MA",324,7764,8088
"3249","Holden","Worcester County","MA","Holden","1995","Holden town, MA",269,7568,7837
"3250","Holden","Worcester County","MA","Holden","1996","Holden town, MA",220,7691,7911
"3251","Holden","Worcester County","MA","Holden","1997","Holden town, MA",208,7902,8110
"3252","Holden","Worcester County","MA","Holden","1998","Holden town, MA",184,8080,8264
"3253","Holden","Worcester County","MA","Holden","1999","Holden town, MA",201,8087,8288
"3254","Holden","Worcester County","MA","Holden","2000","Holden town, MA",179,8185,8364
"3255","Holden","Worcester County","MA","Holden","2001","Holden town, MA",232,8255,8487
"3256","Holden","Worcester County","MA","Holden","2002","Holden town, MA",373,8230,8603
"3257","Holden","Worcester County","MA","Holden","2003","Holden town, MA",428,8302,8730
"3258","Holden","Worcester County","MA","Holden","2004","Holden town, MA",410,8369,8779
"3259","Holden","Worcester County","MA","Holden","2005","Holden town, MA",362,8342,8704
"3260","Holden","Worcester County","MA","Holden","2006","Holden town, MA",365,8723,9088
"3261","Holden","Worcester County","MA","Holden","2007","Holden town, MA",355,8846,9201
"3262","Holden","Worcester County","MA","Holden","2008","Holden town, MA",410,8685,9095
"3263","Holden","Worcester County","MA","Holden","2009","Holden town, MA",669,8467,9136
"3264","Holden","Worcester County","MA","Holden","2010","Holden town, MA",651,8348,8999
"3265","Holden","Worcester County","MA","Holden","2011","Holden town, MA",557,8423,8980
"3266","Holden","Worcester County","MA","Holden","2012","Holden town, MA",517,8420,8937
"3267","Holland","Hampden County","MA","Holland","1990","Holland town, MA",55,1084,1139
"3268","Holland","Hampden County","MA","Holland","1991","Holland town, MA",89,1112,1201
"3269","Holland","Hampden County","MA","Holland","1992","Holland town, MA",85,981,1066
"3270","Holland","Hampden County","MA","Holland","1993","Holland town, MA",89,1009,1098
"3271","Holland","Hampden County","MA","Holland","1994","Holland town, MA",93,1018,1111
"3272","Holland","Hampden County","MA","Holland","1995","Holland town, MA",58,987,1045
"3273","Holland","Hampden County","MA","Holland","1996","Holland town, MA",56,994,1050
"3274","Holland","Hampden County","MA","Holland","1997","Holland town, MA",48,1009,1057
"3275","Holland","Hampden County","MA","Holland","1998","Holland town, MA",39,1015,1054
"3276","Holland","Hampden County","MA","Holland","1999","Holland town, MA",38,1005,1043
"3277","Holland","Hampden County","MA","Holland","2000","Holland town, MA",40,1350,1390
"3278","Holland","Hampden County","MA","Holland","2001","Holland town, MA",49,1344,1393
"3279","Holland","Hampden County","MA","Holland","2002","Holland town, MA",67,1340,1407
"3280","Holland","Hampden County","MA","Holland","2003","Holland town, MA",84,1345,1429
"3281","Holland","Hampden County","MA","Holland","2004","Holland town, MA",76,1346,1422
"3282","Holland","Hampden County","MA","Holland","2005","Holland town, MA",70,1369,1439
"3283","Holland","Hampden County","MA","Holland","2006","Holland town, MA",80,1388,1468
"3284","Holland","Hampden County","MA","Holland","2007","Holland town, MA",77,1393,1470
"3285","Holland","Hampden County","MA","Holland","2008","Holland town, MA",91,1354,1445
"3286","Holland","Hampden County","MA","Holland","2009","Holland town, MA",122,1321,1443
"3287","Holland","Hampden County","MA","Holland","2010","Holland town, MA",134,1282,1416
"3288","Holland","Hampden County","MA","Holland","2011","Holland town, MA",112,1290,1402
"3289","Holland","Hampden County","MA","Holland","2012","Holland town, MA",109,1290,1399
"3290","Holliston","Middlesex County","MA","Holliston","1990","Holliston town, MA",371,7133,7504
"3291","Holliston","Middlesex County","MA","Holliston","1991","Holliston town, MA",506,6939,7445
"3292","Holliston","Middlesex County","MA","Holliston","1992","Holliston town, MA",483,6933,7416
"3293","Holliston","Middlesex County","MA","Holliston","1993","Holliston town, MA",345,7076,7421
"3294","Holliston","Middlesex County","MA","Holliston","1994","Holliston town, MA",314,7248,7562
"3295","Holliston","Middlesex County","MA","Holliston","1995","Holliston town, MA",281,7251,7532
"3296","Holliston","Middlesex County","MA","Holliston","1996","Holliston town, MA",220,7432,7652
"3297","Holliston","Middlesex County","MA","Holliston","1997","Holliston town, MA",214,7658,7872
"3298","Holliston","Middlesex County","MA","Holliston","1998","Holliston town, MA",179,7813,7992
"3299","Holliston","Middlesex County","MA","Holliston","1999","Holliston town, MA",173,7919,8092
"3300","Holliston","Middlesex County","MA","Holliston","2000","Holliston town, MA",155,7369,7524
"3301","Holliston","Middlesex County","MA","Holliston","2001","Holliston town, MA",208,7405,7613
"3302","Holliston","Middlesex County","MA","Holliston","2002","Holliston town, MA",353,7235,7588
"3303","Holliston","Middlesex County","MA","Holliston","2003","Holliston town, MA",359,7108,7467
"3304","Holliston","Middlesex County","MA","Holliston","2004","Holliston town, MA",308,7141,7449
"3305","Holliston","Middlesex County","MA","Holliston","2005","Holliston town, MA",267,7217,7484
"3306","Holliston","Middlesex County","MA","Holliston","2006","Holliston town, MA",267,7283,7550
"3307","Holliston","Middlesex County","MA","Holliston","2007","Holliston town, MA",252,7397,7649
"3308","Holliston","Middlesex County","MA","Holliston","2008","Holliston town, MA",296,7442,7738
"3309","Holliston","Middlesex County","MA","Holliston","2009","Holliston town, MA",493,7246,7739
"3310","Holliston","Middlesex County","MA","Holliston","2010","Holliston town, MA",452,6846,7298
"3311","Holliston","Middlesex County","MA","Holliston","2011","Holliston town, MA",410,6913,7323
"3312","Holliston","Middlesex County","MA","Holliston","2012","Holliston town, MA",366,6976,7342
"3313","Holyoke","Hampden County","MA","Holyoke","1990","Holyoke city, MA",1542,16161,17703
"3314","Holyoke","Hampden County","MA","Holyoke","1991","Holyoke city, MA",2117,15354,17471
"3315","Holyoke","Hampden County","MA","Holyoke","1992","Holyoke city, MA",1876,15016,16892
"3316","Holyoke","Hampden County","MA","Holyoke","1993","Holyoke city, MA",1688,14669,16357
"3317","Holyoke","Hampden County","MA","Holyoke","1994","Holyoke city, MA",1508,14518,16026
"3318","Holyoke","Hampden County","MA","Holyoke","1995","Holyoke city, MA",1428,15085,16513
"3319","Holyoke","Hampden County","MA","Holyoke","1996","Holyoke city, MA",1073,15197,16270
"3320","Holyoke","Hampden County","MA","Holyoke","1997","Holyoke city, MA",958,15479,16437
"3321","Holyoke","Hampden County","MA","Holyoke","1998","Holyoke city, MA",952,15470,16422
"3322","Holyoke","Hampden County","MA","Holyoke","1999","Holyoke city, MA",817,15445,16262
"3323","Holyoke","Hampden County","MA","Holyoke","2000","Holyoke city, MA",652,15265,15917
"3324","Holyoke","Hampden County","MA","Holyoke","2001","Holyoke city, MA",854,15297,16151
"3325","Holyoke","Hampden County","MA","Holyoke","2002","Holyoke city, MA",1140,15200,16340
"3326","Holyoke","Hampden County","MA","Holyoke","2003","Holyoke city, MA",1300,15041,16341
"3327","Holyoke","Hampden County","MA","Holyoke","2004","Holyoke city, MA",1211,15037,16248
"3328","Holyoke","Hampden County","MA","Holyoke","2005","Holyoke city, MA",1224,15058,16282
"3329","Holyoke","Hampden County","MA","Holyoke","2006","Holyoke city, MA",1154,15087,16241
"3330","Holyoke","Hampden County","MA","Holyoke","2007","Holyoke city, MA",1082,15119,16201
"3331","Holyoke","Hampden County","MA","Holyoke","2008","Holyoke city, MA",1284,15064,16348
"3332","Holyoke","Hampden County","MA","Holyoke","2009","Holyoke city, MA",1842,14539,16381
"3333","Holyoke","Hampden County","MA","Holyoke","2010","Holyoke city, MA",1835,14389,16224
"3334","Holyoke","Hampden County","MA","Holyoke","2011","Holyoke city, MA",1692,14245,15937
"3335","Holyoke","Hampden County","MA","Holyoke","2012","Holyoke city, MA",1631,14254,15885
"3336","Hopedale","Worcester County","MA","Hopedale","1990","Hopedale town, MA",206,2772,2978
"3337","Hopedale","Worcester County","MA","Hopedale","1991","Hopedale town, MA",238,2670,2908
"3338","Hopedale","Worcester County","MA","Hopedale","1992","Hopedale town, MA",227,2651,2878
"3339","Hopedale","Worcester County","MA","Hopedale","1993","Hopedale town, MA",211,2703,2914
"3340","Hopedale","Worcester County","MA","Hopedale","1994","Hopedale town, MA",143,2743,2886
"3341","Hopedale","Worcester County","MA","Hopedale","1995","Hopedale town, MA",126,2720,2846
"3342","Hopedale","Worcester County","MA","Hopedale","1996","Hopedale town, MA",106,2760,2866
"3343","Hopedale","Worcester County","MA","Hopedale","1997","Hopedale town, MA",110,2826,2936
"3344","Hopedale","Worcester County","MA","Hopedale","1998","Hopedale town, MA",91,2885,2976
"3345","Hopedale","Worcester County","MA","Hopedale","1999","Hopedale town, MA",73,2967,3040
"3346","Hopedale","Worcester County","MA","Hopedale","2000","Hopedale town, MA",73,3164,3237
"3347","Hopedale","Worcester County","MA","Hopedale","2001","Hopedale town, MA",102,3201,3303
"3348","Hopedale","Worcester County","MA","Hopedale","2002","Hopedale town, MA",152,3179,3331
"3349","Hopedale","Worcester County","MA","Hopedale","2003","Hopedale town, MA",176,3163,3339
"3350","Hopedale","Worcester County","MA","Hopedale","2004","Hopedale town, MA",151,3199,3350
"3351","Hopedale","Worcester County","MA","Hopedale","2005","Hopedale town, MA",141,3260,3401
"3352","Hopedale","Worcester County","MA","Hopedale","2006","Hopedale town, MA",137,3270,3407
"3353","Hopedale","Worcester County","MA","Hopedale","2007","Hopedale town, MA",130,3278,3408
"3354","Hopedale","Worcester County","MA","Hopedale","2008","Hopedale town, MA",164,3295,3459
"3355","Hopedale","Worcester County","MA","Hopedale","2009","Hopedale town, MA",249,3195,3444
"3356","Hopedale","Worcester County","MA","Hopedale","2010","Hopedale town, MA",229,2994,3223
"3357","Hopedale","Worcester County","MA","Hopedale","2011","Hopedale town, MA",209,3002,3211
"3358","Hopedale","Worcester County","MA","Hopedale","2012","Hopedale town, MA",182,3030,3212
"3359","Hopkinton","Middlesex County","MA","Hopkinton","1990","Hopkinton town, MA",253,4977,5230
"3360","Hopkinton","Middlesex County","MA","Hopkinton","1991","Hopkinton town, MA",364,4987,5351
"3361","Hopkinton","Middlesex County","MA","Hopkinton","1992","Hopkinton town, MA",364,5106,5470
"3362","Hopkinton","Middlesex County","MA","Hopkinton","1993","Hopkinton town, MA",310,5351,5661
"3363","Hopkinton","Middlesex County","MA","Hopkinton","1994","Hopkinton town, MA",247,5628,5875
"3364","Hopkinton","Middlesex County","MA","Hopkinton","1995","Hopkinton town, MA",242,5517,5759
"3365","Hopkinton","Middlesex County","MA","Hopkinton","1996","Hopkinton town, MA",192,5830,6022
"3366","Hopkinton","Middlesex County","MA","Hopkinton","1997","Hopkinton town, MA",175,6123,6298
"3367","Hopkinton","Middlesex County","MA","Hopkinton","1998","Hopkinton town, MA",151,6331,6482
"3368","Hopkinton","Middlesex County","MA","Hopkinton","1999","Hopkinton town, MA",145,6556,6701
"3369","Hopkinton","Middlesex County","MA","Hopkinton","2000","Hopkinton town, MA",141,6905,7046
"3370","Hopkinton","Middlesex County","MA","Hopkinton","2001","Hopkinton town, MA",219,7056,7275
"3371","Hopkinton","Middlesex County","MA","Hopkinton","2002","Hopkinton town, MA",342,6960,7302
"3372","Hopkinton","Middlesex County","MA","Hopkinton","2003","Hopkinton town, MA",363,6889,7252
"3373","Hopkinton","Middlesex County","MA","Hopkinton","2004","Hopkinton town, MA",302,6945,7247
"3374","Hopkinton","Middlesex County","MA","Hopkinton","2005","Hopkinton town, MA",275,7095,7370
"3375","Hopkinton","Middlesex County","MA","Hopkinton","2006","Hopkinton town, MA",254,7166,7420
"3376","Hopkinton","Middlesex County","MA","Hopkinton","2007","Hopkinton town, MA",241,7323,7564
"3377","Hopkinton","Middlesex County","MA","Hopkinton","2008","Hopkinton town, MA",302,7406,7708
"3378","Hopkinton","Middlesex County","MA","Hopkinton","2009","Hopkinton town, MA",464,7219,7683
"3379","Hopkinton","Middlesex County","MA","Hopkinton","2010","Hopkinton town, MA",496,7277,7773
"3380","Hopkinton","Middlesex County","MA","Hopkinton","2011","Hopkinton town, MA",395,7348,7743
"3381","Hopkinton","Middlesex County","MA","Hopkinton","2012","Hopkinton town, MA",369,7415,7784
"3382","Hubbardston","Worcester County","MA","Hubbardston","1990","Hubbardston town, MA",109,1427,1536
"3383","Hubbardston","Worcester County","MA","Hubbardston","1991","Hubbardston town, MA",183,1410,1593
"3384","Hubbardston","Worcester County","MA","Hubbardston","1992","Hubbardston town, MA",178,1482,1660
"3385","Hubbardston","Worcester County","MA","Hubbardston","1993","Hubbardston town, MA",155,1565,1720
"3386","Hubbardston","Worcester County","MA","Hubbardston","1994","Hubbardston town, MA",149,1587,1736
"3387","Hubbardston","Worcester County","MA","Hubbardston","1995","Hubbardston town, MA",111,1552,1663
"3388","Hubbardston","Worcester County","MA","Hubbardston","1996","Hubbardston town, MA",121,1566,1687
"3389","Hubbardston","Worcester County","MA","Hubbardston","1997","Hubbardston town, MA",104,1638,1742
"3390","Hubbardston","Worcester County","MA","Hubbardston","1998","Hubbardston town, MA",99,1701,1800
"3391","Hubbardston","Worcester County","MA","Hubbardston","1999","Hubbardston town, MA",86,1745,1831
"3392","Hubbardston","Worcester County","MA","Hubbardston","2000","Hubbardston town, MA",59,2177,2236
"3393","Hubbardston","Worcester County","MA","Hubbardston","2001","Hubbardston town, MA",88,2225,2313
"3394","Hubbardston","Worcester County","MA","Hubbardston","2002","Hubbardston town, MA",126,2239,2365
"3395","Hubbardston","Worcester County","MA","Hubbardston","2003","Hubbardston town, MA",140,2261,2401
"3396","Hubbardston","Worcester County","MA","Hubbardston","2004","Hubbardston town, MA",117,2282,2399
"3397","Hubbardston","Worcester County","MA","Hubbardston","2005","Hubbardston town, MA",119,2317,2436
"3398","Hubbardston","Worcester County","MA","Hubbardston","2006","Hubbardston town, MA",123,2362,2485
"3399","Hubbardston","Worcester County","MA","Hubbardston","2007","Hubbardston town, MA",123,2377,2500
"3400","Hubbardston","Worcester County","MA","Hubbardston","2008","Hubbardston town, MA",135,2327,2462
"3401","Hubbardston","Worcester County","MA","Hubbardston","2009","Hubbardston town, MA",221,2274,2495
"3402","Hubbardston","Worcester County","MA","Hubbardston","2010","Hubbardston town, MA",210,2234,2444
"3403","Hubbardston","Worcester County","MA","Hubbardston","2011","Hubbardston town, MA",183,2253,2436
"3404","Hubbardston","Worcester County","MA","Hubbardston","2012","Hubbardston town, MA",151,2253,2404
"3405","Hudson","Middlesex County","MA","Hudson","1990","Hudson town, MA",582,9677,10259
"3406","Hudson","Middlesex County","MA","Hudson","1991","Hudson town, MA",819,9381,10200
"3407","Hudson","Middlesex County","MA","Hudson","1992","Hudson town, MA",922,9310,10232
"3408","Hudson","Middlesex County","MA","Hudson","1993","Hudson town, MA",691,9441,10132
"3409","Hudson","Middlesex County","MA","Hudson","1994","Hudson town, MA",658,9590,10248
"3410","Hudson","Middlesex County","MA","Hudson","1995","Hudson town, MA",529,9801,10330
"3411","Hudson","Middlesex County","MA","Hudson","1996","Hudson town, MA",420,10001,10421
"3412","Hudson","Middlesex County","MA","Hudson","1997","Hudson town, MA",403,10245,10648
"3413","Hudson","Middlesex County","MA","Hudson","1998","Hudson town, MA",318,10430,10748
"3414","Hudson","Middlesex County","MA","Hudson","1999","Hudson town, MA",383,10565,10948
"3415","Hudson","Middlesex County","MA","Hudson","2000","Hudson town, MA",265,10420,10685
"3416","Hudson","Middlesex County","MA","Hudson","2001","Hudson town, MA",398,10444,10842
"3417","Hudson","Middlesex County","MA","Hudson","2002","Hudson town, MA",624,10226,10850
"3418","Hudson","Middlesex County","MA","Hudson","2003","Hudson town, MA",607,10060,10667
"3419","Hudson","Middlesex County","MA","Hudson","2004","Hudson town, MA",528,10358,10886
"3420","Hudson","Middlesex County","MA","Hudson","2005","Hudson town, MA",480,10643,11123
"3421","Hudson","Middlesex County","MA","Hudson","2006","Hudson town, MA",496,10989,11485
"3422","Hudson","Middlesex County","MA","Hudson","2007","Hudson town, MA",481,11200,11681
"3423","Hudson","Middlesex County","MA","Hudson","2008","Hudson town, MA",578,11312,11890
"3424","Hudson","Middlesex County","MA","Hudson","2009","Hudson town, MA",925,11010,11935
"3425","Hudson","Middlesex County","MA","Hudson","2010","Hudson town, MA",802,10386,11188
"3426","Hudson","Middlesex County","MA","Hudson","2011","Hudson town, MA",748,10490,11238
"3427","Hudson","Middlesex County","MA","Hudson","2012","Hudson town, MA",652,10585,11237
"3428","Hull","Plymouth County","MA","Hull","1990","Hull town, MA",407,5386,5793
"3429","Hull","Plymouth County","MA","Hull","1991","Hull town, MA",627,5216,5843
"3430","Hull","Plymouth County","MA","Hull","1992","Hull town, MA",599,5235,5834
"3431","Hull","Plymouth County","MA","Hull","1993","Hull town, MA",478,5350,5828
"3432","Hull","Plymouth County","MA","Hull","1994","Hull town, MA",437,5422,5859
"3433","Hull","Plymouth County","MA","Hull","1995","Hull town, MA",417,5323,5740
"3434","Hull","Plymouth County","MA","Hull","1996","Hull town, MA",314,5422,5736
"3435","Hull","Plymouth County","MA","Hull","1997","Hull town, MA",314,5556,5870
"3436","Hull","Plymouth County","MA","Hull","1998","Hull town, MA",248,5642,5890
"3437","Hull","Plymouth County","MA","Hull","1999","Hull town, MA",237,5703,5940
"3438","Hull","Plymouth County","MA","Hull","2000","Hull town, MA",197,6091,6288
"3439","Hull","Plymouth County","MA","Hull","2001","Hull town, MA",231,6134,6365
"3440","Hull","Plymouth County","MA","Hull","2002","Hull town, MA",349,6096,6445
"3441","Hull","Plymouth County","MA","Hull","2003","Hull town, MA",425,5997,6422
"3442","Hull","Plymouth County","MA","Hull","2004","Hull town, MA",361,5987,6348
"3443","Hull","Plymouth County","MA","Hull","2005","Hull town, MA",305,6029,6334
"3444","Hull","Plymouth County","MA","Hull","2006","Hull town, MA",300,5871,6171
"3445","Hull","Plymouth County","MA","Hull","2007","Hull town, MA",304,5876,6180
"3446","Hull","Plymouth County","MA","Hull","2008","Hull town, MA",364,5859,6223
"3447","Hull","Plymouth County","MA","Hull","2009","Hull town, MA",540,5673,6213
"3448","Hull","Plymouth County","MA","Hull","2010","Hull town, MA",524,5329,5853
"3449","Hull","Plymouth County","MA","Hull","2011","Hull town, MA",440,5381,5821
"3450","Hull","Plymouth County","MA","Hull","2012","Hull town, MA",407,5440,5847
"3451","Huntington","Hampshire County","MA","Huntington","1990","Huntington town, MA",82,972,1054
"3452","Huntington","Hampshire County","MA","Huntington","1991","Huntington town, MA",115,961,1076
"3453","Huntington","Hampshire County","MA","Huntington","1992","Huntington town, MA",120,975,1095
"3454","Huntington","Hampshire County","MA","Huntington","1993","Huntington town, MA",98,1005,1103
"3455","Huntington","Hampshire County","MA","Huntington","1994","Huntington town, MA",92,1011,1103
"3456","Huntington","Hampshire County","MA","Huntington","1995","Huntington town, MA",83,1007,1090
"3457","Huntington","Hampshire County","MA","Huntington","1996","Huntington town, MA",53,1025,1078
"3458","Huntington","Hampshire County","MA","Huntington","1997","Huntington town, MA",47,1047,1094
"3459","Huntington","Hampshire County","MA","Huntington","1998","Huntington town, MA",41,1057,1098
"3460","Huntington","Hampshire County","MA","Huntington","1999","Huntington town, MA",45,1065,1110
"3461","Huntington","Hampshire County","MA","Huntington","2000","Huntington town, MA",37,1215,1252
"3462","Huntington","Hampshire County","MA","Huntington","2001","Huntington town, MA",42,1216,1258
"3463","Huntington","Hampshire County","MA","Huntington","2002","Huntington town, MA",69,1209,1278
"3464","Huntington","Hampshire County","MA","Huntington","2003","Huntington town, MA",72,1206,1278
"3465","Huntington","Hampshire County","MA","Huntington","2004","Huntington town, MA",60,1202,1262
"3466","Huntington","Hampshire County","MA","Huntington","2005","Huntington town, MA",69,1199,1268
"3467","Huntington","Hampshire County","MA","Huntington","2006","Huntington town, MA",53,1218,1271
"3468","Huntington","Hampshire County","MA","Huntington","2007","Huntington town, MA",59,1217,1276
"3469","Huntington","Hampshire County","MA","Huntington","2008","Huntington town, MA",68,1220,1288
"3470","Huntington","Hampshire County","MA","Huntington","2009","Huntington town, MA",118,1166,1284
"3471","Huntington","Hampshire County","MA","Huntington","2010","Huntington town, MA",115,1147,1262
"3472","Huntington","Hampshire County","MA","Huntington","2011","Huntington town, MA",104,1134,1238
"3473","Huntington","Hampshire County","MA","Huntington","2012","Huntington town, MA",104,1135,1239
"3474","Ipswich","Essex County","MA","Ipswich","1990","Ipswich town, MA",328,6285,6613
"3475","Ipswich","Essex County","MA","Ipswich","1991","Ipswich town, MA",426,6116,6542
"3476","Ipswich","Essex County","MA","Ipswich","1992","Ipswich town, MA",421,6111,6532
"3477","Ipswich","Essex County","MA","Ipswich","1993","Ipswich town, MA",352,6268,6620
"3478","Ipswich","Essex County","MA","Ipswich","1994","Ipswich town, MA",301,6433,6734
"3479","Ipswich","Essex County","MA","Ipswich","1995","Ipswich town, MA",264,6391,6655
"3480","Ipswich","Essex County","MA","Ipswich","1996","Ipswich town, MA",255,6564,6819
"3481","Ipswich","Essex County","MA","Ipswich","1997","Ipswich town, MA",224,6780,7004
"3482","Ipswich","Essex County","MA","Ipswich","1998","Ipswich town, MA",205,6953,7158
"3483","Ipswich","Essex County","MA","Ipswich","1999","Ipswich town, MA",189,7071,7260
"3484","Ipswich","Essex County","MA","Ipswich","2000","Ipswich town, MA",163,7144,7307
"3485","Ipswich","Essex County","MA","Ipswich","2001","Ipswich town, MA",225,7206,7431
"3486","Ipswich","Essex County","MA","Ipswich","2002","Ipswich town, MA",310,7129,7439
"3487","Ipswich","Essex County","MA","Ipswich","2003","Ipswich town, MA",386,7057,7443
"3488","Ipswich","Essex County","MA","Ipswich","2004","Ipswich town, MA",319,7055,7374
"3489","Ipswich","Essex County","MA","Ipswich","2005","Ipswich town, MA",306,7096,7402
"3490","Ipswich","Essex County","MA","Ipswich","2006","Ipswich town, MA",282,7001,7283
"3491","Ipswich","Essex County","MA","Ipswich","2007","Ipswich town, MA",274,7041,7315
"3492","Ipswich","Essex County","MA","Ipswich","2008","Ipswich town, MA",310,7039,7349
"3493","Ipswich","Essex County","MA","Ipswich","2009","Ipswich town, MA",503,6827,7330
"3494","Ipswich","Essex County","MA","Ipswich","2010","Ipswich town, MA",491,6808,7299
"3495","Ipswich","Essex County","MA","Ipswich","2011","Ipswich town, MA",450,6891,7341
"3496","Ipswich","Essex County","MA","Ipswich","2012","Ipswich town, MA",411,6967,7378
"3497","Kingston","Plymouth County","MA","Kingston","1990","Kingston town, MA",326,4718,5044
"3498","Kingston","Plymouth County","MA","Kingston","1991","Kingston town, MA",397,4610,5007
"3499","Kingston","Plymouth County","MA","Kingston","1992","Kingston town, MA",477,4794,5271
"3500","Kingston","Plymouth County","MA","Kingston","1993","Kingston town, MA",412,5015,5427
"3501","Kingston","Plymouth County","MA","Kingston","1994","Kingston town, MA",324,5208,5532
"3502","Kingston","Plymouth County","MA","Kingston","1995","Kingston town, MA",291,5276,5567
"3503","Kingston","Plymouth County","MA","Kingston","1996","Kingston town, MA",282,5443,5725
"3504","Kingston","Plymouth County","MA","Kingston","1997","Kingston town, MA",222,5698,5920
"3505","Kingston","Plymouth County","MA","Kingston","1998","Kingston town, MA",174,5910,6084
"3506","Kingston","Plymouth County","MA","Kingston","1999","Kingston town, MA",171,6100,6271
"3507","Kingston","Plymouth County","MA","Kingston","2000","Kingston town, MA",155,5965,6120
"3508","Kingston","Plymouth County","MA","Kingston","2001","Kingston town, MA",190,6018,6208
"3509","Kingston","Plymouth County","MA","Kingston","2002","Kingston town, MA",253,5988,6241
"3510","Kingston","Plymouth County","MA","Kingston","2003","Kingston town, MA",316,5940,6256
"3511","Kingston","Plymouth County","MA","Kingston","2004","Kingston town, MA",307,5997,6304
"3512","Kingston","Plymouth County","MA","Kingston","2005","Kingston town, MA",277,6116,6393
"3513","Kingston","Plymouth County","MA","Kingston","2006","Kingston town, MA",290,6003,6293
"3514","Kingston","Plymouth County","MA","Kingston","2007","Kingston town, MA",285,6025,6310
"3515","Kingston","Plymouth County","MA","Kingston","2008","Kingston town, MA",336,6016,6352
"3516","Kingston","Plymouth County","MA","Kingston","2009","Kingston town, MA",548,5848,6396
"3517","Kingston","Plymouth County","MA","Kingston","2010","Kingston town, MA",524,6005,6529
"3518","Kingston","Plymouth County","MA","Kingston","2011","Kingston town, MA",458,6063,6521
"3519","Kingston","Plymouth County","MA","Kingston","2012","Kingston town, MA",383,6130,6513
"3520","Lakeville","Plymouth County","MA","Lakeville","1990","Lakeville town, MA",204,3844,4048
"3521","Lakeville","Plymouth County","MA","Lakeville","1991","Lakeville town, MA",356,3780,4136
"3522","Lakeville","Plymouth County","MA","Lakeville","1992","Lakeville town, MA",432,3821,4253
"3523","Lakeville","Plymouth County","MA","Lakeville","1993","Lakeville town, MA",315,4079,4394
"3524","Lakeville","Plymouth County","MA","Lakeville","1994","Lakeville town, MA",291,4385,4676
"3525","Lakeville","Plymouth County","MA","Lakeville","1995","Lakeville town, MA",279,4236,4515
"3526","Lakeville","Plymouth County","MA","Lakeville","1996","Lakeville town, MA",225,4311,4536
"3527","Lakeville","Plymouth County","MA","Lakeville","1997","Lakeville town, MA",209,4485,4694
"3528","Lakeville","Plymouth County","MA","Lakeville","1998","Lakeville town, MA",168,4590,4758
"3529","Lakeville","Plymouth County","MA","Lakeville","1999","Lakeville town, MA",173,4732,4905
"3530","Lakeville","Plymouth County","MA","Lakeville","2000","Lakeville town, MA",132,5358,5490
"3531","Lakeville","Plymouth County","MA","Lakeville","2001","Lakeville town, MA",176,5465,5641
"3532","Lakeville","Plymouth County","MA","Lakeville","2002","Lakeville town, MA",246,5529,5775
"3533","Lakeville","Plymouth County","MA","Lakeville","2003","Lakeville town, MA",295,5560,5855
"3534","Lakeville","Plymouth County","MA","Lakeville","2004","Lakeville town, MA",303,5549,5852
"3535","Lakeville","Plymouth County","MA","Lakeville","2005","Lakeville town, MA",268,5704,5972
"3536","Lakeville","Plymouth County","MA","Lakeville","2006","Lakeville town, MA",264,5775,6039
"3537","Lakeville","Plymouth County","MA","Lakeville","2007","Lakeville town, MA",257,5796,6053
"3538","Lakeville","Plymouth County","MA","Lakeville","2008","Lakeville town, MA",324,5749,6073
"3539","Lakeville","Plymouth County","MA","Lakeville","2009","Lakeville town, MA",509,5590,6099
"3540","Lakeville","Plymouth County","MA","Lakeville","2010","Lakeville town, MA",516,5553,6069
"3541","Lakeville","Plymouth County","MA","Lakeville","2011","Lakeville town, MA",441,5634,6075
"3542","Lakeville","Plymouth County","MA","Lakeville","2012","Lakeville town, MA",391,5617,6008
"3543","Lancaster","Worcester County","MA","Lancaster","1990","Lancaster town, MA",168,3357,3525
"3544","Lancaster","Worcester County","MA","Lancaster","1991","Lancaster town, MA",224,3240,3464
"3545","Lancaster","Worcester County","MA","Lancaster","1992","Lancaster town, MA",219,3195,3414
"3546","Lancaster","Worcester County","MA","Lancaster","1993","Lancaster town, MA",175,3233,3408
"3547","Lancaster","Worcester County","MA","Lancaster","1994","Lancaster town, MA",178,3243,3421
"3548","Lancaster","Worcester County","MA","Lancaster","1995","Lancaster town, MA",167,3260,3427
"3549","Lancaster","Worcester County","MA","Lancaster","1996","Lancaster town, MA",124,3338,3462
"3550","Lancaster","Worcester County","MA","Lancaster","1997","Lancaster town, MA",115,3458,3573
"3551","Lancaster","Worcester County","MA","Lancaster","1998","Lancaster town, MA",85,3465,3550
"3552","Lancaster","Worcester County","MA","Lancaster","1999","Lancaster town, MA",93,3531,3624
"3553","Lancaster","Worcester County","MA","Lancaster","2000","Lancaster town, MA",81,2807,2888
"3554","Lancaster","Worcester County","MA","Lancaster","2001","Lancaster town, MA",126,2787,2913
"3555","Lancaster","Worcester County","MA","Lancaster","2002","Lancaster town, MA",183,2797,2980
"3556","Lancaster","Worcester County","MA","Lancaster","2003","Lancaster town, MA",209,2808,3017
"3557","Lancaster","Worcester County","MA","Lancaster","2004","Lancaster town, MA",200,2850,3050
"3558","Lancaster","Worcester County","MA","Lancaster","2005","Lancaster town, MA",166,2887,3053
"3559","Lancaster","Worcester County","MA","Lancaster","2006","Lancaster town, MA",172,2978,3150
"3560","Lancaster","Worcester County","MA","Lancaster","2007","Lancaster town, MA",158,3008,3166
"3561","Lancaster","Worcester County","MA","Lancaster","2008","Lancaster town, MA",174,2908,3082
"3562","Lancaster","Worcester County","MA","Lancaster","2009","Lancaster town, MA",284,2830,3114
"3563","Lancaster","Worcester County","MA","Lancaster","2010","Lancaster town, MA",311,3252,3563
"3564","Lancaster","Worcester County","MA","Lancaster","2011","Lancaster town, MA",258,3279,3537
"3565","Lancaster","Worcester County","MA","Lancaster","2012","Lancaster town, MA",241,3277,3518
"3566","Lanesborough","Berkshire County","MA","Lanesborough","1990","Lanesborough town, MA",103,1591,1694
"3567","Lanesborough","Berkshire County","MA","Lanesborough","1991","Lanesborough town, MA",176,1522,1698
"3568","Lanesborough","Berkshire County","MA","Lanesborough","1992","Lanesborough town, MA",140,1480,1620
"3569","Lanesborough","Berkshire County","MA","Lanesborough","1993","Lanesborough town, MA",120,1502,1622
"3570","Lanesborough","Berkshire County","MA","Lanesborough","1994","Lanesborough town, MA",123,1472,1595
"3571","Lanesborough","Berkshire County","MA","Lanesborough","1995","Lanesborough town, MA",91,1509,1600
"3572","Lanesborough","Berkshire County","MA","Lanesborough","1996","Lanesborough town, MA",80,1537,1617
"3573","Lanesborough","Berkshire County","MA","Lanesborough","1997","Lanesborough town, MA",76,1556,1632
"3574","Lanesborough","Berkshire County","MA","Lanesborough","1998","Lanesborough town, MA",65,1560,1625
"3575","Lanesborough","Berkshire County","MA","Lanesborough","1999","Lanesborough town, MA",57,1567,1624
"3576","Lanesborough","Berkshire County","MA","Lanesborough","2000","Lanesborough town, MA",41,1695,1736
"3577","Lanesborough","Berkshire County","MA","Lanesborough","2001","Lanesborough town, MA",45,1694,1739
"3578","Lanesborough","Berkshire County","MA","Lanesborough","2002","Lanesborough town, MA",72,1720,1792
"3579","Lanesborough","Berkshire County","MA","Lanesborough","2003","Lanesborough town, MA",79,1711,1790
"3580","Lanesborough","Berkshire County","MA","Lanesborough","2004","Lanesborough town, MA",75,1714,1789
"3581","Lanesborough","Berkshire County","MA","Lanesborough","2005","Lanesborough town, MA",67,1737,1804
"3582","Lanesborough","Berkshire County","MA","Lanesborough","2006","Lanesborough town, MA",68,1757,1825
"3583","Lanesborough","Berkshire County","MA","Lanesborough","2007","Lanesborough town, MA",74,1743,1817
"3584","Lanesborough","Berkshire County","MA","Lanesborough","2008","Lanesborough town, MA",93,1716,1809
"3585","Lanesborough","Berkshire County","MA","Lanesborough","2009","Lanesborough town, MA",136,1661,1797
"3586","Lanesborough","Berkshire County","MA","Lanesborough","2010","Lanesborough town, MA",155,1735,1890
"3587","Lanesborough","Berkshire County","MA","Lanesborough","2011","Lanesborough town, MA",127,1751,1878
"3588","Lanesborough","Berkshire County","MA","Lanesborough","2012","Lanesborough town, MA",121,1743,1864
"3589","Lawrence","Essex County","MA","Lawrence","1990","Lawrence city, MA",3333,24601,27934
"3590","Lawrence","Essex County","MA","Lawrence","1991","Lawrence city, MA",4184,23502,27686
"3591","Lawrence","Essex County","MA","Lawrence","1992","Lawrence city, MA",3982,22833,26815
"3592","Lawrence","Essex County","MA","Lawrence","1993","Lawrence city, MA",3704,22566,26270
"3593","Lawrence","Essex County","MA","Lawrence","1994","Lawrence city, MA",3304,22354,25658
"3594","Lawrence","Essex County","MA","Lawrence","1995","Lawrence city, MA",2869,24854,27723
"3595","Lawrence","Essex County","MA","Lawrence","1996","Lawrence city, MA",2774,25347,28121
"3596","Lawrence","Essex County","MA","Lawrence","1997","Lawrence city, MA",2534,25554,28088
"3597","Lawrence","Essex County","MA","Lawrence","1998","Lawrence city, MA",2475,25850,28325
"3598","Lawrence","Essex County","MA","Lawrence","1999","Lawrence city, MA",2406,26495,28901
"3599","Lawrence","Essex County","MA","Lawrence","2000","Lawrence city, MA",1578,26831,28409
"3600","Lawrence","Essex County","MA","Lawrence","2001","Lawrence city, MA",2567,26733,29300
"3601","Lawrence","Essex County","MA","Lawrence","2002","Lawrence city, MA",3683,26276,29959
"3602","Lawrence","Essex County","MA","Lawrence","2003","Lawrence city, MA",3663,26156,29819
"3603","Lawrence","Essex County","MA","Lawrence","2004","Lawrence city, MA",3269,26086,29355
"3604","Lawrence","Essex County","MA","Lawrence","2005","Lawrence city, MA",2921,26122,29043
"3605","Lawrence","Essex County","MA","Lawrence","2006","Lawrence city, MA",2803,26225,29028
"3606","Lawrence","Essex County","MA","Lawrence","2007","Lawrence city, MA",2616,26325,28941
"3607","Lawrence","Essex County","MA","Lawrence","2008","Lawrence city, MA",3156,26182,29338
"3608","Lawrence","Essex County","MA","Lawrence","2009","Lawrence city, MA",4801,25482,30283
"3609","Lawrence","Essex County","MA","Lawrence","2010","Lawrence city, MA",5087,26657,31744
"3610","Lawrence","Essex County","MA","Lawrence","2011","Lawrence city, MA",5074,27182,32256
"3611","Lawrence","Essex County","MA","Lawrence","2012","Lawrence city, MA",4646,27555,32201
"3612","Lee","Berkshire County","MA","Lee","1990","Lee town, MA",189,2948,3137
"3613","Lee","Berkshire County","MA","Lee","1991","Lee town, MA",306,2780,3086
"3614","Lee","Berkshire County","MA","Lee","1992","Lee town, MA",349,2718,3067
"3615","Lee","Berkshire County","MA","Lee","1993","Lee town, MA",274,2776,3050
"3616","Lee","Berkshire County","MA","Lee","1994","Lee town, MA",234,2755,2989
"3617","Lee","Berkshire County","MA","Lee","1995","Lee town, MA",207,2753,2960
"3618","Lee","Berkshire County","MA","Lee","1996","Lee town, MA",153,2794,2947
"3619","Lee","Berkshire County","MA","Lee","1997","Lee town, MA",151,2811,2962
"3620","Lee","Berkshire County","MA","Lee","1998","Lee town, MA",121,2798,2919
"3621","Lee","Berkshire County","MA","Lee","1999","Lee town, MA",110,2805,2915
"3622","Lee","Berkshire County","MA","Lee","2000","Lee town, MA",89,3411,3500
"3623","Lee","Berkshire County","MA","Lee","2001","Lee town, MA",108,3516,3624
"3624","Lee","Berkshire County","MA","Lee","2002","Lee town, MA",149,3600,3749
"3625","Lee","Berkshire County","MA","Lee","2003","Lee town, MA",175,3603,3778
"3626","Lee","Berkshire County","MA","Lee","2004","Lee town, MA",157,3574,3731
"3627","Lee","Berkshire County","MA","Lee","2005","Lee town, MA",131,3640,3771
"3628","Lee","Berkshire County","MA","Lee","2006","Lee town, MA",154,3653,3807
"3629","Lee","Berkshire County","MA","Lee","2007","Lee town, MA",148,3570,3718
"3630","Lee","Berkshire County","MA","Lee","2008","Lee town, MA",192,3554,3746
"3631","Lee","Berkshire County","MA","Lee","2009","Lee town, MA",254,3440,3694
"3632","Lee","Berkshire County","MA","Lee","2010","Lee town, MA",272,3593,3865
"3633","Lee","Berkshire County","MA","Lee","2011","Lee town, MA",207,3612,3819
"3634","Lee","Berkshire County","MA","Lee","2012","Lee town, MA",200,3583,3783
"3635","Leicester","Worcester County","MA","Leicester","1990","Leicester town, MA",353,5297,5650
"3636","Leicester","Worcester County","MA","Leicester","1991","Leicester town, MA",570,5042,5612
"3637","Leicester","Worcester County","MA","Leicester","1992","Leicester town, MA",536,5048,5584
"3638","Leicester","Worcester County","MA","Leicester","1993","Leicester town, MA",415,5125,5540
"3639","Leicester","Worcester County","MA","Leicester","1994","Leicester town, MA",310,5239,5549
"3640","Leicester","Worcester County","MA","Leicester","1995","Leicester town, MA",317,5326,5643
"3641","Leicester","Worcester County","MA","Leicester","1996","Leicester town, MA",268,5413,5681
"3642","Leicester","Worcester County","MA","Leicester","1997","Leicester town, MA",211,5553,5764
"3643","Leicester","Worcester County","MA","Leicester","1998","Leicester town, MA",190,5702,5892
"3644","Leicester","Worcester County","MA","Leicester","1999","Leicester town, MA",217,5701,5918
"3645","Leicester","Worcester County","MA","Leicester","2000","Leicester town, MA",157,5722,5879
"3646","Leicester","Worcester County","MA","Leicester","2001","Leicester town, MA",201,5740,5941
"3647","Leicester","Worcester County","MA","Leicester","2002","Leicester town, MA",321,5733,6054
"3648","Leicester","Worcester County","MA","Leicester","2003","Leicester town, MA",369,5722,6091
"3649","Leicester","Worcester County","MA","Leicester","2004","Leicester town, MA",328,5741,6069
"3650","Leicester","Worcester County","MA","Leicester","2005","Leicester town, MA",326,5756,6082
"3651","Leicester","Worcester County","MA","Leicester","2006","Leicester town, MA",286,5822,6108
"3652","Leicester","Worcester County","MA","Leicester","2007","Leicester town, MA",308,5853,6161
"3653","Leicester","Worcester County","MA","Leicester","2008","Leicester town, MA",351,5715,6066
"3654","Leicester","Worcester County","MA","Leicester","2009","Leicester town, MA",542,5577,6119
"3655","Leicester","Worcester County","MA","Leicester","2010","Leicester town, MA",512,5511,6023
"3656","Leicester","Worcester County","MA","Leicester","2011","Leicester town, MA",451,5560,6011
"3657","Leicester","Worcester County","MA","Leicester","2012","Leicester town, MA",426,5558,5984
"3658","Lenox","Berkshire County","MA","Lenox","1990","Lenox town, MA",150,2292,2442
"3659","Lenox","Berkshire County","MA","Lenox","1991","Lenox town, MA",216,2230,2446
"3660","Lenox","Berkshire County","MA","Lenox","1992","Lenox town, MA",218,2205,2423
"3661","Lenox","Berkshire County","MA","Lenox","1993","Lenox town, MA",169,2202,2371
"3662","Lenox","Berkshire County","MA","Lenox","1994","Lenox town, MA",153,2185,2338
"3663","Lenox","Berkshire County","MA","Lenox","1995","Lenox town, MA",173,2152,2325
"3664","Lenox","Berkshire County","MA","Lenox","1996","Lenox town, MA",118,2183,2301
"3665","Lenox","Berkshire County","MA","Lenox","1997","Lenox town, MA",99,2261,2360
"3666","Lenox","Berkshire County","MA","Lenox","1998","Lenox town, MA",89,2260,2349
"3667","Lenox","Berkshire County","MA","Lenox","1999","Lenox town, MA",83,2273,2356
"3668","Lenox","Berkshire County","MA","Lenox","2000","Lenox town, MA",72,2479,2551
"3669","Lenox","Berkshire County","MA","Lenox","2001","Lenox town, MA",76,2520,2596
"3670","Lenox","Berkshire County","MA","Lenox","2002","Lenox town, MA",100,2566,2666
"3671","Lenox","Berkshire County","MA","Lenox","2003","Lenox town, MA",111,2564,2675
"3672","Lenox","Berkshire County","MA","Lenox","2004","Lenox town, MA",116,2565,2681
"3673","Lenox","Berkshire County","MA","Lenox","2005","Lenox town, MA",112,2606,2718
"3674","Lenox","Berkshire County","MA","Lenox","2006","Lenox town, MA",109,2665,2774
"3675","Lenox","Berkshire County","MA","Lenox","2007","Lenox town, MA",100,2645,2745
"3676","Lenox","Berkshire County","MA","Lenox","2008","Lenox town, MA",115,2621,2736
"3677","Lenox","Berkshire County","MA","Lenox","2009","Lenox town, MA",183,2542,2725
"3678","Lenox","Berkshire County","MA","Lenox","2010","Lenox town, MA",181,2424,2605
"3679","Lenox","Berkshire County","MA","Lenox","2011","Lenox town, MA",149,2446,2595
"3680","Lenox","Berkshire County","MA","Lenox","2012","Lenox town, MA",136,2435,2571
"3681","Leominster","Worcester County","MA","Leominster","1990","Leominster city, MA",1581,19340,20921
"3682","Leominster","Worcester County","MA","Leominster","1991","Leominster city, MA",2082,18623,20705
"3683","Leominster","Worcester County","MA","Leominster","1992","Leominster city, MA",1869,19083,20952
"3684","Leominster","Worcester County","MA","Leominster","1993","Leominster city, MA",1633,19365,20998
"3685","Leominster","Worcester County","MA","Leominster","1994","Leominster city, MA",1440,19414,20854
"3686","Leominster","Worcester County","MA","Leominster","1995","Leominster city, MA",1368,19727,21095
"3687","Leominster","Worcester County","MA","Leominster","1996","Leominster city, MA",1164,19807,20971
"3688","Leominster","Worcester County","MA","Leominster","1997","Leominster city, MA",1007,20418,21425
"3689","Leominster","Worcester County","MA","Leominster","1998","Leominster city, MA",836,20388,21224
"3690","Leominster","Worcester County","MA","Leominster","1999","Leominster city, MA",868,20410,21278
"3691","Leominster","Worcester County","MA","Leominster","2000","Leominster city, MA",651,20630,21281
"3692","Leominster","Worcester County","MA","Leominster","2001","Leominster city, MA",956,20379,21335
"3693","Leominster","Worcester County","MA","Leominster","2002","Leominster city, MA",1395,20183,21578
"3694","Leominster","Worcester County","MA","Leominster","2003","Leominster city, MA",1473,19963,21436
"3695","Leominster","Worcester County","MA","Leominster","2004","Leominster city, MA",1359,19811,21170
"3696","Leominster","Worcester County","MA","Leominster","2005","Leominster city, MA",1231,19543,20774
"3697","Leominster","Worcester County","MA","Leominster","2006","Leominster city, MA",1193,19592,20785
"3698","Leominster","Worcester County","MA","Leominster","2007","Leominster city, MA",1134,19475,20609
"3699","Leominster","Worcester County","MA","Leominster","2008","Leominster city, MA",1329,19179,20508
"3700","Leominster","Worcester County","MA","Leominster","2009","Leominster city, MA",2107,18631,20738
"3701","Leominster","Worcester County","MA","Leominster","2010","Leominster city, MA",2193,18362,20555
"3702","Leominster","Worcester County","MA","Leominster","2011","Leominster city, MA",1960,18352,20312
"3703","Leominster","Worcester County","MA","Leominster","2012","Leominster city, MA",1769,18339,20108
"3704","Leverett","Franklin County","MA","Leverett","1990","Leverett town, MA",24,1035,1059
"3705","Leverett","Franklin County","MA","Leverett","1991","Leverett town, MA",48,1015,1063
"3706","Leverett","Franklin County","MA","Leverett","1992","Leverett town, MA",45,991,1036
"3707","Leverett","Franklin County","MA","Leverett","1993","Leverett town, MA",43,1003,1046
"3708","Leverett","Franklin County","MA","Leverett","1994","Leverett town, MA",29,1048,1077
"3709","Leverett","Franklin County","MA","Leverett","1995","Leverett town, MA",23,1072,1095
"3710","Leverett","Franklin County","MA","Leverett","1996","Leverett town, MA",21,1078,1099
"3711","Leverett","Franklin County","MA","Leverett","1997","Leverett town, MA",25,1106,1131
"3712","Leverett","Franklin County","MA","Leverett","1998","Leverett town, MA",21,1134,1155
"3713","Leverett","Franklin County","MA","Leverett","1999","Leverett town, MA",16,1160,1176
"3714","Leverett","Franklin County","MA","Leverett","2000","Leverett town, MA",18,936,954
"3715","Leverett","Franklin County","MA","Leverett","2001","Leverett town, MA",18,964,982
"3716","Leverett","Franklin County","MA","Leverett","2002","Leverett town, MA",22,968,990
"3717","Leverett","Franklin County","MA","Leverett","2003","Leverett town, MA",31,988,1019
"3718","Leverett","Franklin County","MA","Leverett","2004","Leverett town, MA",33,1004,1037
"3719","Leverett","Franklin County","MA","Leverett","2005","Leverett town, MA",36,1010,1046
"3720","Leverett","Franklin County","MA","Leverett","2006","Leverett town, MA",37,1025,1062
"3721","Leverett","Franklin County","MA","Leverett","2007","Leverett town, MA",31,1012,1043
"3722","Leverett","Franklin County","MA","Leverett","2008","Leverett town, MA",36,991,1027
"3723","Leverett","Franklin County","MA","Leverett","2009","Leverett town, MA",53,968,1021
"3724","Leverett","Franklin County","MA","Leverett","2010","Leverett town, MA",54,979,1033
"3725","Leverett","Franklin County","MA","Leverett","2011","Leverett town, MA",53,989,1042
"3726","Leverett","Franklin County","MA","Leverett","2012","Leverett town, MA",45,998,1043
"3727","Lexington","Middlesex County","MA","Lexington","1990","Lexington town, MA",505,15201,15706
"3728","Lexington","Middlesex County","MA","Lexington","1991","Lexington town, MA",745,14711,15456
"3729","Lexington","Middlesex County","MA","Lexington","1992","Lexington town, MA",728,14579,15307
"3730","Lexington","Middlesex County","MA","Lexington","1993","Lexington town, MA",607,14718,15325
"3731","Lexington","Middlesex County","MA","Lexington","1994","Lexington town, MA",541,14935,15476
"3732","Lexington","Middlesex County","MA","Lexington","1995","Lexington town, MA",435,15217,15652
"3733","Lexington","Middlesex County","MA","Lexington","1996","Lexington town, MA",350,15526,15876
"3734","Lexington","Middlesex County","MA","Lexington","1997","Lexington town, MA",323,15914,16237
"3735","Lexington","Middlesex County","MA","Lexington","1998","Lexington town, MA",263,16132,16395
"3736","Lexington","Middlesex County","MA","Lexington","1999","Lexington town, MA",287,16248,16535
"3737","Lexington","Middlesex County","MA","Lexington","2000","Lexington town, MA",280,15129,15409
"3738","Lexington","Middlesex County","MA","Lexington","2001","Lexington town, MA",451,15117,15568
"3739","Lexington","Middlesex County","MA","Lexington","2002","Lexington town, MA",651,14856,15507
"3740","Lexington","Middlesex County","MA","Lexington","2003","Lexington town, MA",684,14629,15313
"3741","Lexington","Middlesex County","MA","Lexington","2004","Lexington town, MA",569,14581,15150
"3742","Lexington","Middlesex County","MA","Lexington","2005","Lexington town, MA",508,14660,15168
"3743","Lexington","Middlesex County","MA","Lexington","2006","Lexington town, MA",495,14483,14978
"3744","Lexington","Middlesex County","MA","Lexington","2007","Lexington town, MA",462,14612,15074
"3745","Lexington","Middlesex County","MA","Lexington","2008","Lexington town, MA",556,14631,15187
"3746","Lexington","Middlesex County","MA","Lexington","2009","Lexington town, MA",882,14294,15176
"3747","Lexington","Middlesex County","MA","Lexington","2010","Lexington town, MA",884,14729,15613
"3748","Lexington","Middlesex County","MA","Lexington","2011","Lexington town, MA",738,14945,15683
"3749","Lexington","Middlesex County","MA","Lexington","2012","Lexington town, MA",680,15108,15788
"3750","Leyden","Franklin County","MA","Leyden","1990","Leyden town, MA",27,355,382
"3751","Leyden","Franklin County","MA","Leyden","1991","Leyden town, MA",45,361,406
"3752","Leyden","Franklin County","MA","Leyden","1992","Leyden town, MA",22,350,372
"3753","Leyden","Franklin County","MA","Leyden","1993","Leyden town, MA",31,372,403
"3754","Leyden","Franklin County","MA","Leyden","1994","Leyden town, MA",18,390,408
"3755","Leyden","Franklin County","MA","Leyden","1995","Leyden town, MA",15,371,386
"3756","Leyden","Franklin County","MA","Leyden","1996","Leyden town, MA",20,379,399
"3757","Leyden","Franklin County","MA","Leyden","1997","Leyden town, MA",14,394,408
"3758","Leyden","Franklin County","MA","Leyden","1998","Leyden town, MA",15,402,417
"3759","Leyden","Franklin County","MA","Leyden","1999","Leyden town, MA",10,411,421
"3760","Leyden","Franklin County","MA","Leyden","2000","Leyden town, MA",12,459,471
"3761","Leyden","Franklin County","MA","Leyden","2001","Leyden town, MA",14,461,475
"3762","Leyden","Franklin County","MA","Leyden","2002","Leyden town, MA",16,474,490
"3763","Leyden","Franklin County","MA","Leyden","2003","Leyden town, MA",20,477,497
"3764","Leyden","Franklin County","MA","Leyden","2004","Leyden town, MA",21,474,495
"3765","Leyden","Franklin County","MA","Leyden","2005","Leyden town, MA",15,478,493
"3766","Leyden","Franklin County","MA","Leyden","2006","Leyden town, MA",22,478,500
"3767","Leyden","Franklin County","MA","Leyden","2007","Leyden town, MA",20,470,490
"3768","Leyden","Franklin County","MA","Leyden","2008","Leyden town, MA",25,461,486
"3769","Leyden","Franklin County","MA","Leyden","2009","Leyden town, MA",29,453,482
"3770","Leyden","Franklin County","MA","Leyden","2010","Leyden town, MA",25,405,430
"3771","Leyden","Franklin County","MA","Leyden","2011","Leyden town, MA",16,406,422
"3772","Leyden","Franklin County","MA","Leyden","2012","Leyden town, MA",17,407,424
"3773","Lincoln","Middlesex County","MA","Lincoln","1990","Lincoln town, MA",67,3248,3315
"3774","Lincoln","Middlesex County","MA","Lincoln","1991","Lincoln town, MA",106,3130,3236
"3775","Lincoln","Middlesex County","MA","Lincoln","1992","Lincoln town, MA",101,3163,3264
"3776","Lincoln","Middlesex County","MA","Lincoln","1993","Lincoln town, MA",90,3275,3365
"3777","Lincoln","Middlesex County","MA","Lincoln","1994","Lincoln town, MA",79,3400,3479
"3778","Lincoln","Middlesex County","MA","Lincoln","1995","Lincoln town, MA",68,3264,3332
"3779","Lincoln","Middlesex County","MA","Lincoln","1996","Lincoln town, MA",51,3341,3392
"3780","Lincoln","Middlesex County","MA","Lincoln","1997","Lincoln town, MA",39,3425,3464
"3781","Lincoln","Middlesex County","MA","Lincoln","1998","Lincoln town, MA",42,3480,3522
"3782","Lincoln","Middlesex County","MA","Lincoln","1999","Lincoln town, MA",45,3508,3553
"3783","Lincoln","Middlesex County","MA","Lincoln","2000","Lincoln town, MA",55,3343,3398
"3784","Lincoln","Middlesex County","MA","Lincoln","2001","Lincoln town, MA",82,3339,3421
"3785","Lincoln","Middlesex County","MA","Lincoln","2002","Lincoln town, MA",114,3275,3389
"3786","Lincoln","Middlesex County","MA","Lincoln","2003","Lincoln town, MA",121,3210,3331
"3787","Lincoln","Middlesex County","MA","Lincoln","2004","Lincoln town, MA",109,3193,3302
"3788","Lincoln","Middlesex County","MA","Lincoln","2005","Lincoln town, MA",100,3199,3299
"3789","Lincoln","Middlesex County","MA","Lincoln","2006","Lincoln town, MA",95,3168,3263
"3790","Lincoln","Middlesex County","MA","Lincoln","2007","Lincoln town, MA",95,3379,3474
"3791","Lincoln","Middlesex County","MA","Lincoln","2008","Lincoln town, MA",107,3419,3526
"3792","Lincoln","Middlesex County","MA","Lincoln","2009","Lincoln town, MA",177,3331,3508
"3793","Lincoln","Middlesex County","MA","Lincoln","2010","Lincoln town, MA",147,2486,2633
"3794","Lincoln","Middlesex County","MA","Lincoln","2011","Lincoln town, MA",134,2523,2657
"3795","Lincoln","Middlesex County","MA","Lincoln","2012","Lincoln town, MA",130,2551,2681
"3796","Littleton","Middlesex County","MA","Littleton","1990","Littleton town, MA",178,3827,4005
"3797","Littleton","Middlesex County","MA","Littleton","1991","Littleton town, MA",255,3732,3987
"3798","Littleton","Middlesex County","MA","Littleton","1992","Littleton town, MA",260,3738,3998
"3799","Littleton","Middlesex County","MA","Littleton","1993","Littleton town, MA",242,3849,4091
"3800","Littleton","Middlesex County","MA","Littleton","1994","Littleton town, MA",213,3995,4208
"3801","Littleton","Middlesex County","MA","Littleton","1995","Littleton town, MA",174,4082,4256
"3802","Littleton","Middlesex County","MA","Littleton","1996","Littleton town, MA",129,4190,4319
"3803","Littleton","Middlesex County","MA","Littleton","1997","Littleton town, MA",122,4342,4464
"3804","Littleton","Middlesex County","MA","Littleton","1998","Littleton town, MA",94,4547,4641
"3805","Littleton","Middlesex County","MA","Littleton","1999","Littleton town, MA",104,4640,4744
"3806","Littleton","Middlesex County","MA","Littleton","2000","Littleton town, MA",90,4459,4549
"3807","Littleton","Middlesex County","MA","Littleton","2001","Littleton town, MA",159,4529,4688
"3808","Littleton","Middlesex County","MA","Littleton","2002","Littleton town, MA",249,4494,4743
"3809","Littleton","Middlesex County","MA","Littleton","2003","Littleton town, MA",244,4471,4715
"3810","Littleton","Middlesex County","MA","Littleton","2004","Littleton town, MA",195,4477,4672
"3811","Littleton","Middlesex County","MA","Littleton","2005","Littleton town, MA",192,4531,4723
"3812","Littleton","Middlesex County","MA","Littleton","2006","Littleton town, MA",181,4492,4673
"3813","Littleton","Middlesex County","MA","Littleton","2007","Littleton town, MA",168,4554,4722
"3814","Littleton","Middlesex County","MA","Littleton","2008","Littleton town, MA",196,4565,4761
"3815","Littleton","Middlesex County","MA","Littleton","2009","Littleton town, MA",311,4517,4828
"3816","Littleton","Middlesex County","MA","Littleton","2010","Littleton town, MA",320,4560,4880
"3817","Littleton","Middlesex County","MA","Littleton","2011","Littleton town, MA",279,4626,4905
"3818","Littleton","Middlesex County","MA","Littleton","2012","Littleton town, MA",247,4677,4924
"3819","Longmeadow","Hampden County","MA","Longmeadow","1990","Longmeadow town, MA",301,7607,7908
"3820","Longmeadow","Hampden County","MA","Longmeadow","1991","Longmeadow town, MA",384,7365,7749
"3821","Longmeadow","Hampden County","MA","Longmeadow","1992","Longmeadow town, MA",365,7366,7731
"3822","Longmeadow","Hampden County","MA","Longmeadow","1993","Longmeadow town, MA",346,7358,7704
"3823","Longmeadow","Hampden County","MA","Longmeadow","1994","Longmeadow town, MA",328,7425,7753
"3824","Longmeadow","Hampden County","MA","Longmeadow","1995","Longmeadow town, MA",279,7169,7448
"3825","Longmeadow","Hampden County","MA","Longmeadow","1996","Longmeadow town, MA",230,7229,7459
"3826","Longmeadow","Hampden County","MA","Longmeadow","1997","Longmeadow town, MA",197,7366,7563
"3827","Longmeadow","Hampden County","MA","Longmeadow","1998","Longmeadow town, MA",169,7386,7555
"3828","Longmeadow","Hampden County","MA","Longmeadow","1999","Longmeadow town, MA",162,7384,7546
"3829","Longmeadow","Hampden County","MA","Longmeadow","2000","Longmeadow town, MA",171,7755,7926
"3830","Longmeadow","Hampden County","MA","Longmeadow","2001","Longmeadow town, MA",198,7750,7948
"3831","Longmeadow","Hampden County","MA","Longmeadow","2002","Longmeadow town, MA",259,7709,7968
"3832","Longmeadow","Hampden County","MA","Longmeadow","2003","Longmeadow town, MA",304,7620,7924
"3833","Longmeadow","Hampden County","MA","Longmeadow","2004","Longmeadow town, MA",281,7598,7879
"3834","Longmeadow","Hampden County","MA","Longmeadow","2005","Longmeadow town, MA",271,7597,7868
"3835","Longmeadow","Hampden County","MA","Longmeadow","2006","Longmeadow town, MA",277,7606,7883
"3836","Longmeadow","Hampden County","MA","Longmeadow","2007","Longmeadow town, MA",255,7546,7801
"3837","Longmeadow","Hampden County","MA","Longmeadow","2008","Longmeadow town, MA",286,7485,7771
"3838","Longmeadow","Hampden County","MA","Longmeadow","2009","Longmeadow town, MA",444,7224,7668
"3839","Longmeadow","Hampden County","MA","Longmeadow","2010","Longmeadow town, MA",466,7375,7841
"3840","Longmeadow","Hampden County","MA","Longmeadow","2011","Longmeadow town, MA",389,7301,7690
"3841","Longmeadow","Hampden County","MA","Longmeadow","2012","Longmeadow town, MA",369,7306,7675
"3842","Lowell","Middlesex County","MA","Lowell","1990","Lowell city, MA",4492,47682,52174
"3843","Lowell","Middlesex County","MA","Lowell","1991","Lowell city, MA",6158,44970,51128
"3844","Lowell","Middlesex County","MA","Lowell","1992","Lowell city, MA",6500,43525,50025
"3845","Lowell","Middlesex County","MA","Lowell","1993","Lowell city, MA",5076,42549,47625
"3846","Lowell","Middlesex County","MA","Lowell","1994","Lowell city, MA",3977,42059,46036
"3847","Lowell","Middlesex County","MA","Lowell","1995","Lowell city, MA",3270,44598,47868
"3848","Lowell","Middlesex County","MA","Lowell","1996","Lowell city, MA",2488,45812,48300
"3849","Lowell","Middlesex County","MA","Lowell","1997","Lowell city, MA",2600,47490,50090
"3850","Lowell","Middlesex County","MA","Lowell","1998","Lowell city, MA",2301,48476,50777
"3851","Lowell","Middlesex County","MA","Lowell","1999","Lowell city, MA",2250,49646,51896
"3852","Lowell","Middlesex County","MA","Lowell","2000","Lowell city, MA",1608,49514,51122
"3853","Lowell","Middlesex County","MA","Lowell","2001","Lowell city, MA",2777,49469,52246
"3854","Lowell","Middlesex County","MA","Lowell","2002","Lowell city, MA",4010,48309,52319
"3855","Lowell","Middlesex County","MA","Lowell","2003","Lowell city, MA",4142,47359,51501
"3856","Lowell","Middlesex County","MA","Lowell","2004","Lowell city, MA",3552,46814,50366
"3857","Lowell","Middlesex County","MA","Lowell","2005","Lowell city, MA",3233,46901,50134
"3858","Lowell","Middlesex County","MA","Lowell","2006","Lowell city, MA",2961,46907,49868
"3859","Lowell","Middlesex County","MA","Lowell","2007","Lowell city, MA",2779,47017,49796
"3860","Lowell","Middlesex County","MA","Lowell","2008","Lowell city, MA",3492,46937,50429
"3861","Lowell","Middlesex County","MA","Lowell","2009","Lowell city, MA",5539,45918,51457
"3862","Lowell","Middlesex County","MA","Lowell","2010","Lowell city, MA",5414,47197,52611
"3863","Lowell","Middlesex County","MA","Lowell","2011","Lowell city, MA",4942,47684,52626
"3864","Lowell","Middlesex County","MA","Lowell","2012","Lowell city, MA",4610,48210,52820
"3865","Ludlow","Hampden County","MA","Ludlow","1990","Ludlow town, MA",734,9917,10651
"3866","Ludlow","Hampden County","MA","Ludlow","1991","Ludlow town, MA",1042,9683,10725
"3867","Ludlow","Hampden County","MA","Ludlow","1992","Ludlow town, MA",1052,9753,10805
"3868","Ludlow","Hampden County","MA","Ludlow","1993","Ludlow town, MA",1029,9890,10919
"3869","Ludlow","Hampden County","MA","Ludlow","1994","Ludlow town, MA",958,9973,10931
"3870","Ludlow","Hampden County","MA","Ludlow","1995","Ludlow town, MA",715,9586,10301
"3871","Ludlow","Hampden County","MA","Ludlow","1996","Ludlow town, MA",582,9752,10334
"3872","Ludlow","Hampden County","MA","Ludlow","1997","Ludlow town, MA",600,10050,10650
"3873","Ludlow","Hampden County","MA","Ludlow","1998","Ludlow town, MA",506,10144,10650
"3874","Ludlow","Hampden County","MA","Ludlow","1999","Ludlow town, MA",450,10230,10680
"3875","Ludlow","Hampden County","MA","Ludlow","2000","Ludlow town, MA",364,10369,10733
"3876","Ludlow","Hampden County","MA","Ludlow","2001","Ludlow town, MA",457,10500,10957
"3877","Ludlow","Hampden County","MA","Ludlow","2002","Ludlow town, MA",599,10507,11106
"3878","Ludlow","Hampden County","MA","Ludlow","2003","Ludlow town, MA",745,10447,11192
"3879","Ludlow","Hampden County","MA","Ludlow","2004","Ludlow town, MA",683,10497,11180
"3880","Ludlow","Hampden County","MA","Ludlow","2005","Ludlow town, MA",645,10542,11187
"3881","Ludlow","Hampden County","MA","Ludlow","2006","Ludlow town, MA",694,10617,11311
"3882","Ludlow","Hampden County","MA","Ludlow","2007","Ludlow town, MA",625,10700,11325
"3883","Ludlow","Hampden County","MA","Ludlow","2008","Ludlow town, MA",769,10772,11541
"3884","Ludlow","Hampden County","MA","Ludlow","2009","Ludlow town, MA",1039,10168,11207
"3885","Ludlow","Hampden County","MA","Ludlow","2010","Ludlow town, MA",1034,9706,10740
"3886","Ludlow","Hampden County","MA","Ludlow","2011","Ludlow town, MA",1025,9608,10633
"3887","Ludlow","Hampden County","MA","Ludlow","2012","Ludlow town, MA",911,9614,10525
"3888","Lunenburg","Worcester County","MA","Lunenburg","1990","Lunenburg town, MA",294,4815,5109
"3889","Lunenburg","Worcester County","MA","Lunenburg","1991","Lunenburg town, MA",443,4702,5145
"3890","Lunenburg","Worcester County","MA","Lunenburg","1992","Lunenburg town, MA",379,4797,5176
"3891","Lunenburg","Worcester County","MA","Lunenburg","1993","Lunenburg town, MA",365,4923,5288
"3892","Lunenburg","Worcester County","MA","Lunenburg","1994","Lunenburg town, MA",293,5004,5297
"3893","Lunenburg","Worcester County","MA","Lunenburg","1995","Lunenburg town, MA",259,4861,5120
"3894","Lunenburg","Worcester County","MA","Lunenburg","1996","Lunenburg town, MA",236,4877,5113
"3895","Lunenburg","Worcester County","MA","Lunenburg","1997","Lunenburg town, MA",217,5007,5224
"3896","Lunenburg","Worcester County","MA","Lunenburg","1998","Lunenburg town, MA",155,4937,5092
"3897","Lunenburg","Worcester County","MA","Lunenburg","1999","Lunenburg town, MA",176,4955,5131
"3898","Lunenburg","Worcester County","MA","Lunenburg","2000","Lunenburg town, MA",144,5089,5233
"3899","Lunenburg","Worcester County","MA","Lunenburg","2001","Lunenburg town, MA",186,5092,5278
"3900","Lunenburg","Worcester County","MA","Lunenburg","2002","Lunenburg town, MA",308,5089,5397
"3901","Lunenburg","Worcester County","MA","Lunenburg","2003","Lunenburg town, MA",336,5083,5419
"3902","Lunenburg","Worcester County","MA","Lunenburg","2004","Lunenburg town, MA",313,5096,5409
"3903","Lunenburg","Worcester County","MA","Lunenburg","2005","Lunenburg town, MA",274,5062,5336
"3904","Lunenburg","Worcester County","MA","Lunenburg","2006","Lunenburg town, MA",269,5099,5368
"3905","Lunenburg","Worcester County","MA","Lunenburg","2007","Lunenburg town, MA",266,5088,5354
"3906","Lunenburg","Worcester County","MA","Lunenburg","2008","Lunenburg town, MA",308,5019,5327
"3907","Lunenburg","Worcester County","MA","Lunenburg","2009","Lunenburg town, MA",480,4834,5314
"3908","Lunenburg","Worcester County","MA","Lunenburg","2010","Lunenburg town, MA",473,4908,5381
"3909","Lunenburg","Worcester County","MA","Lunenburg","2011","Lunenburg town, MA",439,4906,5345
"3910","Lunenburg","Worcester County","MA","Lunenburg","2012","Lunenburg town, MA",418,4903,5321
"3911","Lynn","Essex County","MA","Lynn","1990","Lynn city, MA",3065,35836,38901
"3912","Lynn","Essex County","MA","Lynn","1991","Lynn city, MA",3918,34226,38144
"3913","Lynn","Essex County","MA","Lynn","1992","Lynn city, MA",4191,33513,37704
"3914","Lynn","Essex County","MA","Lynn","1993","Lynn city, MA",2942,33663,36605
"3915","Lynn","Essex County","MA","Lynn","1994","Lynn city, MA",2702,33925,36627
"3916","Lynn","Essex County","MA","Lynn","1995","Lynn city, MA",2314,35174,37488
"3917","Lynn","Essex County","MA","Lynn","1996","Lynn city, MA",2013,35817,37830
"3918","Lynn","Essex County","MA","Lynn","1997","Lynn city, MA",1881,36774,38655
"3919","Lynn","Essex County","MA","Lynn","1998","Lynn city, MA",1594,37337,38931
"3920","Lynn","Essex County","MA","Lynn","1999","Lynn city, MA",1628,37553,39181
"3921","Lynn","Essex County","MA","Lynn","2000","Lynn city, MA",1355,40582,41937
"3922","Lynn","Essex County","MA","Lynn","2001","Lynn city, MA",1841,40651,42492
"3923","Lynn","Essex County","MA","Lynn","2002","Lynn city, MA",2676,40169,42845
"3924","Lynn","Essex County","MA","Lynn","2003","Lynn city, MA",3165,39714,42879
"3925","Lynn","Essex County","MA","Lynn","2004","Lynn city, MA",2784,39330,42114
"3926","Lynn","Essex County","MA","Lynn","2005","Lynn city, MA",2579,39095,41674
"3927","Lynn","Essex County","MA","Lynn","2006","Lynn city, MA",2487,39212,41699
"3928","Lynn","Essex County","MA","Lynn","2007","Lynn city, MA",2263,38969,41232
"3929","Lynn","Essex County","MA","Lynn","2008","Lynn city, MA",2660,38947,41607
"3930","Lynn","Essex County","MA","Lynn","2009","Lynn city, MA",3994,38032,42026
"3931","Lynn","Essex County","MA","Lynn","2010","Lynn city, MA",4009,39332,43341
"3932","Lynn","Essex County","MA","Lynn","2011","Lynn city, MA",3640,39788,43428
"3933","Lynn","Essex County","MA","Lynn","2012","Lynn city, MA",3438,40094,43532
"3934","Lynnfield","Essex County","MA","Lynnfield","1990","Lynnfield town, MA",235,5750,5985
"3935","Lynnfield","Essex County","MA","Lynnfield","1991","Lynnfield town, MA",318,5556,5874
"3936","Lynnfield","Essex County","MA","Lynnfield","1992","Lynnfield town, MA",397,5520,5917
"3937","Lynnfield","Essex County","MA","Lynnfield","1993","Lynnfield town, MA",331,5634,5965
"3938","Lynnfield","Essex County","MA","Lynnfield","1994","Lynnfield town, MA",254,5762,6016
"3939","Lynnfield","Essex County","MA","Lynnfield","1995","Lynnfield town, MA",225,5760,5985
"3940","Lynnfield","Essex County","MA","Lynnfield","1996","Lynnfield town, MA",158,5883,6041
"3941","Lynnfield","Essex County","MA","Lynnfield","1997","Lynnfield town, MA",161,6045,6206
"3942","Lynnfield","Essex County","MA","Lynnfield","1998","Lynnfield town, MA",130,6190,6320
"3943","Lynnfield","Essex County","MA","Lynnfield","1999","Lynnfield town, MA",132,6251,6383
"3944","Lynnfield","Essex County","MA","Lynnfield","2000","Lynnfield town, MA",122,5671,5793
"3945","Lynnfield","Essex County","MA","Lynnfield","2001","Lynnfield town, MA",166,5679,5845
"3946","Lynnfield","Essex County","MA","Lynnfield","2002","Lynnfield town, MA",247,5597,5844
"3947","Lynnfield","Essex County","MA","Lynnfield","2003","Lynnfield town, MA",295,5520,5815
"3948","Lynnfield","Essex County","MA","Lynnfield","2004","Lynnfield town, MA",265,5494,5759
"3949","Lynnfield","Essex County","MA","Lynnfield","2005","Lynnfield town, MA",228,5512,5740
"3950","Lynnfield","Essex County","MA","Lynnfield","2006","Lynnfield town, MA",216,5335,5551
"3951","Lynnfield","Essex County","MA","Lynnfield","2007","Lynnfield town, MA",205,5379,5584
"3952","Lynnfield","Essex County","MA","Lynnfield","2008","Lynnfield town, MA",259,5406,5665
"3953","Lynnfield","Essex County","MA","Lynnfield","2009","Lynnfield town, MA",400,5481,5881
"3954","Lynnfield","Essex County","MA","Lynnfield","2010","Lynnfield town, MA",382,5362,5744
"3955","Lynnfield","Essex County","MA","Lynnfield","2011","Lynnfield town, MA",313,5427,5740
"3956","Lynnfield","Essex County","MA","Lynnfield","2012","Lynnfield town, MA",282,5487,5769
"3994","Malden","Middlesex County","MA","Malden","1990","Malden city, MA",1886,28567,30453
"3995","Malden","Middlesex County","MA","Malden","1991","Malden city, MA",2612,27480,30092
"3996","Malden","Middlesex County","MA","Malden","1992","Malden city, MA",2649,27163,29812
"3997","Malden","Middlesex County","MA","Malden","1993","Malden city, MA",2059,26729,28788
"3998","Malden","Middlesex County","MA","Malden","1994","Malden city, MA",1749,26909,28658
"3999","Malden","Middlesex County","MA","Malden","1995","Malden city, MA",1717,27683,29400
"4000","Malden","Middlesex County","MA","Malden","1996","Malden city, MA",1299,28120,29419
"4001","Malden","Middlesex County","MA","Malden","1997","Malden city, MA",1230,28764,29994
"4002","Malden","Middlesex County","MA","Malden","1998","Malden city, MA",1006,29065,30071
"4003","Malden","Middlesex County","MA","Malden","1999","Malden city, MA",1032,29194,30226
"4004","Malden","Middlesex County","MA","Malden","2000","Malden city, MA",808,30867,31675
"4005","Malden","Middlesex County","MA","Malden","2001","Malden city, MA",1165,30679,31844
"4006","Malden","Middlesex County","MA","Malden","2002","Malden city, MA",1681,29984,31665
"4007","Malden","Middlesex County","MA","Malden","2003","Malden city, MA",1940,29383,31323
"4008","Malden","Middlesex County","MA","Malden","2004","Malden city, MA",1621,29196,30817
"4009","Malden","Middlesex County","MA","Malden","2005","Malden city, MA",1471,29789,31260
"4010","Malden","Middlesex County","MA","Malden","2006","Malden city, MA",1435,29257,30692
"4011","Malden","Middlesex County","MA","Malden","2007","Malden city, MA",1348,29459,30807
"4012","Malden","Middlesex County","MA","Malden","2008","Malden city, MA",1668,29389,31057
"4013","Malden","Middlesex County","MA","Malden","2009","Malden city, MA",2494,28566,31060
"4014","Malden","Middlesex County","MA","Malden","2010","Malden city, MA",2592,30702,33294
"4015","Malden","Middlesex County","MA","Malden","2011","Malden city, MA",2245,31155,33400
"4016","Malden","Middlesex County","MA","Malden","2012","Malden city, MA",1985,31496,33481
"4017","Manchester-by-the-Sea","Essex County","MA","Manchester-by-the-Sea","1990","Manchester-by-the-Sea town, MA",112,2782,2894
"4018","Manchester-by-the-Sea","Essex County","MA","Manchester-by-the-Sea","1991","Manchester-by-the-Sea town, MA",165,2723,2888
"4019","Manchester-by-the-Sea","Essex County","MA","Manchester-by-the-Sea","1992","Manchester-by-the-Sea town, MA",178,2728,2906
"4020","Manchester-by-the-Sea","Essex County","MA","Manchester-by-the-Sea","1993","Manchester-by-the-Sea town, MA",137,2752,2889
"4021","Manchester-by-the-Sea","Essex County","MA","Manchester-by-the-Sea","1994","Manchester-by-the-Sea town, MA",101,2815,2916
"4022","Manchester-by-the-Sea","Essex County","MA","Manchester-by-the-Sea","1995","Manchester-by-the-Sea town, MA",86,2779,2865
"4023","Manchester-by-the-Sea","Essex County","MA","Manchester-by-the-Sea","1996","Manchester-by-the-Sea town, MA",82,2836,2918
"4024","Manchester-by-the-Sea","Essex County","MA","Manchester-by-the-Sea","1997","Manchester-by-the-Sea town, MA",84,2928,3012
"4025","Manchester-by-the-Sea","Essex County","MA","Manchester-by-the-Sea","1998","Manchester-by-the-Sea town, MA",63,3019,3082
"4026","Manchester-by-the-Sea","Essex County","MA","Manchester-by-the-Sea","1999","Manchester-by-the-Sea town, MA",58,3048,3106
"4027","Manchester-by-the-Sea","Essex County","MA","Manchester-by-the-Sea","2000","Manchester-by-the-Sea town, MA",57,2714,2771
"4028","Manchester-by-the-Sea","Essex County","MA","Manchester-by-the-Sea","2001","Manchester-by-the-Sea town, MA",81,2722,2803
"4029","Manchester-by-the-Sea","Essex County","MA","Manchester-by-the-Sea","2002","Manchester-by-the-Sea town, MA",122,2683,2805
"4030","Manchester-by-the-Sea","Essex County","MA","Manchester-by-the-Sea","2003","Manchester-by-the-Sea town, MA",135,2664,2799
"4031","Manchester-by-the-Sea","Essex County","MA","Manchester-by-the-Sea","2004","Manchester-by-the-Sea town, MA",120,2676,2796
"4032","Manchester-by-the-Sea","Essex County","MA","Manchester-by-the-Sea","2005","Manchester-by-the-Sea town, MA",93,2689,2782
"4033","Manchester-by-the-Sea","Essex County","MA","Manchester-by-the-Sea","2006","Manchester-by-the-Sea town, MA",99,2575,2674
"4034","Manchester-by-the-Sea","Essex County","MA","Manchester-by-the-Sea","2007","Manchester-by-the-Sea town, MA",90,2584,2674
"4035","Manchester-by-the-Sea","Essex County","MA","Manchester-by-the-Sea","2008","Manchester-by-the-Sea town, MA",107,2578,2685
"4036","Manchester-by-the-Sea","Essex County","MA","Manchester-by-the-Sea","2009","Manchester-by-the-Sea town, MA",173,2502,2675
"4037","Manchester-by-the-Sea","Essex County","MA","Manchester-by-the-Sea","2010","Manchester-by-the-Sea town, MA",180,2507,2687
"4038","Manchester-by-the-Sea","Essex County","MA","Manchester-by-the-Sea","2011","Manchester-by-the-Sea town, MA",144,2538,2682
"4039","Manchester-by-the-Sea","Essex County","MA","Manchester-by-the-Sea","2012","Manchester-by-the-Sea town, MA",153,2566,2719
"4040","Mansfield","Bristol County","MA","Mansfield","1990","Mansfield town, MA",664,9252,9916
"4041","Mansfield","Bristol County","MA","Mansfield","1991","Mansfield town, MA",729,9251,9980
"4042","Mansfield","Bristol County","MA","Mansfield","1992","Mansfield town, MA",812,9539,10351
"4043","Mansfield","Bristol County","MA","Mansfield","1993","Mansfield town, MA",643,10099,10742
"4044","Mansfield","Bristol County","MA","Mansfield","1994","Mansfield town, MA",595,10482,11077
"4045","Mansfield","Bristol County","MA","Mansfield","1995","Mansfield town, MA",548,10218,10766
"4046","Mansfield","Bristol County","MA","Mansfield","1996","Mansfield town, MA",397,10513,10910
"4047","Mansfield","Bristol County","MA","Mansfield","1997","Mansfield town, MA",388,10851,11239
"4048","Mansfield","Bristol County","MA","Mansfield","1998","Mansfield town, MA",315,11227,11542
"4049","Mansfield","Bristol County","MA","Mansfield","1999","Mansfield town, MA",289,11509,11798
"4050","Mansfield","Bristol County","MA","Mansfield","2000","Mansfield town, MA",299,11973,12272
"4051","Mansfield","Bristol County","MA","Mansfield","2001","Mansfield town, MA",413,12024,12437
"4052","Mansfield","Bristol County","MA","Mansfield","2002","Mansfield town, MA",620,11918,12538
"4053","Mansfield","Bristol County","MA","Mansfield","2003","Mansfield town, MA",676,11834,12510
"4054","Mansfield","Bristol County","MA","Mansfield","2004","Mansfield town, MA",566,11791,12357
"4055","Mansfield","Bristol County","MA","Mansfield","2005","Mansfield town, MA",507,11911,12418
"4056","Mansfield","Bristol County","MA","Mansfield","2006","Mansfield town, MA",518,11728,12246
"4057","Mansfield","Bristol County","MA","Mansfield","2007","Mansfield town, MA",476,12013,12489
"4058","Mansfield","Bristol County","MA","Mansfield","2008","Mansfield town, MA",592,12208,12800
"4059","Mansfield","Bristol County","MA","Mansfield","2009","Mansfield town, MA",914,11797,12711
"4060","Mansfield","Bristol County","MA","Mansfield","2010","Mansfield town, MA",916,11640,12556
"4061","Mansfield","Bristol County","MA","Mansfield","2011","Mansfield town, MA",814,11704,12518
"4062","Mansfield","Bristol County","MA","Mansfield","2012","Mansfield town, MA",728,11833,12561
"4063","Marblehead","Essex County","MA","Marblehead","1990","Marblehead town, MA",491,11280,11771
"4064","Marblehead","Essex County","MA","Marblehead","1991","Marblehead town, MA",699,11060,11759
"4065","Marblehead","Essex County","MA","Marblehead","1992","Marblehead town, MA",663,11060,11723
"4066","Marblehead","Essex County","MA","Marblehead","1993","Marblehead town, MA",541,11256,11797
"4067","Marblehead","Essex County","MA","Marblehead","1994","Marblehead town, MA",443,11479,11922
"4068","Marblehead","Essex County","MA","Marblehead","1995","Marblehead town, MA",382,11132,11514
"4069","Marblehead","Essex County","MA","Marblehead","1996","Marblehead town, MA",281,11341,11622
"4070","Marblehead","Essex County","MA","Marblehead","1997","Marblehead town, MA",266,11623,11889
"4071","Marblehead","Essex County","MA","Marblehead","1998","Marblehead town, MA",246,11791,12037
"4072","Marblehead","Essex County","MA","Marblehead","1999","Marblehead town, MA",227,11885,12112
"4073","Marblehead","Essex County","MA","Marblehead","2000","Marblehead town, MA",220,11089,11309
"4074","Marblehead","Essex County","MA","Marblehead","2001","Marblehead town, MA",339,11101,11440
"4075","Marblehead","Essex County","MA","Marblehead","2002","Marblehead town, MA",505,10958,11463
"4076","Marblehead","Essex County","MA","Marblehead","2003","Marblehead town, MA",496,10820,11316
"4077","Marblehead","Essex County","MA","Marblehead","2004","Marblehead town, MA",441,10693,11134
"4078","Marblehead","Essex County","MA","Marblehead","2005","Marblehead town, MA",405,10674,11079
"4079","Marblehead","Essex County","MA","Marblehead","2006","Marblehead town, MA",382,10768,11150
"4080","Marblehead","Essex County","MA","Marblehead","2007","Marblehead town, MA",361,10705,11066
"4081","Marblehead","Essex County","MA","Marblehead","2008","Marblehead town, MA",435,10673,11108
"4082","Marblehead","Essex County","MA","Marblehead","2009","Marblehead town, MA",693,10360,11053
"4083","Marblehead","Essex County","MA","Marblehead","2010","Marblehead town, MA",639,10301,10940
"4084","Marblehead","Essex County","MA","Marblehead","2011","Marblehead town, MA",550,10421,10971
"4085","Marblehead","Essex County","MA","Marblehead","2012","Marblehead town, MA",556,10501,11057
"4086","Marion","Plymouth County","MA","Marion","1990","Marion town, MA",152,2140,2292
"4087","Marion","Plymouth County","MA","Marion","1991","Marion town, MA",199,2139,2338
"4088","Marion","Plymouth County","MA","Marion","1992","Marion town, MA",188,2133,2321
"4089","Marion","Plymouth County","MA","Marion","1993","Marion town, MA",151,2224,2375
"4090","Marion","Plymouth County","MA","Marion","1994","Marion town, MA",156,2324,2480
"4091","Marion","Plymouth County","MA","Marion","1995","Marion town, MA",144,2270,2414
"4092","Marion","Plymouth County","MA","Marion","1996","Marion town, MA",135,2301,2436
"4093","Marion","Plymouth County","MA","Marion","1997","Marion town, MA",121,2415,2536
"4094","Marion","Plymouth County","MA","Marion","1998","Marion town, MA",82,2459,2541
"4095","Marion","Plymouth County","MA","Marion","1999","Marion town, MA",96,2511,2607
"4096","Marion","Plymouth County","MA","Marion","2000","Marion town, MA",64,2817,2881
"4097","Marion","Plymouth County","MA","Marion","2001","Marion town, MA",74,2863,2937
"4098","Marion","Plymouth County","MA","Marion","2002","Marion town, MA",115,2927,3042
"4099","Marion","Plymouth County","MA","Marion","2003","Marion town, MA",128,2978,3106
"4100","Marion","Plymouth County","MA","Marion","2004","Marion town, MA",119,3023,3142
"4101","Marion","Plymouth County","MA","Marion","2005","Marion town, MA",107,3041,3148
"4102","Marion","Plymouth County","MA","Marion","2006","Marion town, MA",116,3051,3167
"4103","Marion","Plymouth County","MA","Marion","2007","Marion town, MA",106,3029,3135
"4104","Marion","Plymouth County","MA","Marion","2008","Marion town, MA",139,2985,3124
"4105","Marion","Plymouth County","MA","Marion","2009","Marion town, MA",191,2921,3112
"4106","Marion","Plymouth County","MA","Marion","2010","Marion town, MA",195,2805,3000
"4107","Marion","Plymouth County","MA","Marion","2011","Marion town, MA",188,2816,3004
"4108","Marion","Plymouth County","MA","Marion","2012","Marion town, MA",159,2863,3022
"4109","Marlborough","Middlesex County","MA","Marlborough","1990","Marlborough city, MA",1092,18008,19100
"4110","Marlborough","Middlesex County","MA","Marlborough","1991","Marlborough city, MA",1511,17543,19054
"4111","Marlborough","Middlesex County","MA","Marlborough","1992","Marlborough city, MA",1541,17478,19019
"4112","Marlborough","Middlesex County","MA","Marlborough","1993","Marlborough city, MA",1289,17887,19176
"4113","Marlborough","Middlesex County","MA","Marlborough","1994","Marlborough city, MA",1059,18453,19512
"4114","Marlborough","Middlesex County","MA","Marlborough","1995","Marlborough city, MA",990,18331,19321
"4115","Marlborough","Middlesex County","MA","Marlborough","1996","Marlborough city, MA",716,18764,19480
"4116","Marlborough","Middlesex County","MA","Marlborough","1997","Marlborough city, MA",661,19307,19968
"4117","Marlborough","Middlesex County","MA","Marlborough","1998","Marlborough city, MA",571,19632,20203
"4118","Marlborough","Middlesex County","MA","Marlborough","1999","Marlborough city, MA",623,19829,20452
"4119","Marlborough","Middlesex County","MA","Marlborough","2000","Marlborough city, MA",492,21229,21721
"4120","Marlborough","Middlesex County","MA","Marlborough","2001","Marlborough city, MA",730,21900,22630
"4121","Marlborough","Middlesex County","MA","Marlborough","2002","Marlborough city, MA",1164,21488,22652
"4122","Marlborough","Middlesex County","MA","Marlborough","2003","Marlborough city, MA",1218,21032,22250
"4123","Marlborough","Middlesex County","MA","Marlborough","2004","Marlborough city, MA",944,21068,22012
"4124","Marlborough","Middlesex County","MA","Marlborough","2005","Marlborough city, MA",895,21257,22152
"4125","Marlborough","Middlesex County","MA","Marlborough","2006","Marlborough city, MA",853,21732,22585
"4126","Marlborough","Middlesex County","MA","Marlborough","2007","Marlborough city, MA",819,22000,22819
"4127","Marlborough","Middlesex County","MA","Marlborough","2008","Marlborough city, MA",979,22123,23102
"4128","Marlborough","Middlesex County","MA","Marlborough","2009","Marlborough city, MA",1522,21393,22915
"4129","Marlborough","Middlesex County","MA","Marlborough","2010","Marlborough city, MA",1521,21194,22715
"4130","Marlborough","Middlesex County","MA","Marlborough","2011","Marlborough city, MA",1263,21398,22661
"4131","Marlborough","Middlesex County","MA","Marlborough","2012","Marlborough city, MA",1233,21593,22826
"4132","Marshfield","Plymouth County","MA","Marshfield","1990","Marshfield town, MA",796,11489,12285
"4133","Marshfield","Plymouth County","MA","Marshfield","1991","Marshfield town, MA",1071,11306,12377
"4134","Marshfield","Plymouth County","MA","Marshfield","1992","Marshfield town, MA",1111,11338,12449
"4135","Marshfield","Plymouth County","MA","Marshfield","1993","Marshfield town, MA",940,11649,12589
"4136","Marshfield","Plymouth County","MA","Marshfield","1994","Marshfield town, MA",738,12075,12813
"4137","Marshfield","Plymouth County","MA","Marshfield","1995","Marshfield town, MA",660,11940,12600
"4138","Marshfield","Plymouth County","MA","Marshfield","1996","Marshfield town, MA",598,12273,12871
"4139","Marshfield","Plymouth County","MA","Marshfield","1997","Marshfield town, MA",489,12694,13183
"4140","Marshfield","Plymouth County","MA","Marshfield","1998","Marshfield town, MA",433,13031,13464
"4141","Marshfield","Plymouth County","MA","Marshfield","1999","Marshfield town, MA",405,13310,13715
"4142","Marshfield","Plymouth County","MA","Marshfield","2000","Marshfield town, MA",317,13296,13613
"4143","Marshfield","Plymouth County","MA","Marshfield","2001","Marshfield town, MA",402,13342,13744
"4144","Marshfield","Plymouth County","MA","Marshfield","2002","Marshfield town, MA",584,13225,13809
"4145","Marshfield","Plymouth County","MA","Marshfield","2003","Marshfield town, MA",660,13039,13699
"4146","Marshfield","Plymouth County","MA","Marshfield","2004","Marshfield town, MA",633,13029,13662
"4147","Marshfield","Plymouth County","MA","Marshfield","2005","Marshfield town, MA",565,13207,13772
"4148","Marshfield","Plymouth County","MA","Marshfield","2006","Marshfield town, MA",567,12872,13439
"4149","Marshfield","Plymouth County","MA","Marshfield","2007","Marshfield town, MA",595,12935,13530
"4150","Marshfield","Plymouth County","MA","Marshfield","2008","Marshfield town, MA",682,13001,13683
"4151","Marshfield","Plymouth County","MA","Marshfield","2009","Marshfield town, MA",1024,12601,13625
"4152","Marshfield","Plymouth County","MA","Marshfield","2010","Marshfield town, MA",1072,12916,13988
"4153","Marshfield","Plymouth County","MA","Marshfield","2011","Marshfield town, MA",910,13043,13953
"4154","Marshfield","Plymouth County","MA","Marshfield","2012","Marshfield town, MA",823,13186,14009
"4155","Mashpee","Barnstable County","MA","Mashpee","1990","Mashpee town, MA",272,4048,4320
"4156","Mashpee","Barnstable County","MA","Mashpee","1991","Mashpee town, MA",448,4051,4499
"4157","Mashpee","Barnstable County","MA","Mashpee","1992","Mashpee town, MA",522,4123,4645
"4158","Mashpee","Barnstable County","MA","Mashpee","1993","Mashpee town, MA",461,4408,4869
"4159","Mashpee","Barnstable County","MA","Mashpee","1994","Mashpee town, MA",398,4610,5008
"4160","Mashpee","Barnstable County","MA","Mashpee","1995","Mashpee town, MA",346,4311,4657
"4161","Mashpee","Barnstable County","MA","Mashpee","1996","Mashpee town, MA",333,4455,4788
"4162","Mashpee","Barnstable County","MA","Mashpee","1997","Mashpee town, MA",337,4538,4875
"4163","Mashpee","Barnstable County","MA","Mashpee","1998","Mashpee town, MA",285,4727,5012
"4164","Mashpee","Barnstable County","MA","Mashpee","1999","Mashpee town, MA",251,5005,5256
"4165","Mashpee","Barnstable County","MA","Mashpee","2000","Mashpee town, MA",213,6692,6905
"4166","Mashpee","Barnstable County","MA","Mashpee","2001","Mashpee town, MA",245,6924,7169
"4167","Mashpee","Barnstable County","MA","Mashpee","2002","Mashpee town, MA",320,7220,7540
"4168","Mashpee","Barnstable County","MA","Mashpee","2003","Mashpee town, MA",379,7454,7833
"4169","Mashpee","Barnstable County","MA","Mashpee","2004","Mashpee town, MA",366,7595,7961
"4170","Mashpee","Barnstable County","MA","Mashpee","2005","Mashpee town, MA",356,7629,7985
"4171","Mashpee","Barnstable County","MA","Mashpee","2006","Mashpee town, MA",365,7737,8102
"4172","Mashpee","Barnstable County","MA","Mashpee","2007","Mashpee town, MA",368,7737,8105
"4173","Mashpee","Barnstable County","MA","Mashpee","2008","Mashpee town, MA",444,7709,8153
"4174","Mashpee","Barnstable County","MA","Mashpee","2009","Mashpee town, MA",645,7568,8213
"4175","Mashpee","Barnstable County","MA","Mashpee","2010","Mashpee town, MA",700,7482,8182
"4176","Mashpee","Barnstable County","MA","Mashpee","2011","Mashpee town, MA",601,7470,8071
"4177","Mashpee","Barnstable County","MA","Mashpee","2012","Mashpee town, MA",558,7595,8153
"4178","Mattapoisett","Plymouth County","MA","Mattapoisett","1990","Mattapoisett town, MA",181,3097,3278
"4179","Mattapoisett","Plymouth County","MA","Mattapoisett","1991","Mattapoisett town, MA",287,2993,3280
"4180","Mattapoisett","Plymouth County","MA","Mattapoisett","1992","Mattapoisett town, MA",293,2980,3273
"4181","Mattapoisett","Plymouth County","MA","Mattapoisett","1993","Mattapoisett town, MA",225,3084,3309
"4182","Mattapoisett","Plymouth County","MA","Mattapoisett","1994","Mattapoisett town, MA",188,3121,3309
"4183","Mattapoisett","Plymouth County","MA","Mattapoisett","1995","Mattapoisett town, MA",185,3190,3375
"4184","Mattapoisett","Plymouth County","MA","Mattapoisett","1996","Mattapoisett town, MA",164,3201,3365
"4185","Mattapoisett","Plymouth County","MA","Mattapoisett","1997","Mattapoisett town, MA",132,3311,3443
"4186","Mattapoisett","Plymouth County","MA","Mattapoisett","1998","Mattapoisett town, MA",105,3372,3477
"4187","Mattapoisett","Plymouth County","MA","Mattapoisett","1999","Mattapoisett town, MA",113,3421,3534
"4188","Mattapoisett","Plymouth County","MA","Mattapoisett","2000","Mattapoisett town, MA",87,3257,3344
"4189","Mattapoisett","Plymouth County","MA","Mattapoisett","2001","Mattapoisett town, MA",104,3240,3344
"4190","Mattapoisett","Plymouth County","MA","Mattapoisett","2002","Mattapoisett town, MA",137,3267,3404
"4191","Mattapoisett","Plymouth County","MA","Mattapoisett","2003","Mattapoisett town, MA",156,3228,3384
"4192","Mattapoisett","Plymouth County","MA","Mattapoisett","2004","Mattapoisett town, MA",160,3247,3407
"4193","Mattapoisett","Plymouth County","MA","Mattapoisett","2005","Mattapoisett town, MA",139,3305,3444
"4194","Mattapoisett","Plymouth County","MA","Mattapoisett","2006","Mattapoisett town, MA",146,3358,3504
"4195","Mattapoisett","Plymouth County","MA","Mattapoisett","2007","Mattapoisett town, MA",131,3355,3486
"4196","Mattapoisett","Plymouth County","MA","Mattapoisett","2008","Mattapoisett town, MA",161,3275,3436
"4197","Mattapoisett","Plymouth County","MA","Mattapoisett","2009","Mattapoisett town, MA",234,3212,3446
"4198","Mattapoisett","Plymouth County","MA","Mattapoisett","2010","Mattapoisett town, MA",254,2938,3192
"4199","Mattapoisett","Plymouth County","MA","Mattapoisett","2011","Mattapoisett town, MA",246,2981,3227
"4200","Mattapoisett","Plymouth County","MA","Mattapoisett","2012","Mattapoisett town, MA",218,3017,3235
"4201","Maynard","Middlesex County","MA","Maynard","1990","Maynard town, MA",296,5696,5992
"4202","Maynard","Middlesex County","MA","Maynard","1991","Maynard town, MA",410,5508,5918
"4203","Maynard","Middlesex County","MA","Maynard","1992","Maynard town, MA",416,5529,5945
"4204","Maynard","Middlesex County","MA","Maynard","1993","Maynard town, MA",364,5597,5961
"4205","Maynard","Middlesex County","MA","Maynard","1994","Maynard town, MA",326,5644,5970
"4206","Maynard","Middlesex County","MA","Maynard","1995","Maynard town, MA",283,5670,5953
"4207","Maynard","Middlesex County","MA","Maynard","1996","Maynard town, MA",220,5788,6008
"4208","Maynard","Middlesex County","MA","Maynard","1997","Maynard town, MA",206,5925,6131
"4209","Maynard","Middlesex County","MA","Maynard","1998","Maynard town, MA",162,6014,6176
"4210","Maynard","Middlesex County","MA","Maynard","1999","Maynard town, MA",177,6072,6249
"4211","Maynard","Middlesex County","MA","Maynard","2000","Maynard town, MA",146,6123,6269
"4212","Maynard","Middlesex County","MA","Maynard","2001","Maynard town, MA",221,6089,6310
"4213","Maynard","Middlesex County","MA","Maynard","2002","Maynard town, MA",333,5972,6305
"4214","Maynard","Middlesex County","MA","Maynard","2003","Maynard town, MA",328,5848,6176
"4215","Maynard","Middlesex County","MA","Maynard","2004","Maynard town, MA",286,5832,6118
"4216","Maynard","Middlesex County","MA","Maynard","2005","Maynard town, MA",256,5841,6097
"4217","Maynard","Middlesex County","MA","Maynard","2006","Maynard town, MA",259,5793,6052
"4218","Maynard","Middlesex County","MA","Maynard","2007","Maynard town, MA",228,5869,6097
"4219","Maynard","Middlesex County","MA","Maynard","2008","Maynard town, MA",266,5905,6171
"4220","Maynard","Middlesex County","MA","Maynard","2009","Maynard town, MA",414,5790,6204
"4221","Maynard","Middlesex County","MA","Maynard","2010","Maynard town, MA",418,5589,6007
"4222","Maynard","Middlesex County","MA","Maynard","2011","Maynard town, MA",390,5672,6062
"4223","Maynard","Middlesex County","MA","Maynard","2012","Maynard town, MA",331,5734,6065
"4224","Medfield","Norfolk County","MA","Medfield","1990","Medfield town, MA",247,5626,5873
"4225","Medfield","Norfolk County","MA","Medfield","1991","Medfield town, MA",314,5501,5815
"4226","Medfield","Norfolk County","MA","Medfield","1992","Medfield town, MA",323,5504,5827
"4227","Medfield","Norfolk County","MA","Medfield","1993","Medfield town, MA",268,5709,5977
"4228","Medfield","Norfolk County","MA","Medfield","1994","Medfield town, MA",199,5982,6181
"4229","Medfield","Norfolk County","MA","Medfield","1995","Medfield town, MA",193,5952,6145
"4230","Medfield","Norfolk County","MA","Medfield","1996","Medfield town, MA",159,6139,6298
"4231","Medfield","Norfolk County","MA","Medfield","1997","Medfield town, MA",142,6354,6496
"4232","Medfield","Norfolk County","MA","Medfield","1998","Medfield town, MA",108,6480,6588
"4233","Medfield","Norfolk County","MA","Medfield","1999","Medfield town, MA",120,6563,6683
"4234","Medfield","Norfolk County","MA","Medfield","2000","Medfield town, MA",124,5959,6083
"4235","Medfield","Norfolk County","MA","Medfield","2001","Medfield town, MA",164,5990,6154
"4236","Medfield","Norfolk County","MA","Medfield","2002","Medfield town, MA",246,5880,6126
"4237","Medfield","Norfolk County","MA","Medfield","2003","Medfield town, MA",276,5786,6062
"4238","Medfield","Norfolk County","MA","Medfield","2004","Medfield town, MA",233,5783,6016
"4239","Medfield","Norfolk County","MA","Medfield","2005","Medfield town, MA",203,5817,6020
"4240","Medfield","Norfolk County","MA","Medfield","2006","Medfield town, MA",219,5654,5873
"4241","Medfield","Norfolk County","MA","Medfield","2007","Medfield town, MA",197,5703,5900
"4242","Medfield","Norfolk County","MA","Medfield","2008","Medfield town, MA",252,5709,5961
"4243","Medfield","Norfolk County","MA","Medfield","2009","Medfield town, MA",376,5517,5893
"4244","Medfield","Norfolk County","MA","Medfield","2010","Medfield town, MA",386,5489,5875
"4245","Medfield","Norfolk County","MA","Medfield","2011","Medfield town, MA",309,5551,5860
"4246","Medfield","Norfolk County","MA","Medfield","2012","Medfield town, MA",298,5612,5910
"4247","Medford","Middlesex County","MA","Medford","1990","Medford city, MA",1724,30306,32030
"4248","Medford","Middlesex County","MA","Medford","1991","Medford city, MA",2365,29279,31644
"4249","Medford","Middlesex County","MA","Medford","1992","Medford city, MA",2406,28760,31166
"4250","Medford","Middlesex County","MA","Medford","1993","Medford city, MA",1853,28711,30564
"4251","Medford","Middlesex County","MA","Medford","1994","Medford city, MA",1649,28827,30476
"4252","Medford","Middlesex County","MA","Medford","1995","Medford city, MA",1485,29411,30896
"4253","Medford","Middlesex County","MA","Medford","1996","Medford city, MA",1226,29860,31086
"4254","Medford","Middlesex County","MA","Medford","1997","Medford city, MA",1127,30526,31653
"4255","Medford","Middlesex County","MA","Medford","1998","Medford city, MA",844,30700,31544
"4256","Medford","Middlesex County","MA","Medford","1999","Medford city, MA",835,30795,31630
"4257","Medford","Middlesex County","MA","Medford","2000","Medford city, MA",736,29882,30618
"4258","Medford","Middlesex County","MA","Medford","2001","Medford city, MA",1032,29659,30691
"4259","Medford","Middlesex County","MA","Medford","2002","Medford city, MA",1503,28812,30315
"4260","Medford","Middlesex County","MA","Medford","2003","Medford city, MA",1676,28206,29882
"4261","Medford","Middlesex County","MA","Medford","2004","Medford city, MA",1452,27974,29426
"4262","Medford","Middlesex County","MA","Medford","2005","Medford city, MA",1291,27984,29275
"4263","Medford","Middlesex County","MA","Medford","2006","Medford city, MA",1317,28808,30125
"4264","Medford","Middlesex County","MA","Medford","2007","Medford city, MA",1220,28908,30128
"4265","Medford","Middlesex County","MA","Medford","2008","Medford city, MA",1464,28800,30264
"4266","Medford","Middlesex County","MA","Medford","2009","Medford city, MA",2287,27729,30016
"4267","Medford","Middlesex County","MA","Medford","2010","Medford city, MA",2259,28446,30705
"4268","Medford","Middlesex County","MA","Medford","2011","Medford city, MA",1858,28856,30714
"4269","Medford","Middlesex County","MA","Medford","2012","Medford city, MA",1738,29172,30910
"4270","Medway","Norfolk County","MA","Medway","1990","Medway town, MA",379,5218,5597
"4271","Medway","Norfolk County","MA","Medway","1991","Medway town, MA",462,5183,5645
"4272","Medway","Norfolk County","MA","Medway","1992","Medway town, MA",478,5254,5732
"4273","Medway","Norfolk County","MA","Medway","1993","Medway town, MA",329,5501,5830
"4274","Medway","Norfolk County","MA","Medway","1994","Medway town, MA",272,5755,6027
"4275","Medway","Norfolk County","MA","Medway","1995","Medway town, MA",252,5789,6041
"4276","Medway","Norfolk County","MA","Medway","1996","Medway town, MA",186,5989,6175
"4277","Medway","Norfolk County","MA","Medway","1997","Medway town, MA",175,6213,6388
"4278","Medway","Norfolk County","MA","Medway","1998","Medway town, MA",148,6401,6549
"4279","Medway","Norfolk County","MA","Medway","1999","Medway town, MA",157,6517,6674
"4280","Medway","Norfolk County","MA","Medway","2000","Medway town, MA",137,6885,7022
"4281","Medway","Norfolk County","MA","Medway","2001","Medway town, MA",207,6942,7149
"4282","Medway","Norfolk County","MA","Medway","2002","Medway town, MA",312,6938,7250
"4283","Medway","Norfolk County","MA","Medway","2003","Medway town, MA",331,6854,7185
"4284","Medway","Norfolk County","MA","Medway","2004","Medway town, MA",258,6843,7101
"4285","Medway","Norfolk County","MA","Medway","2005","Medway town, MA",272,6873,7145
"4286","Medway","Norfolk County","MA","Medway","2006","Medway town, MA",277,6794,7071
"4287","Medway","Norfolk County","MA","Medway","2007","Medway town, MA",244,6838,7082
"4288","Medway","Norfolk County","MA","Medway","2008","Medway town, MA",334,6827,7161
"4289","Medway","Norfolk County","MA","Medway","2009","Medway town, MA",504,6612,7116
"4290","Medway","Norfolk County","MA","Medway","2010","Medway town, MA",487,6626,7113
"4291","Medway","Norfolk County","MA","Medway","2011","Medway town, MA",437,6701,7138
"4292","Medway","Norfolk County","MA","Medway","2012","Medway town, MA",358,6775,7133
"4293","Melrose","Middlesex County","MA","Melrose","1990","Melrose city, MA",720,14789,15509
"4294","Melrose","Middlesex County","MA","Melrose","1991","Melrose city, MA",999,14182,15181
"4295","Melrose","Middlesex County","MA","Melrose","1992","Melrose city, MA",1058,13940,14998
"4296","Melrose","Middlesex County","MA","Melrose","1993","Melrose city, MA",781,13868,14649
"4297","Melrose","Middlesex County","MA","Melrose","1994","Melrose city, MA",654,14025,14679
"4298","Melrose","Middlesex County","MA","Melrose","1995","Melrose city, MA",600,14272,14872
"4299","Melrose","Middlesex County","MA","Melrose","1996","Melrose city, MA",537,14500,15037
"4300","Melrose","Middlesex County","MA","Melrose","1997","Melrose city, MA",485,14836,15321
"4301","Melrose","Middlesex County","MA","Melrose","1998","Melrose city, MA",368,14963,15331
"4302","Melrose","Middlesex County","MA","Melrose","1999","Melrose city, MA",376,15021,15397
"4303","Melrose","Middlesex County","MA","Melrose","2000","Melrose city, MA",330,15170,15500
"4304","Melrose","Middlesex County","MA","Melrose","2001","Melrose city, MA",459,15057,15516
"4305","Melrose","Middlesex County","MA","Melrose","2002","Melrose city, MA",721,14695,15416
"4306","Melrose","Middlesex County","MA","Melrose","2003","Melrose city, MA",749,14394,15143
"4307","Melrose","Middlesex County","MA","Melrose","2004","Melrose city, MA",673,14288,14961
"4308","Melrose","Middlesex County","MA","Melrose","2005","Melrose city, MA",582,14348,14930
"4309","Melrose","Middlesex County","MA","Melrose","2006","Melrose city, MA",557,14322,14879
"4310","Melrose","Middlesex County","MA","Melrose","2007","Melrose city, MA",505,14456,14961
"4311","Melrose","Middlesex County","MA","Melrose","2008","Melrose city, MA",647,14425,15072
"4312","Melrose","Middlesex County","MA","Melrose","2009","Melrose city, MA",1056,14069,15125
"4313","Melrose","Middlesex County","MA","Melrose","2010","Melrose city, MA",987,14223,15210
"4314","Melrose","Middlesex County","MA","Melrose","2011","Melrose city, MA",838,14433,15271
"4315","Melrose","Middlesex County","MA","Melrose","2012","Melrose city, MA",742,14591,15333
"4316","Mendon","Worcester County","MA","Mendon","1990","Mendon town, MA",142,2138,2280
"4317","Mendon","Worcester County","MA","Mendon","1991","Mendon town, MA",202,2141,2343
"4318","Mendon","Worcester County","MA","Mendon","1992","Mendon town, MA",178,2184,2362
"4319","Mendon","Worcester County","MA","Mendon","1993","Mendon town, MA",146,2272,2418
"4320","Mendon","Worcester County","MA","Mendon","1994","Mendon town, MA",127,2369,2496
"4321","Mendon","Worcester County","MA","Mendon","1995","Mendon town, MA",124,2252,2376
"4322","Mendon","Worcester County","MA","Mendon","1996","Mendon town, MA",102,2333,2435
"4323","Mendon","Worcester County","MA","Mendon","1997","Mendon town, MA",86,2462,2548
"4324","Mendon","Worcester County","MA","Mendon","1998","Mendon town, MA",62,2568,2630
"4325","Mendon","Worcester County","MA","Mendon","1999","Mendon town, MA",64,2693,2757
"4326","Mendon","Worcester County","MA","Mendon","2000","Mendon town, MA",67,3020,3087
"4327","Mendon","Worcester County","MA","Mendon","2001","Mendon town, MA",90,3096,3186
"4328","Mendon","Worcester County","MA","Mendon","2002","Mendon town, MA",155,3091,3246
"4329","Mendon","Worcester County","MA","Mendon","2003","Mendon town, MA",150,3093,3243
"4330","Mendon","Worcester County","MA","Mendon","2004","Mendon town, MA",137,3139,3276
"4331","Mendon","Worcester County","MA","Mendon","2005","Mendon town, MA",120,3184,3304
"4332","Mendon","Worcester County","MA","Mendon","2006","Mendon town, MA",123,3210,3333
"4333","Mendon","Worcester County","MA","Mendon","2007","Mendon town, MA",121,3249,3370
"4334","Mendon","Worcester County","MA","Mendon","2008","Mendon town, MA",142,3276,3418
"4335","Mendon","Worcester County","MA","Mendon","2009","Mendon town, MA",215,3089,3304
"4336","Mendon","Worcester County","MA","Mendon","2010","Mendon town, MA",220,3133,3353
"4337","Mendon","Worcester County","MA","Mendon","2011","Mendon town, MA",196,3143,3339
"4338","Mendon","Worcester County","MA","Mendon","2012","Mendon town, MA",173,3172,3345
"4339","Merrimac","Essex County","MA","Merrimac","1990","Merrimac town, MA",191,2696,2887
"4340","Merrimac","Essex County","MA","Merrimac","1991","Merrimac town, MA",262,2665,2927
"4341","Merrimac","Essex County","MA","Merrimac","1992","Merrimac town, MA",246,2781,3027
"4342","Merrimac","Essex County","MA","Merrimac","1993","Merrimac town, MA",211,2863,3074
"4343","Merrimac","Essex County","MA","Merrimac","1994","Merrimac town, MA",201,3020,3221
"4344","Merrimac","Essex County","MA","Merrimac","1995","Merrimac town, MA",172,2947,3119
"4345","Merrimac","Essex County","MA","Merrimac","1996","Merrimac town, MA",134,3068,3202
"4346","Merrimac","Essex County","MA","Merrimac","1997","Merrimac town, MA",133,3149,3282
"4347","Merrimac","Essex County","MA","Merrimac","1998","Merrimac town, MA",113,3274,3387
"4348","Merrimac","Essex County","MA","Merrimac","1999","Merrimac town, MA",102,3408,3510
"4349","Merrimac","Essex County","MA","Merrimac","2000","Merrimac town, MA",79,3478,3557
"4350","Merrimac","Essex County","MA","Merrimac","2001","Merrimac town, MA",121,3466,3587
"4351","Merrimac","Essex County","MA","Merrimac","2002","Merrimac town, MA",193,3381,3574
"4352","Merrimac","Essex County","MA","Merrimac","2003","Merrimac town, MA",181,3309,3490
"4353","Merrimac","Essex County","MA","Merrimac","2004","Merrimac town, MA",163,3277,3440
"4354","Merrimac","Essex County","MA","Merrimac","2005","Merrimac town, MA",146,3325,3471
"4355","Merrimac","Essex County","MA","Merrimac","2006","Merrimac town, MA",136,3373,3509
"4356","Merrimac","Essex County","MA","Merrimac","2007","Merrimac town, MA",134,3395,3529
"4357","Merrimac","Essex County","MA","Merrimac","2008","Merrimac town, MA",168,3387,3555
"4358","Merrimac","Essex County","MA","Merrimac","2009","Merrimac town, MA",266,3329,3595
"4359","Merrimac","Essex County","MA","Merrimac","2010","Merrimac town, MA",267,3271,3538
"4360","Merrimac","Essex County","MA","Merrimac","2011","Merrimac town, MA",221,3314,3535
"4361","Merrimac","Essex County","MA","Merrimac","2012","Merrimac town, MA",211,3357,3568
"4362","Methuen","Essex County","MA","Methuen","1990","Methuen Town city, MA",1498,18572,20070
"4363","Methuen","Essex County","MA","Methuen","1991","Methuen Town city, MA",2122,18270,20392
"4364","Methuen","Essex County","MA","Methuen","1992","Methuen Town city, MA",2205,18521,20726
"4365","Methuen","Essex County","MA","Methuen","1993","Methuen Town city, MA",2069,18805,20874
"4366","Methuen","Essex County","MA","Methuen","1994","Methuen Town city, MA",1870,19079,20949
"4367","Methuen","Essex County","MA","Methuen","1995","Methuen Town city, MA",1511,19322,20833
"4368","Methuen","Essex County","MA","Methuen","1996","Methuen Town city, MA",1348,19875,21223
"4369","Methuen","Essex County","MA","Methuen","1997","Methuen Town city, MA",1254,20168,21422
"4370","Methuen","Essex County","MA","Methuen","1998","Methuen Town city, MA",1085,20652,21737
"4371","Methuen","Essex County","MA","Methuen","1999","Methuen Town city, MA",1072,21148,22220
"4372","Methuen","Essex County","MA","Methuen","2000","Methuen Town city, MA",737,21702,22439
"4373","Methuen","Essex County","MA","Methuen","2001","Methuen Town city, MA",1062,21817,22879
"4374","Methuen","Essex County","MA","Methuen","2002","Methuen Town city, MA",1708,21574,23282
"4375","Methuen","Essex County","MA","Methuen","2003","Methuen Town city, MA",1779,21585,23364
"4376","Methuen","Essex County","MA","Methuen","2004","Methuen Town city, MA",1558,21627,23185
"4377","Methuen","Essex County","MA","Methuen","2005","Methuen Town city, MA",1401,21708,23109
"4378","Methuen","Essex County","MA","Methuen","2006","Methuen Town city, MA",1339,21821,23160
"4379","Methuen","Essex County","MA","Methuen","2007","Methuen Town city, MA",1248,21951,23199
"4380","Methuen","Essex County","MA","Methuen","2008","Methuen Town city, MA",1532,21886,23418
"4381","Methuen","Essex County","MA","Methuen","2009","Methuen Town city, MA",2418,21278,23696
"4382","Methuen","Essex County","MA","Methuen","2010","Methuen Town city, MA",2429,21910,24339
"4383","Methuen","Essex County","MA","Methuen","2011","Methuen Town city, MA",2124,22342,24466
"4384","Methuen","Essex County","MA","Methuen","2012","Methuen Town city, MA",2091,22649,24740
"4385","Middleborough","Plymouth County","MA","Middleborough","1990","Middleborough town, MA",885,8609,9494
"4386","Middleborough","Plymouth County","MA","Middleborough","1991","Middleborough town, MA",1203,8255,9458
"4387","Middleborough","Plymouth County","MA","Middleborough","1992","Middleborough town, MA",1217,8207,9424
"4388","Middleborough","Plymouth County","MA","Middleborough","1993","Middleborough town, MA",1031,8565,9596
"4389","Middleborough","Plymouth County","MA","Middleborough","1994","Middleborough town, MA",792,9099,9891
"4390","Middleborough","Plymouth County","MA","Middleborough","1995","Middleborough town, MA",691,9319,10010
"4391","Middleborough","Plymouth County","MA","Middleborough","1996","Middleborough town, MA",583,9463,10046
"4392","Middleborough","Plymouth County","MA","Middleborough","1997","Middleborough town, MA",580,9816,10396
"4393","Middleborough","Plymouth County","MA","Middleborough","1998","Middleborough town, MA",448,9935,10383
"4394","Middleborough","Plymouth County","MA","Middleborough","1999","Middleborough town, MA",438,10136,10574
"4395","Middleborough","Plymouth County","MA","Middleborough","2000","Middleborough town, MA",331,10721,11052
"4396","Middleborough","Plymouth County","MA","Middleborough","2001","Middleborough town, MA",389,10777,11166
"4397","Middleborough","Plymouth County","MA","Middleborough","2002","Middleborough town, MA",587,10776,11363
"4398","Middleborough","Plymouth County","MA","Middleborough","2003","Middleborough town, MA",651,10621,11272
"4399","Middleborough","Plymouth County","MA","Middleborough","2004","Middleborough town, MA",594,10699,11293
"4400","Middleborough","Plymouth County","MA","Middleborough","2005","Middleborough town, MA",609,10771,11380
"4401","Middleborough","Plymouth County","MA","Middleborough","2006","Middleborough town, MA",652,10967,11619
"4402","Middleborough","Plymouth County","MA","Middleborough","2007","Middleborough town, MA",657,11086,11743
"4403","Middleborough","Plymouth County","MA","Middleborough","2008","Middleborough town, MA",785,10942,11727
"4404","Middleborough","Plymouth County","MA","Middleborough","2009","Middleborough town, MA",1136,10702,11838
"4405","Middleborough","Plymouth County","MA","Middleborough","2010","Middleborough town, MA",1230,11562,12792
"4406","Middleborough","Plymouth County","MA","Middleborough","2011","Middleborough town, MA",1090,11670,12760
"4407","Middleborough","Plymouth County","MA","Middleborough","2012","Middleborough town, MA",938,11773,12711
"4408","Middlefield","Hampshire County","MA","Middlefield","1990","Middlefield town, MA",8,200,208
"4409","Middlefield","Hampshire County","MA","Middlefield","1991","Middlefield town, MA",21,194,215
"4410","Middlefield","Hampshire County","MA","Middlefield","1992","Middlefield town, MA",20,213,233
"4411","Middlefield","Hampshire County","MA","Middlefield","1993","Middlefield town, MA",14,228,242
"4412","Middlefield","Hampshire County","MA","Middlefield","1994","Middlefield town, MA",11,247,258
"4413","Middlefield","Hampshire County","MA","Middlefield","1995","Middlefield town, MA",8,260,268
"4414","Middlefield","Hampshire County","MA","Middlefield","1996","Middlefield town, MA",11,256,267
"4415","Middlefield","Hampshire County","MA","Middlefield","1997","Middlefield town, MA",9,258,267
"4416","Middlefield","Hampshire County","MA","Middlefield","1998","Middlefield town, MA",5,271,276
"4417","Middlefield","Hampshire County","MA","Middlefield","1999","Middlefield town, MA",8,293,301
"4418","Middlefield","Hampshire County","MA","Middlefield","2000","Middlefield town, MA",6,314,320
"4419","Middlefield","Hampshire County","MA","Middlefield","2001","Middlefield town, MA",7,315,322
"4420","Middlefield","Hampshire County","MA","Middlefield","2002","Middlefield town, MA",9,312,321
"4421","Middlefield","Hampshire County","MA","Middlefield","2003","Middlefield town, MA",11,310,321
"4422","Middlefield","Hampshire County","MA","Middlefield","2004","Middlefield town, MA",12,309,321
"4423","Middlefield","Hampshire County","MA","Middlefield","2005","Middlefield town, MA",12,312,324
"4424","Middlefield","Hampshire County","MA","Middlefield","2006","Middlefield town, MA",12,315,327
"4425","Middlefield","Hampshire County","MA","Middlefield","2007","Middlefield town, MA",9,316,325
"4426","Middlefield","Hampshire County","MA","Middlefield","2008","Middlefield town, MA",11,316,327
"4427","Middlefield","Hampshire County","MA","Middlefield","2009","Middlefield town, MA",24,302,326
"4428","Middlefield","Hampshire County","MA","Middlefield","2010","Middlefield town, MA",19,284,303
"4429","Middlefield","Hampshire County","MA","Middlefield","2011","Middlefield town, MA",19,281,300
"4430","Middlefield","Hampshire County","MA","Middlefield","2012","Middlefield town, MA",15,281,296
"4431",NA,"Middlesex County","MA","Middlesex County","1990","Middlesex County, MA",41332,760223,801555
"4432",NA,"Middlesex County","MA","Middlesex County","1991","Middlesex County, MA",56563,733455,790018
"4433",NA,"Middlesex County","MA","Middlesex County","1992","Middlesex County, MA",58947,727818,786765
"4434",NA,"Middlesex County","MA","Middlesex County","1993","Middlesex County, MA",47421,733455,780876
"4435",NA,"Middlesex County","MA","Middlesex County","1994","Middlesex County, MA",40160,744089,784249
"4436",NA,"Middlesex County","MA","Middlesex County","1995","Middlesex County, MA",34657,752160,786817
"4437",NA,"Middlesex County","MA","Middlesex County","1996","Middlesex County, MA",27516,769545,797061
"4438",NA,"Middlesex County","MA","Middlesex County","1997","Middlesex County, MA",24947,792324,817271
"4439",NA,"Middlesex County","MA","Middlesex County","1998","Middlesex County, MA",20679,805836,826515
"4440",NA,"Middlesex County","MA","Middlesex County","1999","Middlesex County, MA",21279,816516,837795
"4441",NA,"Middlesex County","MA","Middlesex County","2000","Middlesex County, MA",18181,803616,821797
"4442",NA,"Middlesex County","MA","Middlesex County","2001","Middlesex County, MA",27298,803298,830596
"4443",NA,"Middlesex County","MA","Middlesex County","2002","Middlesex County, MA",41306,786821,828127
"4444",NA,"Middlesex County","MA","Middlesex County","2003","Middlesex County, MA",43489,773934,817423
"4445",NA,"Middlesex County","MA","Middlesex County","2004","Middlesex County, MA",36384,771860,808244
"4446",NA,"Middlesex County","MA","Middlesex County","2005","Middlesex County, MA",32895,777022,809917
"4447",NA,"Middlesex County","MA","Middlesex County","2006","Middlesex County, MA",32051,780347,812398
"4448",NA,"Middlesex County","MA","Middlesex County","2007","Middlesex County, MA",30027,788302,818329
"4449",NA,"Middlesex County","MA","Middlesex County","2008","Middlesex County, MA",36189,791149,827338
"4450",NA,"Middlesex County","MA","Middlesex County","2009","Middlesex County, MA",57234,769491,826725
"4451",NA,"Middlesex County","MA","Middlesex County","2010","Middlesex County, MA",56430,776213,832643
"4452",NA,"Middlesex County","MA","Middlesex County","2011","Middlesex County, MA",48531,786142,834673
"4453",NA,"Middlesex County","MA","Middlesex County","2012","Middlesex County, MA",44620,794517,839137
"4454","Middleton","Essex County","MA","Middleton","1990","Middleton town, MA",162,2698,2860
"4455","Middleton","Essex County","MA","Middleton","1991","Middleton town, MA",194,2652,2846
"4456","Middleton","Essex County","MA","Middleton","1992","Middleton town, MA",242,2700,2942
"4457","Middleton","Essex County","MA","Middleton","1993","Middleton town, MA",215,2751,2966
"4458","Middleton","Essex County","MA","Middleton","1994","Middleton town, MA",182,2887,3069
"4459","Middleton","Essex County","MA","Middleton","1995","Middleton town, MA",119,2954,3073
"4460","Middleton","Essex County","MA","Middleton","1996","Middleton town, MA",119,3095,3214
"4461","Middleton","Essex County","MA","Middleton","1997","Middleton town, MA",125,3271,3396
"4462","Middleton","Essex County","MA","Middleton","1998","Middleton town, MA",113,3420,3533
"4463","Middleton","Essex County","MA","Middleton","1999","Middleton town, MA",97,3549,3646
"4464","Middleton","Essex County","MA","Middleton","2000","Middleton town, MA",88,3567,3655
"4465","Middleton","Essex County","MA","Middleton","2001","Middleton town, MA",128,3873,4001
"4466","Middleton","Essex County","MA","Middleton","2002","Middleton town, MA",177,3870,4047
"4467","Middleton","Essex County","MA","Middleton","2003","Middleton town, MA",195,3898,4093
"4468","Middleton","Essex County","MA","Middleton","2004","Middleton town, MA",206,3948,4154
"4469","Middleton","Essex County","MA","Middleton","2005","Middleton town, MA",186,4063,4249
"4470","Middleton","Essex County","MA","Middleton","2006","Middleton town, MA",164,3827,3991
"4471","Middleton","Essex County","MA","Middleton","2007","Middleton town, MA",165,3896,4061
"4472","Middleton","Essex County","MA","Middleton","2008","Middleton town, MA",207,3963,4170
"4473","Middleton","Essex County","MA","Middleton","2009","Middleton town, MA",324,3864,4188
"4474","Middleton","Essex County","MA","Middleton","2010","Middleton town, MA",349,3814,4163
"4475","Middleton","Essex County","MA","Middleton","2011","Middleton town, MA",290,3857,4147
"4476","Middleton","Essex County","MA","Middleton","2012","Middleton town, MA",250,3899,4149
"4477","Milford","Worcester County","MA","Milford","1990","Milford town, MA",1006,12910,13916
"4478","Milford","Worcester County","MA","Milford","1991","Milford town, MA",1337,12400,13737
"4479","Milford","Worcester County","MA","Milford","1992","Milford town, MA",1231,12243,13474
"4480","Milford","Worcester County","MA","Milford","1993","Milford town, MA",924,12342,13266
"4481","Milford","Worcester County","MA","Milford","1994","Milford town, MA",815,12588,13403
"4482","Milford","Worcester County","MA","Milford","1995","Milford town, MA",840,12705,13545
"4483","Milford","Worcester County","MA","Milford","1996","Milford town, MA",651,12911,13562
"4484","Milford","Worcester County","MA","Milford","1997","Milford town, MA",625,13269,13894
"4485","Milford","Worcester County","MA","Milford","1998","Milford town, MA",522,13559,14081
"4486","Milford","Worcester County","MA","Milford","1999","Milford town, MA",492,13847,14339
"4487","Milford","Worcester County","MA","Milford","2000","Milford town, MA",378,14409,14787
"4488","Milford","Worcester County","MA","Milford","2001","Milford town, MA",518,14506,15024
"4489","Milford","Worcester County","MA","Milford","2002","Milford town, MA",844,14292,15136
"4490","Milford","Worcester County","MA","Milford","2003","Milford town, MA",918,14105,15023
"4491","Milford","Worcester County","MA","Milford","2004","Milford town, MA",773,14203,14976
"4492","Milford","Worcester County","MA","Milford","2005","Milford town, MA",674,14482,15156
"4493","Milford","Worcester County","MA","Milford","2006","Milford town, MA",679,14567,15246
"4494","Milford","Worcester County","MA","Milford","2007","Milford town, MA",655,14606,15261
"4495","Milford","Worcester County","MA","Milford","2008","Milford town, MA",804,14730,15534
"4496","Milford","Worcester County","MA","Milford","2009","Milford town, MA",1200,14223,15423
"4497","Milford","Worcester County","MA","Milford","2010","Milford town, MA",1190,14288,15478
"4498","Milford","Worcester County","MA","Milford","2011","Milford town, MA",991,14328,15319
"4499","Milford","Worcester County","MA","Milford","2012","Milford town, MA",915,14459,15374
"4500","Millbury","Worcester County","MA","Millbury","1990","Millbury town, MA",461,6315,6776
"4501","Millbury","Worcester County","MA","Millbury","1991","Millbury town, MA",680,6110,6790
"4502","Millbury","Worcester County","MA","Millbury","1992","Millbury town, MA",657,6100,6757
"4503","Millbury","Worcester County","MA","Millbury","1993","Millbury town, MA",494,6299,6793
"4504","Millbury","Worcester County","MA","Millbury","1994","Millbury town, MA",347,6358,6705
"4505","Millbury","Worcester County","MA","Millbury","1995","Millbury town, MA",345,6361,6706
"4506","Millbury","Worcester County","MA","Millbury","1996","Millbury town, MA",292,6429,6721
"4507","Millbury","Worcester County","MA","Millbury","1997","Millbury town, MA",271,6570,6841
"4508","Millbury","Worcester County","MA","Millbury","1998","Millbury town, MA",216,6653,6869
"4509","Millbury","Worcester County","MA","Millbury","1999","Millbury town, MA",225,6623,6848
"4510","Millbury","Worcester County","MA","Millbury","2000","Millbury town, MA",174,7054,7228
"4511","Millbury","Worcester County","MA","Millbury","2001","Millbury town, MA",262,7108,7370
"4512","Millbury","Worcester County","MA","Millbury","2002","Millbury town, MA",368,7074,7442
"4513","Millbury","Worcester County","MA","Millbury","2003","Millbury town, MA",398,7079,7477
"4514","Millbury","Worcester County","MA","Millbury","2004","Millbury town, MA",359,7104,7463
"4515","Millbury","Worcester County","MA","Millbury","2005","Millbury town, MA",349,7127,7476
"4516","Millbury","Worcester County","MA","Millbury","2006","Millbury town, MA",349,7226,7575
"4517","Millbury","Worcester County","MA","Millbury","2007","Millbury town, MA",346,7217,7563
"4518","Millbury","Worcester County","MA","Millbury","2008","Millbury town, MA",417,7060,7477
"4519","Millbury","Worcester County","MA","Millbury","2009","Millbury town, MA",628,6859,7487
"4520","Millbury","Worcester County","MA","Millbury","2010","Millbury town, MA",619,6722,7341
"4521","Millbury","Worcester County","MA","Millbury","2011","Millbury town, MA",564,6782,7346
"4522","Millbury","Worcester County","MA","Millbury","2012","Millbury town, MA",502,6779,7281
"4523","Millis","Norfolk County","MA","Millis","1990","Millis town, MA",244,4274,4518
"4524","Millis","Norfolk County","MA","Millis","1991","Millis town, MA",318,4223,4541
"4525","Millis","Norfolk County","MA","Millis","1992","Millis town, MA",299,4248,4547
"4526","Millis","Norfolk County","MA","Millis","1993","Millis town, MA",244,4301,4545
"4527","Millis","Norfolk County","MA","Millis","1994","Millis town, MA",212,4394,4606
"4528","Millis","Norfolk County","MA","Millis","1995","Millis town, MA",190,4386,4576
"4529","Millis","Norfolk County","MA","Millis","1996","Millis town, MA",163,4509,4672
"4530","Millis","Norfolk County","MA","Millis","1997","Millis town, MA",127,4666,4793
"4531","Millis","Norfolk County","MA","Millis","1998","Millis town, MA",120,4729,4849
"4532","Millis","Norfolk County","MA","Millis","1999","Millis town, MA",124,4762,4886
"4533","Millis","Norfolk County","MA","Millis","2000","Millis town, MA",99,4425,4524
"4534","Millis","Norfolk County","MA","Millis","2001","Millis town, MA",137,4438,4575
"4535","Millis","Norfolk County","MA","Millis","2002","Millis town, MA",207,4370,4577
"4536","Millis","Norfolk County","MA","Millis","2003","Millis town, MA",240,4316,4556
"4537","Millis","Norfolk County","MA","Millis","2004","Millis town, MA",197,4306,4503
"4538","Millis","Norfolk County","MA","Millis","2005","Millis town, MA",180,4333,4513
"4539","Millis","Norfolk County","MA","Millis","2006","Millis town, MA",184,4273,4457
"4540","Millis","Norfolk County","MA","Millis","2007","Millis town, MA",186,4302,4488
"4541","Millis","Norfolk County","MA","Millis","2008","Millis town, MA",219,4315,4534
"4542","Millis","Norfolk County","MA","Millis","2009","Millis town, MA",336,4168,4504
"4543","Millis","Norfolk County","MA","Millis","2010","Millis town, MA",329,4158,4487
"4544","Millis","Norfolk County","MA","Millis","2011","Millis town, MA",288,4204,4492
"4545","Millis","Norfolk County","MA","Millis","2012","Millis town, MA",259,4250,4509
"4546","Millville","Worcester County","MA","Millville","1990","Millville town, MA",88,1172,1260
"4547","Millville","Worcester County","MA","Millville","1991","Millville town, MA",126,1145,1271
"4548","Millville","Worcester County","MA","Millville","1992","Millville town, MA",120,1210,1330
"4549","Millville","Worcester County","MA","Millville","1993","Millville town, MA",125,1251,1376
"4550","Millville","Worcester County","MA","Millville","1994","Millville town, MA",70,1307,1377
"4551","Millville","Worcester County","MA","Millville","1995","Millville town, MA",95,1235,1330
"4552","Millville","Worcester County","MA","Millville","1996","Millville town, MA",78,1271,1349
"4553","Millville","Worcester County","MA","Millville","1997","Millville town, MA",66,1322,1388
"4554","Millville","Worcester County","MA","Millville","1998","Millville town, MA",58,1369,1427
"4555","Millville","Worcester County","MA","Millville","1999","Millville town, MA",53,1400,1453
"4556","Millville","Worcester County","MA","Millville","2000","Millville town, MA",49,1467,1516
"4557","Millville","Worcester County","MA","Millville","2001","Millville town, MA",68,1476,1544
"4558","Millville","Worcester County","MA","Millville","2002","Millville town, MA",108,1515,1623
"4559","Millville","Worcester County","MA","Millville","2003","Millville town, MA",103,1552,1655
"4560","Millville","Worcester County","MA","Millville","2004","Millville town, MA",86,1562,1648
"4561","Millville","Worcester County","MA","Millville","2005","Millville town, MA",79,1577,1656
"4562","Millville","Worcester County","MA","Millville","2006","Millville town, MA",93,1598,1691
"4563","Millville","Worcester County","MA","Millville","2007","Millville town, MA",84,1537,1621
"4564","Millville","Worcester County","MA","Millville","2008","Millville town, MA",105,1521,1626
"4565","Millville","Worcester County","MA","Millville","2009","Millville town, MA",181,1508,1689
"4566","Millville","Worcester County","MA","Millville","2010","Millville town, MA",200,1621,1821
"4567","Millville","Worcester County","MA","Millville","2011","Millville town, MA",166,1635,1801
"4568","Millville","Worcester County","MA","Millville","2012","Millville town, MA",161,1638,1799
"4569","Milton","Norfolk County","MA","Milton","1990","Milton town, MA",508,12720,13228
"4570","Milton","Norfolk County","MA","Milton","1991","Milton town, MA",697,12260,12957
"4571","Milton","Norfolk County","MA","Milton","1992","Milton town, MA",670,12247,12917
"4572","Milton","Norfolk County","MA","Milton","1993","Milton town, MA",653,12535,13188
"4573","Milton","Norfolk County","MA","Milton","1994","Milton town, MA",529,12501,13030
"4574","Milton","Norfolk County","MA","Milton","1995","Milton town, MA",488,12627,13115
"4575","Milton","Norfolk County","MA","Milton","1996","Milton town, MA",402,12832,13234
"4576","Milton","Norfolk County","MA","Milton","1997","Milton town, MA",327,13095,13422
"4577","Milton","Norfolk County","MA","Milton","1998","Milton town, MA",284,13260,13544
"4578","Milton","Norfolk County","MA","Milton","1999","Milton town, MA",268,13288,13556
"4579","Milton","Norfolk County","MA","Milton","2000","Milton town, MA",301,13460,13761
"4580","Milton","Norfolk County","MA","Milton","2001","Milton town, MA",370,13384,13754
"4581","Milton","Norfolk County","MA","Milton","2002","Milton town, MA",571,13105,13676
"4582","Milton","Norfolk County","MA","Milton","2003","Milton town, MA",603,12845,13448
"4583","Milton","Norfolk County","MA","Milton","2004","Milton town, MA",562,12862,13424
"4584","Milton","Norfolk County","MA","Milton","2005","Milton town, MA",522,13084,13606
"4585","Milton","Norfolk County","MA","Milton","2006","Milton town, MA",558,13190,13748
"4586","Milton","Norfolk County","MA","Milton","2007","Milton town, MA",492,13144,13636
"4587","Milton","Norfolk County","MA","Milton","2008","Milton town, MA",588,13054,13642
"4588","Milton","Norfolk County","MA","Milton","2009","Milton town, MA",950,12559,13509
"4589","Milton","Norfolk County","MA","Milton","2010","Milton town, MA",934,13145,14079
"4590","Milton","Norfolk County","MA","Milton","2011","Milton town, MA",774,13288,14062
"4591","Milton","Norfolk County","MA","Milton","2012","Milton town, MA",712,13434,14146
"4592","Monroe","Franklin County","MA","Monroe","1990","Monroe town, MA",3,67,70
"4593","Monroe","Franklin County","MA","Monroe","1991","Monroe town, MA",4,68,72
"4594","Monroe","Franklin County","MA","Monroe","1992","Monroe town, MA",9,69,78
"4595","Monroe","Franklin County","MA","Monroe","1993","Monroe town, MA",7,59,66
"4596","Monroe","Franklin County","MA","Monroe","1994","Monroe town, MA",6,48,54
"4597","Monroe","Franklin County","MA","Monroe","1995","Monroe town, MA",3,68,71
"4598","Monroe","Franklin County","MA","Monroe","1996","Monroe town, MA",3,68,71
"4599","Monroe","Franklin County","MA","Monroe","1997","Monroe town, MA",4,68,72
"4600","Monroe","Franklin County","MA","Monroe","1998","Monroe town, MA",3,70,73
"4601","Monroe","Franklin County","MA","Monroe","1999","Monroe town, MA",5,72,77
"4602","Monroe","Franklin County","MA","Monroe","2000","Monroe town, MA",3,22,25
"4603","Monroe","Franklin County","MA","Monroe","2001","Monroe town, MA",3,23,26
"4604","Monroe","Franklin County","MA","Monroe","2002","Monroe town, MA",3,23,26
"4605","Monroe","Franklin County","MA","Monroe","2003","Monroe town, MA",4,23,27
"4606","Monroe","Franklin County","MA","Monroe","2004","Monroe town, MA",3,23,26
"4607","Monroe","Franklin County","MA","Monroe","2005","Monroe town, MA",2,24,26
"4608","Monroe","Franklin County","MA","Monroe","2006","Monroe town, MA",2,24,26
"4609","Monroe","Franklin County","MA","Monroe","2007","Monroe town, MA",3,24,27
"4610","Monroe","Franklin County","MA","Monroe","2008","Monroe town, MA",2,24,26
"4611","Monroe","Franklin County","MA","Monroe","2009","Monroe town, MA",4,22,26
"4612","Monroe","Franklin County","MA","Monroe","2010","Monroe town, MA",5,28,33
"4613","Monroe","Franklin County","MA","Monroe","2011","Monroe town, MA",3,28,31
"4614","Monroe","Franklin County","MA","Monroe","2012","Monroe town, MA",6,28,34
"4615","Monson","Hampden County","MA","Monson","1990","Monson town, MA",245,3623,3868
"4616","Monson","Hampden County","MA","Monson","1991","Monson town, MA",320,3557,3877
"4617","Monson","Hampden County","MA","Monson","1992","Monson town, MA",328,3615,3943
"4618","Monson","Hampden County","MA","Monson","1993","Monson town, MA",363,3673,4036
"4619","Monson","Hampden County","MA","Monson","1994","Monson town, MA",300,3692,3992
"4620","Monson","Hampden County","MA","Monson","1995","Monson town, MA",258,3569,3827
"4621","Monson","Hampden County","MA","Monson","1996","Monson town, MA",168,3629,3797
"4622","Monson","Hampden County","MA","Monson","1997","Monson town, MA",166,3727,3893
"4623","Monson","Hampden County","MA","Monson","1998","Monson town, MA",137,3777,3914
"4624","Monson","Hampden County","MA","Monson","1999","Monson town, MA",144,3819,3963
"4625","Monson","Hampden County","MA","Monson","2000","Monson town, MA",123,4338,4461
"4626","Monson","Hampden County","MA","Monson","2001","Monson town, MA",170,4375,4545
"4627","Monson","Hampden County","MA","Monson","2002","Monson town, MA",242,4388,4630
"4628","Monson","Hampden County","MA","Monson","2003","Monson town, MA",268,4377,4645
"4629","Monson","Hampden County","MA","Monson","2004","Monson town, MA",247,4408,4655
"4630","Monson","Hampden County","MA","Monson","2005","Monson town, MA",223,4466,4689
"4631","Monson","Hampden County","MA","Monson","2006","Monson town, MA",241,4511,4752
"4632","Monson","Hampden County","MA","Monson","2007","Monson town, MA",226,4521,4747
"4633","Monson","Hampden County","MA","Monson","2008","Monson town, MA",270,4565,4835
"4634","Monson","Hampden County","MA","Monson","2009","Monson town, MA",389,4408,4797
"4635","Monson","Hampden County","MA","Monson","2010","Monson town, MA",410,4176,4586
"4636","Monson","Hampden County","MA","Monson","2011","Monson town, MA",357,4135,4492
"4637","Monson","Hampden County","MA","Monson","2012","Monson town, MA",323,4137,4460
"4638","Montague","Franklin County","MA","Montague","1990","Montague town, MA",206,4018,4224
"4639","Montague","Franklin County","MA","Montague","1991","Montague town, MA",343,3970,4313
"4640","Montague","Franklin County","MA","Montague","1992","Montague town, MA",416,3923,4339
"4641","Montague","Franklin County","MA","Montague","1993","Montague town, MA",300,3908,4208
"4642","Montague","Franklin County","MA","Montague","1994","Montague town, MA",257,4040,4297
"4643","Montague","Franklin County","MA","Montague","1995","Montague town, MA",285,4073,4358
"4644","Montague","Franklin County","MA","Montague","1996","Montague town, MA",209,4083,4292
"4645","Montague","Franklin County","MA","Montague","1997","Montague town, MA",194,4166,4360
"4646","Montague","Franklin County","MA","Montague","1998","Montague town, MA",166,4261,4427
"4647","Montague","Franklin County","MA","Montague","1999","Montague town, MA",146,4334,4480
"4648","Montague","Franklin County","MA","Montague","2000","Montague town, MA",126,4235,4361
"4649","Montague","Franklin County","MA","Montague","2001","Montague town, MA",151,4212,4363
"4650","Montague","Franklin County","MA","Montague","2002","Montague town, MA",207,4260,4467
"4651","Montague","Franklin County","MA","Montague","2003","Montague town, MA",217,4254,4471
"4652","Montague","Franklin County","MA","Montague","2004","Montague town, MA",208,4175,4383
"4653","Montague","Franklin County","MA","Montague","2005","Montague town, MA",217,4150,4367
"4654","Montague","Franklin County","MA","Montague","2006","Montague town, MA",218,4153,4371
"4655","Montague","Franklin County","MA","Montague","2007","Montague town, MA",215,4112,4327
"4656","Montague","Franklin County","MA","Montague","2008","Montague town, MA",243,4039,4282
"4657","Montague","Franklin County","MA","Montague","2009","Montague town, MA",381,3857,4238
"4658","Montague","Franklin County","MA","Montague","2010","Montague town, MA",399,4053,4452
"4659","Montague","Franklin County","MA","Montague","2011","Montague town, MA",362,4060,4422
"4660","Montague","Franklin County","MA","Montague","2012","Montague town, MA",333,4071,4404
"4661","Monterey","Berkshire County","MA","Monterey","1990","Monterey town, MA",14,390,404
"4662","Monterey","Berkshire County","MA","Monterey","1991","Monterey town, MA",27,382,409
"4663","Monterey","Berkshire County","MA","Monterey","1992","Monterey town, MA",17,380,397
"4664","Monterey","Berkshire County","MA","Monterey","1993","Monterey town, MA",17,392,409
"4665","Monterey","Berkshire County","MA","Monterey","1994","Monterey town, MA",23,393,416
"4666","Monterey","Berkshire County","MA","Monterey","1995","Monterey town, MA",29,416,445
"4667","Monterey","Berkshire County","MA","Monterey","1996","Monterey town, MA",17,425,442
"4668","Monterey","Berkshire County","MA","Monterey","1997","Monterey town, MA",12,438,450
"4669","Monterey","Berkshire County","MA","Monterey","1998","Monterey town, MA",9,423,432
"4670","Monterey","Berkshire County","MA","Monterey","1999","Monterey town, MA",8,422,430
"4671","Monterey","Berkshire County","MA","Monterey","2000","Monterey town, MA",13,529,542
"4672","Monterey","Berkshire County","MA","Monterey","2001","Monterey town, MA",13,549,562
"4673","Monterey","Berkshire County","MA","Monterey","2002","Monterey town, MA",17,569,586
"4674","Monterey","Berkshire County","MA","Monterey","2003","Monterey town, MA",19,574,593
"4675","Monterey","Berkshire County","MA","Monterey","2004","Monterey town, MA",15,573,588
"4676","Monterey","Berkshire County","MA","Monterey","2005","Monterey town, MA",18,587,605
"4677","Monterey","Berkshire County","MA","Monterey","2006","Monterey town, MA",17,593,610
"4678","Monterey","Berkshire County","MA","Monterey","2007","Monterey town, MA",15,584,599
"4679","Monterey","Berkshire County","MA","Monterey","2008","Monterey town, MA",20,580,600
"4680","Monterey","Berkshire County","MA","Monterey","2009","Monterey town, MA",28,569,597
"4681","Monterey","Berkshire County","MA","Monterey","2010","Monterey town, MA",22,574,596
"4682","Monterey","Berkshire County","MA","Monterey","2011","Monterey town, MA",24,578,602
"4683","Monterey","Berkshire County","MA","Monterey","2012","Monterey town, MA",22,574,596
"4684","Montgomery","Hampden County","MA","Montgomery","1990","Montgomery town, MA",11,414,425
"4685","Montgomery","Hampden County","MA","Montgomery","1991","Montgomery town, MA",24,412,436
"4686","Montgomery","Hampden County","MA","Montgomery","1992","Montgomery town, MA",20,407,427
"4687","Montgomery","Hampden County","MA","Montgomery","1993","Montgomery town, MA",14,407,421
"4688","Montgomery","Hampden County","MA","Montgomery","1994","Montgomery town, MA",21,432,453
"4689","Montgomery","Hampden County","MA","Montgomery","1995","Montgomery town, MA",19,408,427
"4690","Montgomery","Hampden County","MA","Montgomery","1996","Montgomery town, MA",12,421,433
"4691","Montgomery","Hampden County","MA","Montgomery","1997","Montgomery town, MA",22,439,461
"4692","Montgomery","Hampden County","MA","Montgomery","1998","Montgomery town, MA",30,398,428
"4693","Montgomery","Hampden County","MA","Montgomery","1999","Montgomery town, MA",13,411,424
"4694","Montgomery","Hampden County","MA","Montgomery","2000","Montgomery town, MA",9,383,392
"4695","Montgomery","Hampden County","MA","Montgomery","2001","Montgomery town, MA",12,398,410
"4696","Montgomery","Hampden County","MA","Montgomery","2002","Montgomery town, MA",14,409,423
"4697","Montgomery","Hampden County","MA","Montgomery","2003","Montgomery town, MA",20,415,435
"4698","Montgomery","Hampden County","MA","Montgomery","2004","Montgomery town, MA",18,420,438
"4699","Montgomery","Hampden County","MA","Montgomery","2005","Montgomery town, MA",18,426,444
"4700","Montgomery","Hampden County","MA","Montgomery","2006","Montgomery town, MA",23,434,457
"4701","Montgomery","Hampden County","MA","Montgomery","2007","Montgomery town, MA",18,436,454
"4702","Montgomery","Hampden County","MA","Montgomery","2008","Montgomery town, MA",14,411,425
"4703","Montgomery","Hampden County","MA","Montgomery","2009","Montgomery town, MA",31,397,428
"4704","Montgomery","Hampden County","MA","Montgomery","2010","Montgomery town, MA",37,459,496
"4705","Montgomery","Hampden County","MA","Montgomery","2011","Montgomery town, MA",29,454,483
"4706","Montgomery","Hampden County","MA","Montgomery","2012","Montgomery town, MA",28,454,482
"4707","Mount Washington","Berkshire County","MA","Mount Washington","1990","Mount Washington town, MA",5,66,71
"4708","Mount Washington","Berkshire County","MA","Mount Washington","1991","Mount Washington town, MA",4,60,64
"4709","Mount Washington","Berkshire County","MA","Mount Washington","1992","Mount Washington town, MA",1,64,65
"4710","Mount Washington","Berkshire County","MA","Mount Washington","1993","Mount Washington town, MA",1,75,76
"4711","Mount Washington","Berkshire County","MA","Mount Washington","1994","Mount Washington town, MA",1,82,83
"4712","Mount Washington","Berkshire County","MA","Mount Washington","1995","Mount Washington town, MA",3,71,74
"4713","Mount Washington","Berkshire County","MA","Mount Washington","1996","Mount Washington town, MA",1,72,73
"4714","Mount Washington","Berkshire County","MA","Mount Washington","1997","Mount Washington town, MA",2,73,75
"4715","Mount Washington","Berkshire County","MA","Mount Washington","1998","Mount Washington town, MA",1,74,75
"4716","Mount Washington","Berkshire County","MA","Mount Washington","1999","Mount Washington town, MA",3,73,76
"4717","Mount Washington","Berkshire County","MA","Mount Washington","2000","Mount Washington town, MA",2,86,88
"4718","Mount Washington","Berkshire County","MA","Mount Washington","2001","Mount Washington town, MA",2,89,91
"4719","Mount Washington","Berkshire County","MA","Mount Washington","2002","Mount Washington town, MA",3,92,95
"4720","Mount Washington","Berkshire County","MA","Mount Washington","2003","Mount Washington town, MA",4,93,97
"4721","Mount Washington","Berkshire County","MA","Mount Washington","2004","Mount Washington town, MA",2,94,96
"4722","Mount Washington","Berkshire County","MA","Mount Washington","2005","Mount Washington town, MA",4,97,101
"4723","Mount Washington","Berkshire County","MA","Mount Washington","2006","Mount Washington town, MA",2,100,102
"4724","Mount Washington","Berkshire County","MA","Mount Washington","2007","Mount Washington town, MA",1,98,99
"4725","Mount Washington","Berkshire County","MA","Mount Washington","2008","Mount Washington town, MA",1,98,99
"4726","Mount Washington","Berkshire County","MA","Mount Washington","2009","Mount Washington town, MA",3,94,97
"4727","Mount Washington","Berkshire County","MA","Mount Washington","2010","Mount Washington town, MA",4,117,121
"4728","Mount Washington","Berkshire County","MA","Mount Washington","2011","Mount Washington town, MA",4,117,121
"4729","Mount Washington","Berkshire County","MA","Mount Washington","2012","Mount Washington town, MA",3,116,119
"4730","Nahant","Essex County","MA","Nahant","1990","Nahant town, MA",92,2005,2097
"4731","Nahant","Essex County","MA","Nahant","1991","Nahant town, MA",149,1921,2070
"4732","Nahant","Essex County","MA","Nahant","1992","Nahant town, MA",144,1891,2035
"4733","Nahant","Essex County","MA","Nahant","1993","Nahant town, MA",140,1907,2047
"4734","Nahant","Essex County","MA","Nahant","1994","Nahant town, MA",110,1924,2034
"4735","Nahant","Essex County","MA","Nahant","1995","Nahant town, MA",84,1963,2047
"4736","Nahant","Essex County","MA","Nahant","1996","Nahant town, MA",93,1995,2088
"4737","Nahant","Essex County","MA","Nahant","1997","Nahant town, MA",76,2040,2116
"4738","Nahant","Essex County","MA","Nahant","1998","Nahant town, MA",59,2057,2116
"4739","Nahant","Essex County","MA","Nahant","1999","Nahant town, MA",61,2069,2130
"4740","Nahant","Essex County","MA","Nahant","2000","Nahant town, MA",43,1993,2036
"4741","Nahant","Essex County","MA","Nahant","2001","Nahant town, MA",67,1992,2059
"4742","Nahant","Essex County","MA","Nahant","2002","Nahant town, MA",108,1964,2072
"4743","Nahant","Essex County","MA","Nahant","2003","Nahant town, MA",108,1937,2045
"4744","Nahant","Essex County","MA","Nahant","2004","Nahant town, MA",88,1916,2004
"4745","Nahant","Essex County","MA","Nahant","2005","Nahant town, MA",81,1905,1986
"4746","Nahant","Essex County","MA","Nahant","2006","Nahant town, MA",88,1908,1996
"4747","Nahant","Essex County","MA","Nahant","2007","Nahant town, MA",87,1896,1983
"4748","Nahant","Essex County","MA","Nahant","2008","Nahant town, MA",94,1887,1981
"4749","Nahant","Essex County","MA","Nahant","2009","Nahant town, MA",142,1899,2041
"4750","Nahant","Essex County","MA","Nahant","2010","Nahant town, MA",135,1788,1923
"4751","Nahant","Essex County","MA","Nahant","2011","Nahant town, MA",137,1809,1946
"4752","Nahant","Essex County","MA","Nahant","2012","Nahant town, MA",112,1823,1935
"4753","Nantucket","Nantucket County","MA","Nantucket","1990","Nantucket County/town, MA",153,4606,4759
"4754","Nantucket","Nantucket County","MA","Nantucket","1991","Nantucket County/town, MA",269,4588,4857
"4755","Nantucket","Nantucket County","MA","Nantucket","1992","Nantucket County/town, MA",235,4721,4956
"4756","Nantucket","Nantucket County","MA","Nantucket","1993","Nantucket County/town, MA",207,5093,5300
"4757","Nantucket","Nantucket County","MA","Nantucket","1994","Nantucket County/town, MA",152,5409,5561
"4758","Nantucket","Nantucket County","MA","Nantucket","1995","Nantucket County/town, MA",151,5540,5691
"4759","Nantucket","Nantucket County","MA","Nantucket","1996","Nantucket County/town, MA",139,5685,5824
"4760","Nantucket","Nantucket County","MA","Nantucket","1997","Nantucket County/town, MA",141,5957,6098
"4761","Nantucket","Nantucket County","MA","Nantucket","1998","Nantucket County/town, MA",113,6355,6468
"4762","Nantucket","Nantucket County","MA","Nantucket","1999","Nantucket County/town, MA",115,6489,6604
"4763","Nantucket","Nantucket County","MA","Nantucket","2000","Nantucket County/town, MA",108,7181,7289
"4764","Nantucket","Nantucket County","MA","Nantucket","2001","Nantucket County/town, MA",116,7002,7118
"4765","Nantucket","Nantucket County","MA","Nantucket","2002","Nantucket County/town, MA",145,7324,7469
"4766","Nantucket","Nantucket County","MA","Nantucket","2003","Nantucket County/town, MA",195,7496,7691
"4767","Nantucket","Nantucket County","MA","Nantucket","2004","Nantucket County/town, MA",197,7643,7840
"4768","Nantucket","Nantucket County","MA","Nantucket","2005","Nantucket County/town, MA",198,7940,8138
"4769","Nantucket","Nantucket County","MA","Nantucket","2006","Nantucket County/town, MA",194,8218,8412
"4770","Nantucket","Nantucket County","MA","Nantucket","2007","Nantucket County/town, MA",199,8343,8542
"4771","Nantucket","Nantucket County","MA","Nantucket","2008","Nantucket County/town, MA",277,8153,8430
"4772","Nantucket","Nantucket County","MA","Nantucket","2009","Nantucket County/town, MA",530,7278,7808
"4773","Nantucket","Nantucket County","MA","Nantucket","2010","Nantucket County/town, MA",586,7228,7814
"4774","Nantucket","Nantucket County","MA","Nantucket","2011","Nantucket County/town, MA",526,7304,7830
"4775","Nantucket","Nantucket County","MA","Nantucket","2012","Nantucket County/town, MA",487,7695,8182
"4776","Natick","Middlesex County","MA","Natick","1990","Natick town, MA",819,17659,18478
"4777","Natick","Middlesex County","MA","Natick","1991","Natick town, MA",1112,17033,18145
"4778","Natick","Middlesex County","MA","Natick","1992","Natick town, MA",1106,16942,18048
"4779","Natick","Middlesex County","MA","Natick","1993","Natick town, MA",853,17255,18108
"4780","Natick","Middlesex County","MA","Natick","1994","Natick town, MA",727,17504,18231
"4781","Natick","Middlesex County","MA","Natick","1995","Natick town, MA",675,17896,18571
"4782","Natick","Middlesex County","MA","Natick","1996","Natick town, MA",537,18250,18787
"4783","Natick","Middlesex County","MA","Natick","1997","Natick town, MA",497,18721,19218
"4784","Natick","Middlesex County","MA","Natick","1998","Natick town, MA",370,19039,19409
"4785","Natick","Middlesex County","MA","Natick","1999","Natick town, MA",383,19208,19591
"4786","Natick","Middlesex County","MA","Natick","2000","Natick town, MA",356,18500,18856
"4787","Natick","Middlesex County","MA","Natick","2001","Natick town, MA",515,18491,19006
"4788","Natick","Middlesex County","MA","Natick","2002","Natick town, MA",771,18058,18829
"4789","Natick","Middlesex County","MA","Natick","2003","Natick town, MA",837,17720,18557
"4790","Natick","Middlesex County","MA","Natick","2004","Natick town, MA",691,17768,18459
"4791","Natick","Middlesex County","MA","Natick","2005","Natick town, MA",621,17953,18574
"4792","Natick","Middlesex County","MA","Natick","2006","Natick town, MA",646,18023,18669
"4793","Natick","Middlesex County","MA","Natick","2007","Natick town, MA",575,18295,18870
"4794","Natick","Middlesex County","MA","Natick","2008","Natick town, MA",692,18407,19099
"4795","Natick","Middlesex County","MA","Natick","2009","Natick town, MA",1097,17804,18901
"4796","Natick","Middlesex County","MA","Natick","2010","Natick town, MA",1082,17988,19070
"4797","Natick","Middlesex County","MA","Natick","2011","Natick town, MA",898,18163,19061
"4798","Natick","Middlesex County","MA","Natick","2012","Natick town, MA",830,18329,19159
"4799","Needham","Norfolk County","MA","Needham","1990","Needham town, MA",536,14039,14575
"4800","Needham","Norfolk County","MA","Needham","1991","Needham town, MA",691,13497,14188
"4801","Needham","Norfolk County","MA","Needham","1992","Needham town, MA",694,13553,14247
"4802","Needham","Norfolk County","MA","Needham","1993","Needham town, MA",558,13802,14360
"4803","Needham","Norfolk County","MA","Needham","1994","Needham town, MA",513,14043,14556
"4804","Needham","Norfolk County","MA","Needham","1995","Needham town, MA",477,14018,14495
"4805","Needham","Norfolk County","MA","Needham","1996","Needham town, MA",325,14283,14608
"4806","Needham","Norfolk County","MA","Needham","1997","Needham town, MA",285,14637,14922
"4807","Needham","Norfolk County","MA","Needham","1998","Needham town, MA",251,14811,15062
"4808","Needham","Norfolk County","MA","Needham","1999","Needham town, MA",240,14899,15139
"4809","Needham","Norfolk County","MA","Needham","2000","Needham town, MA",284,14120,14404
"4810","Needham","Norfolk County","MA","Needham","2001","Needham town, MA",396,14114,14510
"4811","Needham","Norfolk County","MA","Needham","2002","Needham town, MA",597,13891,14488
"4812","Needham","Norfolk County","MA","Needham","2003","Needham town, MA",619,13673,14292
"4813","Needham","Norfolk County","MA","Needham","2004","Needham town, MA",537,13639,14176
"4814","Needham","Norfolk County","MA","Needham","2005","Needham town, MA",484,13697,14181
"4815","Needham","Norfolk County","MA","Needham","2006","Needham town, MA",465,13632,14097
"4816","Needham","Norfolk County","MA","Needham","2007","Needham town, MA",432,13726,14158
"4817","Needham","Norfolk County","MA","Needham","2008","Needham town, MA",530,13777,14307
"4818","Needham","Norfolk County","MA","Needham","2009","Needham town, MA",855,13348,14203
"4819","Needham","Norfolk County","MA","Needham","2010","Needham town, MA",790,13486,14276
"4820","Needham","Norfolk County","MA","Needham","2011","Needham town, MA",689,13636,14325
"4821","Needham","Norfolk County","MA","Needham","2012","Needham town, MA",638,13786,14424
"4822","New Ashford","Berkshire County","MA","New Ashford","1990","New Ashford town, MA",5,116,121
"4823","New Ashford","Berkshire County","MA","New Ashford","1991","New Ashford town, MA",9,109,118
"4824","New Ashford","Berkshire County","MA","New Ashford","1992","New Ashford town, MA",11,113,124
"4825","New Ashford","Berkshire County","MA","New Ashford","1993","New Ashford town, MA",9,111,120
"4826","New Ashford","Berkshire County","MA","New Ashford","1994","New Ashford town, MA",12,111,123
"4827","New Ashford","Berkshire County","MA","New Ashford","1995","New Ashford town, MA",4,111,115
"4828","New Ashford","Berkshire County","MA","New Ashford","1996","New Ashford town, MA",4,111,115
"4829","New Ashford","Berkshire County","MA","New Ashford","1997","New Ashford town, MA",6,115,121
"4830","New Ashford","Berkshire County","MA","New Ashford","1998","New Ashford town, MA",7,120,127
"4831","New Ashford","Berkshire County","MA","New Ashford","1999","New Ashford town, MA",4,126,130
"4832","New Ashford","Berkshire County","MA","New Ashford","2000","New Ashford town, MA",7,147,154
"4833","New Ashford","Berkshire County","MA","New Ashford","2001","New Ashford town, MA",5,148,153
"4834","New Ashford","Berkshire County","MA","New Ashford","2002","New Ashford town, MA",7,150,157
"4835","New Ashford","Berkshire County","MA","New Ashford","2003","New Ashford town, MA",7,148,155
"4836","New Ashford","Berkshire County","MA","New Ashford","2004","New Ashford town, MA",6,148,154
"4837","New Ashford","Berkshire County","MA","New Ashford","2005","New Ashford town, MA",7,152,159
"4838","New Ashford","Berkshire County","MA","New Ashford","2006","New Ashford town, MA",6,156,162
"4839","New Ashford","Berkshire County","MA","New Ashford","2007","New Ashford town, MA",6,157,163
"4840","New Ashford","Berkshire County","MA","New Ashford","2008","New Ashford town, MA",6,155,161
"4841","New Ashford","Berkshire County","MA","New Ashford","2009","New Ashford town, MA",7,151,158
"4842","New Ashford","Berkshire County","MA","New Ashford","2010","New Ashford town, MA",6,133,139
"4843","New Ashford","Berkshire County","MA","New Ashford","2011","New Ashford town, MA",8,136,144
"4844","New Ashford","Berkshire County","MA","New Ashford","2012","New Ashford town, MA",7,135,142
"4845","New Bedford","Bristol County","MA","New Bedford","1990","New Bedford city, MA",5669,39663,45332
"4846","New Bedford","Bristol County","MA","New Bedford","1991","New Bedford city, MA",7278,37870,45148
"4847","New Bedford","Bristol County","MA","New Bedford","1992","New Bedford city, MA",6718,37225,43943
"4848","New Bedford","Bristol County","MA","New Bedford","1993","New Bedford city, MA",5878,37664,43542
"4849","New Bedford","Bristol County","MA","New Bedford","1994","New Bedford city, MA",5664,37847,43511
"4850","New Bedford","Bristol County","MA","New Bedford","1995","New Bedford city, MA",5314,38114,43428
"4851","New Bedford","Bristol County","MA","New Bedford","1996","New Bedford city, MA",4709,37641,42350
"4852","New Bedford","Bristol County","MA","New Bedford","1997","New Bedford city, MA",4040,38419,42459
"4853","New Bedford","Bristol County","MA","New Bedford","1998","New Bedford city, MA",3507,37871,41378
"4854","New Bedford","Bristol County","MA","New Bedford","1999","New Bedford city, MA",3191,37947,41138
"4855","New Bedford","Bristol County","MA","New Bedford","2000","New Bedford city, MA",2306,39621,41927
"4856","New Bedford","Bristol County","MA","New Bedford","2001","New Bedford city, MA",2838,39116,41954
"4857","New Bedford","Bristol County","MA","New Bedford","2002","New Bedford city, MA",3644,39243,42887
"4858","New Bedford","Bristol County","MA","New Bedford","2003","New Bedford city, MA",4012,38297,42309
"4859","New Bedford","Bristol County","MA","New Bedford","2004","New Bedford city, MA",3618,38425,42043
"4860","New Bedford","Bristol County","MA","New Bedford","2005","New Bedford city, MA",3466,38692,42158
"4861","New Bedford","Bristol County","MA","New Bedford","2006","New Bedford city, MA",3374,39122,42496
"4862","New Bedford","Bristol County","MA","New Bedford","2007","New Bedford city, MA",3250,38939,42189
"4863","New Bedford","Bristol County","MA","New Bedford","2008","New Bedford city, MA",3965,37718,41683
"4864","New Bedford","Bristol County","MA","New Bedford","2009","New Bedford city, MA",5837,36552,42389
"4865","New Bedford","Bristol County","MA","New Bedford","2010","New Bedford city, MA",6126,37630,43756
"4866","New Bedford","Bristol County","MA","New Bedford","2011","New Bedford city, MA",5592,38020,43612
"4867","New Bedford","Bristol County","MA","New Bedford","2012","New Bedford city, MA",5492,38469,43961
"4868","New Braintree","Worcester County","MA","New Braintree","1990","New Braintree town, MA",31,433,464
"4869","New Braintree","Worcester County","MA","New Braintree","1991","New Braintree town, MA",45,419,464
"4870","New Braintree","Worcester County","MA","New Braintree","1992","New Braintree town, MA",39,424,463
"4871","New Braintree","Worcester County","MA","New Braintree","1993","New Braintree town, MA",23,450,473
"4872","New Braintree","Worcester County","MA","New Braintree","1994","New Braintree town, MA",23,449,472
"4873","New Braintree","Worcester County","MA","New Braintree","1995","New Braintree town, MA",22,429,451
"4874","New Braintree","Worcester County","MA","New Braintree","1996","New Braintree town, MA",19,425,444
"4875","New Braintree","Worcester County","MA","New Braintree","1997","New Braintree town, MA",22,437,459
"4876","New Braintree","Worcester County","MA","New Braintree","1998","New Braintree town, MA",20,444,464
"4877","New Braintree","Worcester County","MA","New Braintree","1999","New Braintree town, MA",14,449,463
"4878","New Braintree","Worcester County","MA","New Braintree","2000","New Braintree town, MA",13,527,540
"4879","New Braintree","Worcester County","MA","New Braintree","2001","New Braintree town, MA",14,542,556
"4880","New Braintree","Worcester County","MA","New Braintree","2002","New Braintree town, MA",25,552,577
"4881","New Braintree","Worcester County","MA","New Braintree","2003","New Braintree town, MA",29,568,597
"4882","New Braintree","Worcester County","MA","New Braintree","2004","New Braintree town, MA",27,581,608
"4883","New Braintree","Worcester County","MA","New Braintree","2005","New Braintree town, MA",36,594,630
"4884","New Braintree","Worcester County","MA","New Braintree","2006","New Braintree town, MA",36,603,639
"4885","New Braintree","Worcester County","MA","New Braintree","2007","New Braintree town, MA",36,613,649
"4886","New Braintree","Worcester County","MA","New Braintree","2008","New Braintree town, MA",35,604,639
"4887","New Braintree","Worcester County","MA","New Braintree","2009","New Braintree town, MA",54,589,643
"4888","New Braintree","Worcester County","MA","New Braintree","2010","New Braintree town, MA",56,520,576
"4889","New Braintree","Worcester County","MA","New Braintree","2011","New Braintree town, MA",41,524,565
"4890","New Braintree","Worcester County","MA","New Braintree","2012","New Braintree town, MA",42,523,565
"4891","New Marlborough","Berkshire County","MA","New Marlborough","1990","New Marlborough town, MA",8,592,600
"4892","New Marlborough","Berkshire County","MA","New Marlborough","1991","New Marlborough town, MA",14,583,597
"4893","New Marlborough","Berkshire County","MA","New Marlborough","1992","New Marlborough town, MA",20,565,585
"4894","New Marlborough","Berkshire County","MA","New Marlborough","1993","New Marlborough town, MA",16,596,612
"4895","New Marlborough","Berkshire County","MA","New Marlborough","1994","New Marlborough town, MA",18,578,596
"4896","New Marlborough","Berkshire County","MA","New Marlborough","1995","New Marlborough town, MA",18,649,667
"4897","New Marlborough","Berkshire County","MA","New Marlborough","1996","New Marlborough town, MA",14,665,679
"4898","New Marlborough","Berkshire County","MA","New Marlborough","1997","New Marlborough town, MA",11,681,692
"4899","New Marlborough","Berkshire County","MA","New Marlborough","1998","New Marlborough town, MA",10,676,686
"4900","New Marlborough","Berkshire County","MA","New Marlborough","1999","New Marlborough town, MA",12,671,683
"4901","New Marlborough","Berkshire County","MA","New Marlborough","2000","New Marlborough town, MA",17,805,822
"4902","New Marlborough","Berkshire County","MA","New Marlborough","2001","New Marlborough town, MA",22,839,861
"4903","New Marlborough","Berkshire County","MA","New Marlborough","2002","New Marlborough town, MA",30,860,890
"4904","New Marlborough","Berkshire County","MA","New Marlborough","2003","New Marlborough town, MA",30,861,891
"4905","New Marlborough","Berkshire County","MA","New Marlborough","2004","New Marlborough town, MA",27,866,893
"4906","New Marlborough","Berkshire County","MA","New Marlborough","2005","New Marlborough town, MA",29,890,919
"4907","New Marlborough","Berkshire County","MA","New Marlborough","2006","New Marlborough town, MA",29,901,930
"4908","New Marlborough","Berkshire County","MA","New Marlborough","2007","New Marlborough town, MA",30,883,913
"4909","New Marlborough","Berkshire County","MA","New Marlborough","2008","New Marlborough town, MA",38,877,915
"4910","New Marlborough","Berkshire County","MA","New Marlborough","2009","New Marlborough town, MA",55,852,907
"4911","New Marlborough","Berkshire County","MA","New Marlborough","2010","New Marlborough town, MA",62,861,923
"4912","New Marlborough","Berkshire County","MA","New Marlborough","2011","New Marlborough town, MA",46,865,911
"4913","New Marlborough","Berkshire County","MA","New Marlborough","2012","New Marlborough town, MA",50,858,908
"4914","New Salem","Franklin County","MA","New Salem","1990","New Salem town, MA",24,426,450
"4915","New Salem","Franklin County","MA","New Salem","1991","New Salem town, MA",37,417,454
"4916","New Salem","Franklin County","MA","New Salem","1992","New Salem town, MA",30,390,420
"4917","New Salem","Franklin County","MA","New Salem","1993","New Salem town, MA",19,386,405
"4918","New Salem","Franklin County","MA","New Salem","1994","New Salem town, MA",37,387,424
"4919","New Salem","Franklin County","MA","New Salem","1995","New Salem town, MA",34,407,441
"4920","New Salem","Franklin County","MA","New Salem","1996","New Salem town, MA",20,404,424
"4921","New Salem","Franklin County","MA","New Salem","1997","New Salem town, MA",17,410,427
"4922","New Salem","Franklin County","MA","New Salem","1998","New Salem town, MA",18,407,425
"4923","New Salem","Franklin County","MA","New Salem","1999","New Salem town, MA",18,403,421
"4924","New Salem","Franklin County","MA","New Salem","2000","New Salem town, MA",13,546,559
"4925","New Salem","Franklin County","MA","New Salem","2001","New Salem town, MA",15,540,555
"4926","New Salem","Franklin County","MA","New Salem","2002","New Salem town, MA",19,548,567
"4927","New Salem","Franklin County","MA","New Salem","2003","New Salem town, MA",24,546,570
"4928","New Salem","Franklin County","MA","New Salem","2004","New Salem town, MA",17,543,560
"4929","New Salem","Franklin County","MA","New Salem","2005","New Salem town, MA",29,538,567
"4930","New Salem","Franklin County","MA","New Salem","2006","New Salem town, MA",23,531,554
"4931","New Salem","Franklin County","MA","New Salem","2007","New Salem town, MA",22,534,556
"4932","New Salem","Franklin County","MA","New Salem","2008","New Salem town, MA",28,539,567
"4933","New Salem","Franklin County","MA","New Salem","2009","New Salem town, MA",43,498,541
"4934","New Salem","Franklin County","MA","New Salem","2010","New Salem town, MA",40,511,551
"4935","New Salem","Franklin County","MA","New Salem","2011","New Salem town, MA",36,511,547
"4936","New Salem","Franklin County","MA","New Salem","2012","New Salem town, MA",33,512,545
"4937","Newbury","Essex County","MA","Newbury","1990","Newbury town, MA",152,2966,3118
"4938","Newbury","Essex County","MA","Newbury","1991","Newbury town, MA",212,2930,3142
"4939","Newbury","Essex County","MA","Newbury","1992","Newbury town, MA",208,3025,3233
"4940","Newbury","Essex County","MA","Newbury","1993","Newbury town, MA",191,3141,3332
"4941","Newbury","Essex County","MA","Newbury","1994","Newbury town, MA",172,3283,3455
"4942","Newbury","Essex County","MA","Newbury","1995","Newbury town, MA",133,3074,3207
"4943","Newbury","Essex County","MA","Newbury","1996","Newbury town, MA",105,3159,3264
"4944","Newbury","Essex County","MA","Newbury","1997","Newbury town, MA",105,3272,3377
"4945","Newbury","Essex County","MA","Newbury","1998","Newbury town, MA",102,3357,3459
"4946","Newbury","Essex County","MA","Newbury","1999","Newbury town, MA",93,3405,3498
"4947","Newbury","Essex County","MA","Newbury","2000","Newbury town, MA",83,3673,3756
"4948","Newbury","Essex County","MA","Newbury","2001","Newbury town, MA",118,3699,3817
"4949","Newbury","Essex County","MA","Newbury","2002","Newbury town, MA",166,3663,3829
"4950","Newbury","Essex County","MA","Newbury","2003","Newbury town, MA",191,3611,3802
"4951","Newbury","Essex County","MA","Newbury","2004","Newbury town, MA",176,3611,3787
"4952","Newbury","Essex County","MA","Newbury","2005","Newbury town, MA",156,3714,3870
"4953","Newbury","Essex County","MA","Newbury","2006","Newbury town, MA",147,3548,3695
"4954","Newbury","Essex County","MA","Newbury","2007","Newbury town, MA",134,3580,3714
"4955","Newbury","Essex County","MA","Newbury","2008","Newbury town, MA",180,3594,3774
"4956","Newbury","Essex County","MA","Newbury","2009","Newbury town, MA",259,3498,3757
"4957","Newbury","Essex County","MA","Newbury","2010","Newbury town, MA",269,3425,3694
"4958","Newbury","Essex County","MA","Newbury","2011","Newbury town, MA",243,3467,3710
"4959","Newbury","Essex County","MA","Newbury","2012","Newbury town, MA",227,3505,3732
"4960","Newburyport","Essex County","MA","Newburyport","1990","Newburyport city, MA",577,8914,9491
"4961","Newburyport","Essex County","MA","Newburyport","1991","Newburyport city, MA",694,8613,9307
"4962","Newburyport","Essex County","MA","Newburyport","1992","Newburyport city, MA",693,8617,9310
"4963","Newburyport","Essex County","MA","Newburyport","1993","Newburyport city, MA",577,8735,9312
"4964","Newburyport","Essex County","MA","Newburyport","1994","Newburyport city, MA",483,8962,9445
"4965","Newburyport","Essex County","MA","Newburyport","1995","Newburyport city, MA",425,8852,9277
"4966","Newburyport","Essex County","MA","Newburyport","1996","Newburyport city, MA",346,9044,9390
"4967","Newburyport","Essex County","MA","Newburyport","1997","Newburyport city, MA",300,9325,9625
"4968","Newburyport","Essex County","MA","Newburyport","1998","Newburyport city, MA",245,9501,9746
"4969","Newburyport","Essex County","MA","Newburyport","1999","Newburyport city, MA",257,9613,9870
"4970","Newburyport","Essex County","MA","Newburyport","2000","Newburyport city, MA",220,9663,9883
"4971","Newburyport","Essex County","MA","Newburyport","2001","Newburyport city, MA",334,9696,10030
"4972","Newburyport","Essex County","MA","Newburyport","2002","Newburyport city, MA",511,9632,10143
"4973","Newburyport","Essex County","MA","Newburyport","2003","Newburyport city, MA",548,9485,10033
"4974","Newburyport","Essex County","MA","Newburyport","2004","Newburyport city, MA",440,9472,9912
"4975","Newburyport","Essex County","MA","Newburyport","2005","Newburyport city, MA",393,9504,9897
"4976","Newburyport","Essex County","MA","Newburyport","2006","Newburyport city, MA",386,9371,9757
"4977","Newburyport","Essex County","MA","Newburyport","2007","Newburyport city, MA",344,9418,9762
"4978","Newburyport","Essex County","MA","Newburyport","2008","Newburyport city, MA",412,9450,9862
"4979","Newburyport","Essex County","MA","Newburyport","2009","Newburyport city, MA",655,9162,9817
"4980","Newburyport","Essex County","MA","Newburyport","2010","Newburyport city, MA",695,9206,9901
"4981","Newburyport","Essex County","MA","Newburyport","2011","Newburyport city, MA",579,9318,9897
"4982","Newburyport","Essex County","MA","Newburyport","2012","Newburyport city, MA",520,9421,9941
"4983","Newton","Middlesex County","MA","Newton","1990","Newton city, MA",1659,46233,47892
"4984","Newton","Middlesex County","MA","Newton","1991","Newton city, MA",2203,45051,47254
"4985","Newton","Middlesex County","MA","Newton","1992","Newton city, MA",2386,45104,47490
"4986","Newton","Middlesex County","MA","Newton","1993","Newton city, MA",1853,45766,47619
"4987","Newton","Middlesex County","MA","Newton","1994","Newton city, MA",1596,46858,48454
"4988","Newton","Middlesex County","MA","Newton","1995","Newton city, MA",1501,44470,45971
"4989","Newton","Middlesex County","MA","Newton","1996","Newton city, MA",1062,45204,46266
"4990","Newton","Middlesex County","MA","Newton","1997","Newton city, MA",1096,46301,47397
"4991","Newton","Middlesex County","MA","Newton","1998","Newton city, MA",824,46812,47636
"4992","Newton","Middlesex County","MA","Newton","1999","Newton city, MA",813,47091,47904
"4993","Newton","Middlesex County","MA","Newton","2000","Newton city, MA",857,46486,47343
"4994","Newton","Middlesex County","MA","Newton","2001","Newton city, MA",1290,46216,47506
"4995","Newton","Middlesex County","MA","Newton","2002","Newton city, MA",1859,45283,47142
"4996","Newton","Middlesex County","MA","Newton","2003","Newton city, MA",1912,44923,46835
"4997","Newton","Middlesex County","MA","Newton","2004","Newton city, MA",1621,44738,46359
"4998","Newton","Middlesex County","MA","Newton","2005","Newton city, MA",1559,44861,46420
"4999","Newton","Middlesex County","MA","Newton","2006","Newton city, MA",1497,44221,45718
"5000","Newton","Middlesex County","MA","Newton","2007","Newton city, MA",1366,44712,46078
"5001","Newton","Middlesex County","MA","Newton","2008","Newton city, MA",1653,44751,46404
"5002","Newton","Middlesex County","MA","Newton","2009","Newton city, MA",2563,43547,46110
"5003","Newton","Middlesex County","MA","Newton","2010","Newton city, MA",2593,44490,47083
"5004","Newton","Middlesex County","MA","Newton","2011","Newton city, MA",2199,45100,47299
"5005","Newton","Middlesex County","MA","Newton","2012","Newton city, MA",2023,45594,47617
"5006","Norfolk","Norfolk County","MA","Norfolk","1990","Norfolk town, MA",224,3977,4201
"5007","Norfolk","Norfolk County","MA","Norfolk","1991","Norfolk town, MA",283,3994,4277
"5008","Norfolk","Norfolk County","MA","Norfolk","1992","Norfolk town, MA",320,4061,4381
"5009","Norfolk","Norfolk County","MA","Norfolk","1993","Norfolk town, MA",220,4200,4420
"5010","Norfolk","Norfolk County","MA","Norfolk","1994","Norfolk town, MA",221,4348,4569
"5011","Norfolk","Norfolk County","MA","Norfolk","1995","Norfolk town, MA",194,4348,4542
"5012","Norfolk","Norfolk County","MA","Norfolk","1996","Norfolk town, MA",150,4452,4602
"5013","Norfolk","Norfolk County","MA","Norfolk","1997","Norfolk town, MA",145,4589,4734
"5014","Norfolk","Norfolk County","MA","Norfolk","1998","Norfolk town, MA",118,4777,4895
"5015","Norfolk","Norfolk County","MA","Norfolk","1999","Norfolk town, MA",115,4835,4950
"5016","Norfolk","Norfolk County","MA","Norfolk","2000","Norfolk town, MA",121,4584,4705
"5017","Norfolk","Norfolk County","MA","Norfolk","2001","Norfolk town, MA",141,4535,4676
"5018","Norfolk","Norfolk County","MA","Norfolk","2002","Norfolk town, MA",232,4441,4673
"5019","Norfolk","Norfolk County","MA","Norfolk","2003","Norfolk town, MA",243,4402,4645
"5020","Norfolk","Norfolk County","MA","Norfolk","2004","Norfolk town, MA",239,4419,4658
"5021","Norfolk","Norfolk County","MA","Norfolk","2005","Norfolk town, MA",198,4464,4662
"5022","Norfolk","Norfolk County","MA","Norfolk","2006","Norfolk town, MA",210,4570,4780
"5023","Norfolk","Norfolk County","MA","Norfolk","2007","Norfolk town, MA",195,4642,4837
"5024","Norfolk","Norfolk County","MA","Norfolk","2008","Norfolk town, MA",235,4697,4932
"5025","Norfolk","Norfolk County","MA","Norfolk","2009","Norfolk town, MA",379,4541,4920
"5026","Norfolk","Norfolk County","MA","Norfolk","2010","Norfolk town, MA",385,4627,5012
"5027","Norfolk","Norfolk County","MA","Norfolk","2011","Norfolk town, MA",324,4674,4998
"5028","Norfolk","Norfolk County","MA","Norfolk","2012","Norfolk town, MA",289,4725,5014
"5029",NA,"Norfolk County","MA","Norfolk County","1990","Norfolk County, MA",17712,326817,344529
"5030",NA,"Norfolk County","MA","Norfolk County","1991","Norfolk County, MA",24868,317154,342022
"5031",NA,"Norfolk County","MA","Norfolk County","1992","Norfolk County, MA",25228,316698,341926
"5032",NA,"Norfolk County","MA","Norfolk County","1993","Norfolk County, MA",20408,321416,341824
"5033",NA,"Norfolk County","MA","Norfolk County","1994","Norfolk County, MA",17415,327949,345364
"5034",NA,"Norfolk County","MA","Norfolk County","1995","Norfolk County, MA",15697,337160,352857
"5035",NA,"Norfolk County","MA","Norfolk County","1996","Norfolk County, MA",12784,344369,357153
"5036",NA,"Norfolk County","MA","Norfolk County","1997","Norfolk County, MA",11443,349054,360497
"5037",NA,"Norfolk County","MA","Norfolk County","1998","Norfolk County, MA",9174,354608,363782
"5038",NA,"Norfolk County","MA","Norfolk County","1999","Norfolk County, MA",8869,357802,366671
"5039",NA,"Norfolk County","MA","Norfolk County","2000","Norfolk County, MA",8358,348783,357141
"5040",NA,"Norfolk County","MA","Norfolk County","2001","Norfolk County, MA",11332,348311,359643
"5041",NA,"Norfolk County","MA","Norfolk County","2002","Norfolk County, MA",16710,343231,359941
"5042",NA,"Norfolk County","MA","Norfolk County","2003","Norfolk County, MA",18256,338109,356365
"5043",NA,"Norfolk County","MA","Norfolk County","2004","Norfolk County, MA",16191,338057,354248
"5044",NA,"Norfolk County","MA","Norfolk County","2005","Norfolk County, MA",14738,341067,355805
"5045",NA,"Norfolk County","MA","Norfolk County","2006","Norfolk County, MA",14683,337854,352537
"5046",NA,"Norfolk County","MA","Norfolk County","2007","Norfolk County, MA",13857,341241,355098
"5047",NA,"Norfolk County","MA","Norfolk County","2008","Norfolk County, MA",16950,341866,358816
"5048",NA,"Norfolk County","MA","Norfolk County","2009","Norfolk County, MA",26323,331719,358042
"5049",NA,"Norfolk County","MA","Norfolk County","2010","Norfolk County, MA",26535,338840,365375
"5050",NA,"Norfolk County","MA","Norfolk County","2011","Norfolk County, MA",22667,342649,365316
"5051",NA,"Norfolk County","MA","Norfolk County","2012","Norfolk County, MA",20543,346268,366811
"5052","North Adams","Berkshire County","MA","North Adams","1990","North Adams city, MA",978,7356,8334
"5053","North Adams","Berkshire County","MA","North Adams","1991","North Adams city, MA",1223,7044,8267
"5054","North Adams","Berkshire County","MA","North Adams","1992","North Adams city, MA",1088,6766,7854
"5055","North Adams","Berkshire County","MA","North Adams","1993","North Adams city, MA",775,7033,7808
"5056","North Adams","Berkshire County","MA","North Adams","1994","North Adams city, MA",656,7046,7702
"5057","North Adams","Berkshire County","MA","North Adams","1995","North Adams city, MA",546,6938,7484
"5058","North Adams","Berkshire County","MA","North Adams","1996","North Adams city, MA",477,7021,7498
"5059","North Adams","Berkshire County","MA","North Adams","1997","North Adams city, MA",419,7054,7473
"5060","North Adams","Berkshire County","MA","North Adams","1998","North Adams city, MA",327,7154,7481
"5061","North Adams","Berkshire County","MA","North Adams","1999","North Adams city, MA",306,7183,7489
"5062","North Adams","Berkshire County","MA","North Adams","2000","North Adams city, MA",249,6955,7204
"5063","North Adams","Berkshire County","MA","North Adams","2001","North Adams city, MA",314,6968,7282
"5064","North Adams","Berkshire County","MA","North Adams","2002","North Adams city, MA",428,6916,7344
"5065","North Adams","Berkshire County","MA","North Adams","2003","North Adams city, MA",464,6806,7270
"5066","North Adams","Berkshire County","MA","North Adams","2004","North Adams city, MA",441,6733,7174
"5067","North Adams","Berkshire County","MA","North Adams","2005","North Adams city, MA",391,6715,7106
"5068","North Adams","Berkshire County","MA","North Adams","2006","North Adams city, MA",401,6733,7134
"5069","North Adams","Berkshire County","MA","North Adams","2007","North Adams city, MA",424,6717,7141
"5070","North Adams","Berkshire County","MA","North Adams","2008","North Adams city, MA",485,6771,7256
"5071","North Adams","Berkshire County","MA","North Adams","2009","North Adams city, MA",688,6680,7368
"5072","North Adams","Berkshire County","MA","North Adams","2010","North Adams city, MA",742,6513,7255
"5073","North Adams","Berkshire County","MA","North Adams","2011","North Adams city, MA",678,6505,7183
"5074","North Adams","Berkshire County","MA","North Adams","2012","North Adams city, MA",570,6419,6989
"5075","North Andover","Essex County","MA","North Andover","1990","North Andover town, MA",583,11283,11866
"5076","North Andover","Essex County","MA","North Andover","1991","North Andover town, MA",847,11259,12106
"5077","North Andover","Essex County","MA","North Andover","1992","North Andover town, MA",896,11511,12407
"5078","North Andover","Essex County","MA","North Andover","1993","North Andover town, MA",751,11822,12573
"5079","North Andover","Essex County","MA","North Andover","1994","North Andover town, MA",682,12181,12863
"5080","North Andover","Essex County","MA","North Andover","1995","North Andover town, MA",588,11941,12529
"5081","North Andover","Essex County","MA","North Andover","1996","North Andover town, MA",504,12540,13044
"5082","North Andover","Essex County","MA","North Andover","1997","North Andover town, MA",521,12818,13339
"5083","North Andover","Essex County","MA","North Andover","1998","North Andover town, MA",406,14194,14600
"5084","North Andover","Essex County","MA","North Andover","1999","North Andover town, MA",432,14520,14952
"5085","North Andover","Essex County","MA","North Andover","2000","North Andover town, MA",309,13397,13706
"5086","North Andover","Essex County","MA","North Andover","2001","North Andover town, MA",461,13354,13815
"5087","North Andover","Essex County","MA","North Andover","2002","North Andover town, MA",700,13024,13724
"5088","North Andover","Essex County","MA","North Andover","2003","North Andover town, MA",707,12735,13442
"5089","North Andover","Essex County","MA","North Andover","2004","North Andover town, MA",592,12625,13217
"5090","North Andover","Essex County","MA","North Andover","2005","North Andover town, MA",562,12682,13244
"5091","North Andover","Essex County","MA","North Andover","2006","North Andover town, MA",547,12818,13365
"5092","North Andover","Essex County","MA","North Andover","2007","North Andover town, MA",523,13045,13568
"5093","North Andover","Essex County","MA","North Andover","2008","North Andover town, MA",622,12800,13422
"5094","North Andover","Essex County","MA","North Andover","2009","North Andover town, MA",1033,12485,13518
"5095","North Andover","Essex County","MA","North Andover","2010","North Andover town, MA",1016,13071,14087
"5096","North Andover","Essex County","MA","North Andover","2011","North Andover town, MA",832,13237,14069
"5097","North Andover","Essex County","MA","North Andover","2012","North Andover town, MA",808,13411,14219
"5098","North Attleborough","Bristol County","MA","North Attleborough","1990","North Attleborough town, MA",863,13870,14733
"5099","North Attleborough","Bristol County","MA","North Attleborough","1991","North Attleborough town, MA",1340,13385,14725
"5100","North Attleborough","Bristol County","MA","North Attleborough","1992","North Attleborough town, MA",1401,13619,15020
"5101","North Attleborough","Bristol County","MA","North Attleborough","1993","North Attleborough town, MA",1000,14120,15120
"5102","North Attleborough","Bristol County","MA","North Attleborough","1994","North Attleborough town, MA",884,14504,15388
"5103","North Attleborough","Bristol County","MA","North Attleborough","1995","North Attleborough town, MA",811,14097,14908
"5104","North Attleborough","Bristol County","MA","North Attleborough","1996","North Attleborough town, MA",678,14244,14922
"5105","North Attleborough","Bristol County","MA","North Attleborough","1997","North Attleborough town, MA",667,14587,15254
"5106","North Attleborough","Bristol County","MA","North Attleborough","1998","North Attleborough town, MA",486,14762,15248
"5107","North Attleborough","Bristol County","MA","North Attleborough","1999","North Attleborough town, MA",451,14948,15399
"5108","North Attleborough","Bristol County","MA","North Attleborough","2000","North Attleborough town, MA",458,15419,15877
"5109","North Attleborough","Bristol County","MA","North Attleborough","2001","North Attleborough town, MA",625,15358,15983
"5110","North Attleborough","Bristol County","MA","North Attleborough","2002","North Attleborough town, MA",837,15579,16416
"5111","North Attleborough","Bristol County","MA","North Attleborough","2003","North Attleborough town, MA",859,15765,16624
"5112","North Attleborough","Bristol County","MA","North Attleborough","2004","North Attleborough town, MA",802,15840,16642
"5113","North Attleborough","Bristol County","MA","North Attleborough","2005","North Attleborough town, MA",722,15927,16649
"5114","North Attleborough","Bristol County","MA","North Attleborough","2006","North Attleborough town, MA",720,15986,16706
"5115","North Attleborough","Bristol County","MA","North Attleborough","2007","North Attleborough town, MA",706,16005,16711
"5116","North Attleborough","Bristol County","MA","North Attleborough","2008","North Attleborough town, MA",956,15702,16658
"5117","North Attleborough","Bristol County","MA","North Attleborough","2009","North Attleborough town, MA",1635,14984,16619
"5118","North Attleborough","Bristol County","MA","North Attleborough","2010","North Attleborough town, MA",1555,15415,16970
"5119","North Attleborough","Bristol County","MA","North Attleborough","2011","North Attleborough town, MA",1426,15527,16953
"5120","North Attleborough","Bristol County","MA","North Attleborough","2012","North Attleborough town, MA",1292,15552,16844
"5121","North Brookfield","Worcester County","MA","North Brookfield","1990","North Brookfield town, MA",156,2345,2501
"5122","North Brookfield","Worcester County","MA","North Brookfield","1991","North Brookfield town, MA",220,2313,2533
"5123","North Brookfield","Worcester County","MA","North Brookfield","1992","North Brookfield town, MA",228,2305,2533
"5124","North Brookfield","Worcester County","MA","North Brookfield","1993","North Brookfield town, MA",173,2362,2535
"5125","North Brookfield","Worcester County","MA","North Brookfield","1994","North Brookfield town, MA",111,2372,2483
"5126","North Brookfield","Worcester County","MA","North Brookfield","1995","North Brookfield town, MA",101,2372,2473
"5127","North Brookfield","Worcester County","MA","North Brookfield","1996","North Brookfield town, MA",96,2405,2501
"5128","North Brookfield","Worcester County","MA","North Brookfield","1997","North Brookfield town, MA",82,2459,2541
"5129","North Brookfield","Worcester County","MA","North Brookfield","1998","North Brookfield town, MA",75,2504,2579
"5130","North Brookfield","Worcester County","MA","North Brookfield","1999","North Brookfield town, MA",77,2492,2569
"5131","North Brookfield","Worcester County","MA","North Brookfield","2000","North Brookfield town, MA",64,2396,2460
"5132","North Brookfield","Worcester County","MA","North Brookfield","2001","North Brookfield town, MA",88,2402,2490
"5133","North Brookfield","Worcester County","MA","North Brookfield","2002","North Brookfield town, MA",111,2390,2501
"5134","North Brookfield","Worcester County","MA","North Brookfield","2003","North Brookfield town, MA",136,2384,2520
"5135","North Brookfield","Worcester County","MA","North Brookfield","2004","North Brookfield town, MA",144,2375,2519
"5136","North Brookfield","Worcester County","MA","North Brookfield","2005","North Brookfield town, MA",118,2367,2485
"5137","North Brookfield","Worcester County","MA","North Brookfield","2006","North Brookfield town, MA",134,2477,2611
"5138","North Brookfield","Worcester County","MA","North Brookfield","2007","North Brookfield town, MA",124,2490,2614
"5139","North Brookfield","Worcester County","MA","North Brookfield","2008","North Brookfield town, MA",158,2439,2597
"5140","North Brookfield","Worcester County","MA","North Brookfield","2009","North Brookfield town, MA",225,2373,2598
"5141","North Brookfield","Worcester County","MA","North Brookfield","2010","North Brookfield town, MA",211,2203,2414
"5142","North Brookfield","Worcester County","MA","North Brookfield","2011","North Brookfield town, MA",188,2222,2410
"5143","North Brookfield","Worcester County","MA","North Brookfield","2012","North Brookfield town, MA",180,2221,2401
"5144","North Reading","Middlesex County","MA","North Reading","1990","North Reading town, MA",403,6607,7010
"5145","North Reading","Middlesex County","MA","North Reading","1991","North Reading town, MA",527,6443,6970
"5146","North Reading","Middlesex County","MA","North Reading","1992","North Reading town, MA",546,6478,7024
"5147","North Reading","Middlesex County","MA","North Reading","1993","North Reading town, MA",410,6694,7104
"5148","North Reading","Middlesex County","MA","North Reading","1994","North Reading town, MA",360,6918,7278
"5149","North Reading","Middlesex County","MA","North Reading","1995","North Reading town, MA",327,6900,7227
"5150","North Reading","Middlesex County","MA","North Reading","1996","North Reading town, MA",248,7138,7386
"5151","North Reading","Middlesex County","MA","North Reading","1997","North Reading town, MA",212,7389,7601
"5152","North Reading","Middlesex County","MA","North Reading","1998","North Reading town, MA",193,7537,7730
"5153","North Reading","Middlesex County","MA","North Reading","1999","North Reading town, MA",198,7679,7877
"5154","North Reading","Middlesex County","MA","North Reading","2000","North Reading town, MA",169,7723,7892
"5155","North Reading","Middlesex County","MA","North Reading","2001","North Reading town, MA",236,7727,7963
"5156","North Reading","Middlesex County","MA","North Reading","2002","North Reading town, MA",358,7593,7951
"5157","North Reading","Middlesex County","MA","North Reading","2003","North Reading town, MA",397,7499,7896
"5158","North Reading","Middlesex County","MA","North Reading","2004","North Reading town, MA",337,7501,7838
"5159","North Reading","Middlesex County","MA","North Reading","2005","North Reading town, MA",309,7563,7872
"5160","North Reading","Middlesex County","MA","North Reading","2006","North Reading town, MA",292,6720,7012
"5161","North Reading","Middlesex County","MA","North Reading","2007","North Reading town, MA",260,6630,6890
"5162","North Reading","Middlesex County","MA","North Reading","2008","North Reading town, MA",365,7758,8123
"5163","North Reading","Middlesex County","MA","North Reading","2009","North Reading town, MA",587,7491,8078
"5164","North Reading","Middlesex County","MA","North Reading","2010","North Reading town, MA",596,7821,8417
"5165","North Reading","Middlesex County","MA","North Reading","2011","North Reading town, MA",502,7937,8439
"5166","North Reading","Middlesex County","MA","North Reading","2012","North Reading town, MA",467,8025,8492
"5167","Northampton","Hampshire County","MA","Northampton","1990","Northampton city, MA",825,15580,16405
"5168","Northampton","Hampshire County","MA","Northampton","1991","Northampton city, MA",1113,15025,16138
"5169","Northampton","Hampshire County","MA","Northampton","1992","Northampton city, MA",1142,14848,15990
"5170","Northampton","Hampshire County","MA","Northampton","1993","Northampton city, MA",842,14834,15676
"5171","Northampton","Hampshire County","MA","Northampton","1994","Northampton city, MA",739,14904,15643
"5172","Northampton","Hampshire County","MA","Northampton","1995","Northampton city, MA",602,14964,15566
"5173","Northampton","Hampshire County","MA","Northampton","1996","Northampton city, MA",523,15167,15690
"5174","Northampton","Hampshire County","MA","Northampton","1997","Northampton city, MA",423,15532,15955
"5175","Northampton","Hampshire County","MA","Northampton","1998","Northampton city, MA",407,15421,15828
"5176","Northampton","Hampshire County","MA","Northampton","1999","Northampton city, MA",372,15480,15852
"5177","Northampton","Hampshire County","MA","Northampton","2000","Northampton city, MA",353,16734,17087
"5178","Northampton","Hampshire County","MA","Northampton","2001","Northampton city, MA",427,16663,17090
"5179","Northampton","Hampshire County","MA","Northampton","2002","Northampton city, MA",557,16613,17170
"5180","Northampton","Hampshire County","MA","Northampton","2003","Northampton city, MA",666,16442,17108
"5181","Northampton","Hampshire County","MA","Northampton","2004","Northampton city, MA",650,16356,17006
"5182","Northampton","Hampshire County","MA","Northampton","2005","Northampton city, MA",603,16322,16925
"5183","Northampton","Hampshire County","MA","Northampton","2006","Northampton city, MA",625,16363,16988
"5184","Northampton","Hampshire County","MA","Northampton","2007","Northampton city, MA",594,16305,16899
"5185","Northampton","Hampshire County","MA","Northampton","2008","Northampton city, MA",668,16141,16809
"5186","Northampton","Hampshire County","MA","Northampton","2009","Northampton city, MA",967,15486,16453
"5187","Northampton","Hampshire County","MA","Northampton","2010","Northampton city, MA",957,15537,16494
"5188","Northampton","Hampshire County","MA","Northampton","2011","Northampton city, MA",866,15346,16212
"5189","Northampton","Hampshire County","MA","Northampton","2012","Northampton city, MA",814,15356,16170
"5190","Northborough","Worcester County","MA","Northborough","1990","Northborough town, MA",323,6615,6938
"5191","Northborough","Worcester County","MA","Northborough","1991","Northborough town, MA",489,6432,6921
"5192","Northborough","Worcester County","MA","Northborough","1992","Northborough town, MA",473,6542,7015
"5193","Northborough","Worcester County","MA","Northborough","1993","Northborough town, MA",410,6831,7241
"5194","Northborough","Worcester County","MA","Northborough","1994","Northborough town, MA",348,7064,7412
"5195","Northborough","Worcester County","MA","Northborough","1995","Northborough town, MA",287,6946,7233
"5196","Northborough","Worcester County","MA","Northborough","1996","Northborough town, MA",226,7169,7395
"5197","Northborough","Worcester County","MA","Northborough","1997","Northborough town, MA",224,7448,7672
"5198","Northborough","Worcester County","MA","Northborough","1998","Northborough town, MA",179,7651,7830
"5199","Northborough","Worcester County","MA","Northborough","1999","Northborough town, MA",208,7747,7955
"5200","Northborough","Worcester County","MA","Northborough","2000","Northborough town, MA",161,7732,7893
"5201","Northborough","Worcester County","MA","Northborough","2001","Northborough town, MA",249,7728,7977
"5202","Northborough","Worcester County","MA","Northborough","2002","Northborough town, MA",394,7668,8062
"5203","Northborough","Worcester County","MA","Northborough","2003","Northborough town, MA",401,7618,8019
"5204","Northborough","Worcester County","MA","Northborough","2004","Northborough town, MA",340,7622,7962
"5205","Northborough","Worcester County","MA","Northborough","2005","Northborough town, MA",290,7787,8077
"5206","Northborough","Worcester County","MA","Northborough","2006","Northborough town, MA",283,7784,8067
"5207","Northborough","Worcester County","MA","Northborough","2007","Northborough town, MA",291,7813,8104
"5208","Northborough","Worcester County","MA","Northborough","2008","Northborough town, MA",330,7691,8021
"5209","Northborough","Worcester County","MA","Northborough","2009","Northborough town, MA",575,7525,8100
"5210","Northborough","Worcester County","MA","Northborough","2010","Northborough town, MA",525,7189,7714
"5211","Northborough","Worcester County","MA","Northborough","2011","Northborough town, MA",479,7253,7732
"5212","Northborough","Worcester County","MA","Northborough","2012","Northborough town, MA",431,7250,7681
"5213","Northbridge","Worcester County","MA","Northbridge","1990","Northbridge town, MA",496,6360,6856
"5214","Northbridge","Worcester County","MA","Northbridge","1991","Northbridge town, MA",689,6018,6707
"5215","Northbridge","Worcester County","MA","Northbridge","1992","Northbridge town, MA",620,5954,6574
"5216","Northbridge","Worcester County","MA","Northbridge","1993","Northbridge town, MA",543,6122,6665
"5217","Northbridge","Worcester County","MA","Northbridge","1994","Northbridge town, MA",367,6266,6633
"5218","Northbridge","Worcester County","MA","Northbridge","1995","Northbridge town, MA",355,6416,6771
"5219","Northbridge","Worcester County","MA","Northbridge","1996","Northbridge town, MA",330,6568,6898
"5220","Northbridge","Worcester County","MA","Northbridge","1997","Northbridge town, MA",292,6788,7080
"5221","Northbridge","Worcester County","MA","Northbridge","1998","Northbridge town, MA",260,7022,7282
"5222","Northbridge","Worcester County","MA","Northbridge","1999","Northbridge town, MA",228,7041,7269
"5223","Northbridge","Worcester County","MA","Northbridge","2000","Northbridge town, MA",191,6669,6860
"5224","Northbridge","Worcester County","MA","Northbridge","2001","Northbridge town, MA",272,6679,6951
"5225","Northbridge","Worcester County","MA","Northbridge","2002","Northbridge town, MA",453,6680,7133
"5226","Northbridge","Worcester County","MA","Northbridge","2003","Northbridge town, MA",484,6710,7194
"5227","Northbridge","Worcester County","MA","Northbridge","2004","Northbridge town, MA",429,6772,7201
"5228","Northbridge","Worcester County","MA","Northbridge","2005","Northbridge town, MA",373,6913,7286
"5229","Northbridge","Worcester County","MA","Northbridge","2006","Northbridge town, MA",376,7088,7464
"5230","Northbridge","Worcester County","MA","Northbridge","2007","Northbridge town, MA",418,7126,7544
"5231","Northbridge","Worcester County","MA","Northbridge","2008","Northbridge town, MA",481,7009,7490
"5232","Northbridge","Worcester County","MA","Northbridge","2009","Northbridge town, MA",704,6828,7532
"5233","Northbridge","Worcester County","MA","Northbridge","2010","Northbridge town, MA",731,7312,8043
"5234","Northbridge","Worcester County","MA","Northbridge","2011","Northbridge town, MA",650,7377,8027
"5235","Northbridge","Worcester County","MA","Northbridge","2012","Northbridge town, MA",626,7374,8000
"5236","Northfield","Franklin County","MA","Northfield","1990","Northfield town, MA",87,1497,1584
"5237","Northfield","Franklin County","MA","Northfield","1991","Northfield town, MA",95,1531,1626
"5238","Northfield","Franklin County","MA","Northfield","1992","Northfield town, MA",104,1501,1605
"5239","Northfield","Franklin County","MA","Northfield","1993","Northfield town, MA",62,1529,1591
"5240","Northfield","Franklin County","MA","Northfield","1994","Northfield town, MA",57,1631,1688
"5241","Northfield","Franklin County","MA","Northfield","1995","Northfield town, MA",52,1533,1585
"5242","Northfield","Franklin County","MA","Northfield","1996","Northfield town, MA",54,1553,1607
"5243","Northfield","Franklin County","MA","Northfield","1997","Northfield town, MA",48,1600,1648
"5244","Northfield","Franklin County","MA","Northfield","1998","Northfield town, MA",46,1645,1691
"5245","Northfield","Franklin County","MA","Northfield","1999","Northfield town, MA",36,1690,1726
"5246","Northfield","Franklin County","MA","Northfield","2000","Northfield town, MA",36,1687,1723
"5247","Northfield","Franklin County","MA","Northfield","2001","Northfield town, MA",43,1704,1747
"5248","Northfield","Franklin County","MA","Northfield","2002","Northfield town, MA",59,1754,1813
"5249","Northfield","Franklin County","MA","Northfield","2003","Northfield town, MA",78,1786,1864
"5250","Northfield","Franklin County","MA","Northfield","2004","Northfield town, MA",69,1787,1856
"5251","Northfield","Franklin County","MA","Northfield","2005","Northfield town, MA",69,1816,1885
"5252","Northfield","Franklin County","MA","Northfield","2006","Northfield town, MA",68,1853,1921
"5253","Northfield","Franklin County","MA","Northfield","2007","Northfield town, MA",59,1677,1736
"5254","Northfield","Franklin County","MA","Northfield","2008","Northfield town, MA",75,1673,1748
"5255","Northfield","Franklin County","MA","Northfield","2009","Northfield town, MA",113,1629,1742
"5256","Northfield","Franklin County","MA","Northfield","2010","Northfield town, MA",117,1659,1776
"5257","Northfield","Franklin County","MA","Northfield","2011","Northfield town, MA",92,1661,1753
"5258","Northfield","Franklin County","MA","Northfield","2012","Northfield town, MA",76,1666,1742
"5259","Norton","Bristol County","MA","Norton","1990","Norton town, MA",588,7742,8330
"5260","Norton","Bristol County","MA","Norton","1991","Norton town, MA",697,7741,8438
"5261","Norton","Bristol County","MA","Norton","1992","Norton town, MA",699,7878,8577
"5262","Norton","Bristol County","MA","Norton","1993","Norton town, MA",536,8068,8604
"5263","Norton","Bristol County","MA","Norton","1994","Norton town, MA",511,8356,8867
"5264","Norton","Bristol County","MA","Norton","1995","Norton town, MA",415,8276,8691
"5265","Norton","Bristol County","MA","Norton","1996","Norton town, MA",398,8512,8910
"5266","Norton","Bristol County","MA","Norton","1997","Norton town, MA",365,8814,9179
"5267","Norton","Bristol County","MA","Norton","1998","Norton town, MA",278,9024,9302
"5268","Norton","Bristol County","MA","Norton","1999","Norton town, MA",289,9225,9514
"5269","Norton","Bristol County","MA","Norton","2000","Norton town, MA",244,9412,9656
"5270","Norton","Bristol County","MA","Norton","2001","Norton town, MA",336,9468,9804
"5271","Norton","Bristol County","MA","Norton","2002","Norton town, MA",501,9516,10017
"5272","Norton","Bristol County","MA","Norton","2003","Norton town, MA",541,9665,10206
"5273","Norton","Bristol County","MA","Norton","2004","Norton town, MA",516,9679,10195
"5274","Norton","Bristol County","MA","Norton","2005","Norton town, MA",521,9858,10379
"5275","Norton","Bristol County","MA","Norton","2006","Norton town, MA",529,10018,10547
"5276","Norton","Bristol County","MA","Norton","2007","Norton town, MA",504,10095,10599
"5277","Norton","Bristol County","MA","Norton","2008","Norton town, MA",604,10062,10666
"5278","Norton","Bristol County","MA","Norton","2009","Norton town, MA",915,9742,10657
"5279","Norton","Bristol County","MA","Norton","2010","Norton town, MA",938,9562,10500
"5280","Norton","Bristol County","MA","Norton","2011","Norton town, MA",763,9660,10423
"5281","Norton","Bristol County","MA","Norton","2012","Norton town, MA",725,9631,10356
"5282","Norwell","Plymouth County","MA","Norwell","1990","Norwell town, MA",260,4918,5178
"5283","Norwell","Plymouth County","MA","Norwell","1991","Norwell town, MA",323,4782,5105
"5284","Norwell","Plymouth County","MA","Norwell","1992","Norwell town, MA",347,4835,5182
"5285","Norwell","Plymouth County","MA","Norwell","1993","Norwell town, MA",236,4905,5141
"5286","Norwell","Plymouth County","MA","Norwell","1994","Norwell town, MA",191,4978,5169
"5287","Norwell","Plymouth County","MA","Norwell","1995","Norwell town, MA",197,5010,5207
"5288","Norwell","Plymouth County","MA","Norwell","1996","Norwell town, MA",168,5141,5309
"5289","Norwell","Plymouth County","MA","Norwell","1997","Norwell town, MA",135,5326,5461
"5290","Norwell","Plymouth County","MA","Norwell","1998","Norwell town, MA",119,5493,5612
"5291","Norwell","Plymouth County","MA","Norwell","1999","Norwell town, MA",111,5606,5717
"5292","Norwell","Plymouth County","MA","Norwell","2000","Norwell town, MA",95,5054,5149
"5293","Norwell","Plymouth County","MA","Norwell","2001","Norwell town, MA",141,5129,5270
"5294","Norwell","Plymouth County","MA","Norwell","2002","Norwell town, MA",197,5107,5304
"5295","Norwell","Plymouth County","MA","Norwell","2003","Norwell town, MA",223,5102,5325
"5296","Norwell","Plymouth County","MA","Norwell","2004","Norwell town, MA",196,5150,5346
"5297","Norwell","Plymouth County","MA","Norwell","2005","Norwell town, MA",201,5208,5409
"5298","Norwell","Plymouth County","MA","Norwell","2006","Norwell town, MA",197,5080,5277
"5299","Norwell","Plymouth County","MA","Norwell","2007","Norwell town, MA",194,5111,5305
"5300","Norwell","Plymouth County","MA","Norwell","2008","Norwell town, MA",232,5106,5338
"5301","Norwell","Plymouth County","MA","Norwell","2009","Norwell town, MA",356,4941,5297
"5302","Norwell","Plymouth County","MA","Norwell","2010","Norwell town, MA",324,5097,5421
"5303","Norwell","Plymouth County","MA","Norwell","2011","Norwell town, MA",316,5146,5462
"5304","Norwell","Plymouth County","MA","Norwell","2012","Norwell town, MA",242,5202,5444
"5305","Norwood","Norfolk County","MA","Norwood","1990","Norwood town, MA",971,15464,16435
"5306","Norwood","Norfolk County","MA","Norwood","1991","Norwood town, MA",1283,15104,16387
"5307","Norwood","Norfolk County","MA","Norwood","1992","Norwood town, MA",1294,14888,16182
"5308","Norwood","Norfolk County","MA","Norwood","1993","Norwood town, MA",1002,14971,15973
"5309","Norwood","Norfolk County","MA","Norwood","1994","Norwood town, MA",869,15152,16021
"5310","Norwood","Norfolk County","MA","Norwood","1995","Norwood town, MA",784,15448,16232
"5311","Norwood","Norfolk County","MA","Norwood","1996","Norwood town, MA",565,15708,16273
"5312","Norwood","Norfolk County","MA","Norwood","1997","Norwood town, MA",548,16046,16594
"5313","Norwood","Norfolk County","MA","Norwood","1998","Norwood town, MA",431,16221,16652
"5314","Norwood","Norfolk County","MA","Norwood","1999","Norwood town, MA",431,16290,16721
"5315","Norwood","Norfolk County","MA","Norwood","2000","Norwood town, MA",372,15583,15955
"5316","Norwood","Norfolk County","MA","Norwood","2001","Norwood town, MA",481,15520,16001
"5317","Norwood","Norfolk County","MA","Norwood","2002","Norwood town, MA",759,15334,16093
"5318","Norwood","Norfolk County","MA","Norwood","2003","Norwood town, MA",790,15067,15857
"5319","Norwood","Norfolk County","MA","Norwood","2004","Norwood town, MA",720,14989,15709
"5320","Norwood","Norfolk County","MA","Norwood","2005","Norwood town, MA",655,15105,15760
"5321","Norwood","Norfolk County","MA","Norwood","2006","Norwood town, MA",627,14840,15467
"5322","Norwood","Norfolk County","MA","Norwood","2007","Norwood town, MA",609,14956,15565
"5323","Norwood","Norfolk County","MA","Norwood","2008","Norwood town, MA",746,14927,15673
"5324","Norwood","Norfolk County","MA","Norwood","2009","Norwood town, MA",1126,14396,15522
"5325","Norwood","Norfolk County","MA","Norwood","2010","Norwood town, MA",1135,14695,15830
"5326","Norwood","Norfolk County","MA","Norwood","2011","Norwood town, MA",978,14861,15839
"5327","Norwood","Norfolk County","MA","Norwood","2012","Norwood town, MA",893,15024,15917
"5328","Oak Bluffs","Dukes County","MA","Oak Bluffs","1990","Oak Bluffs town, MA",83,1674,1757
"5329","Oak Bluffs","Dukes County","MA","Oak Bluffs","1991","Oak Bluffs town, MA",111,1695,1806
"5330","Oak Bluffs","Dukes County","MA","Oak Bluffs","1992","Oak Bluffs town, MA",121,1646,1767
"5331","Oak Bluffs","Dukes County","MA","Oak Bluffs","1993","Oak Bluffs town, MA",129,1680,1809
"5332","Oak Bluffs","Dukes County","MA","Oak Bluffs","1994","Oak Bluffs town, MA",105,1821,1926
"5333","Oak Bluffs","Dukes County","MA","Oak Bluffs","1995","Oak Bluffs town, MA",102,1886,1988
"5334","Oak Bluffs","Dukes County","MA","Oak Bluffs","1996","Oak Bluffs town, MA",93,1965,2058
"5335","Oak Bluffs","Dukes County","MA","Oak Bluffs","1997","Oak Bluffs town, MA",100,2014,2114
"5336","Oak Bluffs","Dukes County","MA","Oak Bluffs","1998","Oak Bluffs town, MA",74,2041,2115
"5337","Oak Bluffs","Dukes County","MA","Oak Bluffs","1999","Oak Bluffs town, MA",66,2070,2136
"5338","Oak Bluffs","Dukes County","MA","Oak Bluffs","2000","Oak Bluffs town, MA",60,2336,2396
"5339","Oak Bluffs","Dukes County","MA","Oak Bluffs","2001","Oak Bluffs town, MA",61,2347,2408
"5340","Oak Bluffs","Dukes County","MA","Oak Bluffs","2002","Oak Bluffs town, MA",81,2430,2511
"5341","Oak Bluffs","Dukes County","MA","Oak Bluffs","2003","Oak Bluffs town, MA",113,2507,2620
"5342","Oak Bluffs","Dukes County","MA","Oak Bluffs","2004","Oak Bluffs town, MA",109,2512,2621
"5343","Oak Bluffs","Dukes County","MA","Oak Bluffs","2005","Oak Bluffs town, MA",95,2464,2559
"5344","Oak Bluffs","Dukes County","MA","Oak Bluffs","2006","Oak Bluffs town, MA",100,2481,2581
"5345","Oak Bluffs","Dukes County","MA","Oak Bluffs","2007","Oak Bluffs town, MA",90,2493,2583
"5346","Oak Bluffs","Dukes County","MA","Oak Bluffs","2008","Oak Bluffs town, MA",108,2490,2598
"5347","Oak Bluffs","Dukes County","MA","Oak Bluffs","2009","Oak Bluffs town, MA",184,2535,2719
"5348","Oak Bluffs","Dukes County","MA","Oak Bluffs","2010","Oak Bluffs town, MA",210,2814,3024
"5349","Oak Bluffs","Dukes County","MA","Oak Bluffs","2011","Oak Bluffs town, MA",221,2835,3056
"5350","Oak Bluffs","Dukes County","MA","Oak Bluffs","2012","Oak Bluffs town, MA",205,2863,3068
"5351","Oakham","Worcester County","MA","Oakham","1990","Oakham town, MA",46,727,773
"5352","Oakham","Worcester County","MA","Oakham","1991","Oakham town, MA",95,735,830
"5353","Oakham","Worcester County","MA","Oakham","1992","Oakham town, MA",70,737,807
"5354","Oakham","Worcester County","MA","Oakham","1993","Oakham town, MA",68,777,845
"5355","Oakham","Worcester County","MA","Oakham","1994","Oakham town, MA",48,787,835
"5356","Oakham","Worcester County","MA","Oakham","1995","Oakham town, MA",43,781,824
"5357","Oakham","Worcester County","MA","Oakham","1996","Oakham town, MA",40,798,838
"5358","Oakham","Worcester County","MA","Oakham","1997","Oakham town, MA",36,822,858
"5359","Oakham","Worcester County","MA","Oakham","1998","Oakham town, MA",37,845,882
"5360","Oakham","Worcester County","MA","Oakham","1999","Oakham town, MA",30,848,878
"5361","Oakham","Worcester County","MA","Oakham","2000","Oakham town, MA",23,923,946
"5362","Oakham","Worcester County","MA","Oakham","2001","Oakham town, MA",34,937,971
"5363","Oakham","Worcester County","MA","Oakham","2002","Oakham town, MA",47,948,995
"5364","Oakham","Worcester County","MA","Oakham","2003","Oakham town, MA",64,972,1036
"5365","Oakham","Worcester County","MA","Oakham","2004","Oakham town, MA",69,997,1066
"5366","Oakham","Worcester County","MA","Oakham","2005","Oakham town, MA",55,1004,1059
"5367","Oakham","Worcester County","MA","Oakham","2006","Oakham town, MA",52,1016,1068
"5368","Oakham","Worcester County","MA","Oakham","2007","Oakham town, MA",49,1022,1071
"5369","Oakham","Worcester County","MA","Oakham","2008","Oakham town, MA",54,1008,1062
"5370","Oakham","Worcester County","MA","Oakham","2009","Oakham town, MA",94,982,1076
"5371","Oakham","Worcester County","MA","Oakham","2010","Oakham town, MA",101,964,1065
"5372","Oakham","Worcester County","MA","Oakham","2011","Oakham town, MA",79,972,1051
"5373","Oakham","Worcester County","MA","Oakham","2012","Oakham town, MA",69,972,1041
"5374","Orange","Franklin County","MA","Orange","1990","Orange town, MA",332,3223,3555
"5375","Orange","Franklin County","MA","Orange","1991","Orange town, MA",478,3042,3520
"5376","Orange","Franklin County","MA","Orange","1992","Orange town, MA",449,3088,3537
"5377","Orange","Franklin County","MA","Orange","1993","Orange town, MA",351,3124,3475
"5378","Orange","Franklin County","MA","Orange","1994","Orange town, MA",273,3110,3383
"5379","Orange","Franklin County","MA","Orange","1995","Orange town, MA",228,3069,3297
"5380","Orange","Franklin County","MA","Orange","1996","Orange town, MA",194,3052,3246
"5381","Orange","Franklin County","MA","Orange","1997","Orange town, MA",213,3088,3301
"5382","Orange","Franklin County","MA","Orange","1998","Orange town, MA",173,3110,3283
"5383","Orange","Franklin County","MA","Orange","1999","Orange town, MA",144,3088,3232
"5384","Orange","Franklin County","MA","Orange","2000","Orange town, MA",112,3710,3822
"5385","Orange","Franklin County","MA","Orange","2001","Orange town, MA",151,3623,3774
"5386","Orange","Franklin County","MA","Orange","2002","Orange town, MA",195,3627,3822
"5387","Orange","Franklin County","MA","Orange","2003","Orange town, MA",227,3565,3792
"5388","Orange","Franklin County","MA","Orange","2004","Orange town, MA",215,3503,3718
"5389","Orange","Franklin County","MA","Orange","2005","Orange town, MA",200,3513,3713
"5390","Orange","Franklin County","MA","Orange","2006","Orange town, MA",186,3528,3714
"5391","Orange","Franklin County","MA","Orange","2007","Orange town, MA",193,3537,3730
"5392","Orange","Franklin County","MA","Orange","2008","Orange town, MA",256,3527,3783
"5393","Orange","Franklin County","MA","Orange","2009","Orange town, MA",404,3375,3779
"5394","Orange","Franklin County","MA","Orange","2010","Orange town, MA",411,3409,3820
"5395","Orange","Franklin County","MA","Orange","2011","Orange town, MA",344,3402,3746
"5396","Orange","Franklin County","MA","Orange","2012","Orange town, MA",339,3413,3752
"5397","Orleans","Barnstable County","MA","Orleans","1990","Orleans town, MA",146,2703,2849
"5398","Orleans","Barnstable County","MA","Orleans","1991","Orleans town, MA",294,2568,2862
"5399","Orleans","Barnstable County","MA","Orleans","1992","Orleans town, MA",235,2525,2760
"5400","Orleans","Barnstable County","MA","Orleans","1993","Orleans town, MA",236,2565,2801
"5401","Orleans","Barnstable County","MA","Orleans","1994","Orleans town, MA",226,2623,2849
"5402","Orleans","Barnstable County","MA","Orleans","1995","Orleans town, MA",169,2788,2957
"5403","Orleans","Barnstable County","MA","Orleans","1996","Orleans town, MA",162,2855,3017
"5404","Orleans","Barnstable County","MA","Orleans","1997","Orleans town, MA",169,2895,3064
"5405","Orleans","Barnstable County","MA","Orleans","1998","Orleans town, MA",137,2942,3079
"5406","Orleans","Barnstable County","MA","Orleans","1999","Orleans town, MA",110,3052,3162
"5407","Orleans","Barnstable County","MA","Orleans","2000","Orleans town, MA",103,2775,2878
"5408","Orleans","Barnstable County","MA","Orleans","2001","Orleans town, MA",119,2799,2918
"5409","Orleans","Barnstable County","MA","Orleans","2002","Orleans town, MA",138,2845,2983
"5410","Orleans","Barnstable County","MA","Orleans","2003","Orleans town, MA",164,2902,3066
"5411","Orleans","Barnstable County","MA","Orleans","2004","Orleans town, MA",148,2931,3079
"5412","Orleans","Barnstable County","MA","Orleans","2005","Orleans town, MA",137,2940,3077
"5413","Orleans","Barnstable County","MA","Orleans","2006","Orleans town, MA",154,2941,3095
"5414","Orleans","Barnstable County","MA","Orleans","2007","Orleans town, MA",137,2920,3057
"5415","Orleans","Barnstable County","MA","Orleans","2008","Orleans town, MA",160,2895,3055
"5416","Orleans","Barnstable County","MA","Orleans","2009","Orleans town, MA",223,2808,3031
"5417","Orleans","Barnstable County","MA","Orleans","2010","Orleans town, MA",244,2681,2925
"5418","Orleans","Barnstable County","MA","Orleans","2011","Orleans town, MA",237,2677,2914
"5419","Orleans","Barnstable County","MA","Orleans","2012","Orleans town, MA",193,2722,2915
"5420","Otis","Berkshire County","MA","Otis","1990","Otis town, MA",46,546,592
"5421","Otis","Berkshire County","MA","Otis","1991","Otis town, MA",54,544,598
"5422","Otis","Berkshire County","MA","Otis","1992","Otis town, MA",58,567,625
"5423","Otis","Berkshire County","MA","Otis","1993","Otis town, MA",59,575,634
"5424","Otis","Berkshire County","MA","Otis","1994","Otis town, MA",44,600,644
"5425","Otis","Berkshire County","MA","Otis","1995","Otis town, MA",41,588,629
"5426","Otis","Berkshire County","MA","Otis","1996","Otis town, MA",37,600,637
"5427","Otis","Berkshire County","MA","Otis","1997","Otis town, MA",29,614,643
"5428","Otis","Berkshire County","MA","Otis","1998","Otis town, MA",23,609,632
"5429","Otis","Berkshire County","MA","Otis","1999","Otis town, MA",24,607,631
"5430","Otis","Berkshire County","MA","Otis","2000","Otis town, MA",25,743,768
"5431","Otis","Berkshire County","MA","Otis","2001","Otis town, MA",22,768,790
"5432","Otis","Berkshire County","MA","Otis","2002","Otis town, MA",35,796,831
"5433","Otis","Berkshire County","MA","Otis","2003","Otis town, MA",41,801,842
"5434","Otis","Berkshire County","MA","Otis","2004","Otis town, MA",44,802,846
"5435","Otis","Berkshire County","MA","Otis","2005","Otis town, MA",31,823,854
"5436","Otis","Berkshire County","MA","Otis","2006","Otis town, MA",39,829,868
"5437","Otis","Berkshire County","MA","Otis","2007","Otis town, MA",37,820,857
"5438","Otis","Berkshire County","MA","Otis","2008","Otis town, MA",41,823,864
"5439","Otis","Berkshire County","MA","Otis","2009","Otis town, MA",61,800,861
"5440","Otis","Berkshire County","MA","Otis","2010","Otis town, MA",67,931,998
"5441","Otis","Berkshire County","MA","Otis","2011","Otis town, MA",57,936,993
"5442","Otis","Berkshire County","MA","Otis","2012","Otis town, MA",56,929,985
"5443","Oxford","Worcester County","MA","Oxford","1990","Oxford town, MA",495,6221,6716
"5444","Oxford","Worcester County","MA","Oxford","1991","Oxford town, MA",711,6061,6772
"5445","Oxford","Worcester County","MA","Oxford","1992","Oxford town, MA",668,6198,6866
"5446","Oxford","Worcester County","MA","Oxford","1993","Oxford town, MA",486,6371,6857
"5447","Oxford","Worcester County","MA","Oxford","1994","Oxford town, MA",409,6529,6938
"5448","Oxford","Worcester County","MA","Oxford","1995","Oxford town, MA",392,6339,6731
"5449","Oxford","Worcester County","MA","Oxford","1996","Oxford town, MA",315,6469,6784
"5450","Oxford","Worcester County","MA","Oxford","1997","Oxford town, MA",285,6678,6963
"5451","Oxford","Worcester County","MA","Oxford","1998","Oxford town, MA",267,6836,7103
"5452","Oxford","Worcester County","MA","Oxford","1999","Oxford town, MA",221,6839,7060
"5453","Oxford","Worcester County","MA","Oxford","2000","Oxford town, MA",205,7377,7582
"5454","Oxford","Worcester County","MA","Oxford","2001","Oxford town, MA",255,7413,7668
"5455","Oxford","Worcester County","MA","Oxford","2002","Oxford town, MA",394,7375,7769
"5456","Oxford","Worcester County","MA","Oxford","2003","Oxford town, MA",450,7336,7786
"5457","Oxford","Worcester County","MA","Oxford","2004","Oxford town, MA",401,7311,7712
"5458","Oxford","Worcester County","MA","Oxford","2005","Oxford town, MA",378,7279,7657
"5459","Oxford","Worcester County","MA","Oxford","2006","Oxford town, MA",370,7332,7702
"5460","Oxford","Worcester County","MA","Oxford","2007","Oxford town, MA",347,7349,7696
"5461","Oxford","Worcester County","MA","Oxford","2008","Oxford town, MA",435,7198,7633
"5462","Oxford","Worcester County","MA","Oxford","2009","Oxford town, MA",685,6992,7677
"5463","Oxford","Worcester County","MA","Oxford","2010","Oxford town, MA",657,6964,7621
"5464","Oxford","Worcester County","MA","Oxford","2011","Oxford town, MA",574,7026,7600
"5465","Oxford","Worcester County","MA","Oxford","2012","Oxford town, MA",522,7024,7546
"5466","Palmer","Hampden County","MA","Palmer","1990","Palmer Town city, MA",409,5785,6194
"5467","Palmer","Hampden County","MA","Palmer","1991","Palmer Town city, MA",590,5591,6181
"5468","Palmer","Hampden County","MA","Palmer","1992","Palmer Town city, MA",555,5665,6220
"5469","Palmer","Hampden County","MA","Palmer","1993","Palmer Town city, MA",580,5627,6207
"5470","Palmer","Hampden County","MA","Palmer","1994","Palmer Town city, MA",554,5647,6201
"5471","Palmer","Hampden County","MA","Palmer","1995","Palmer Town city, MA",378,5561,5939
"5472","Palmer","Hampden County","MA","Palmer","1996","Palmer Town city, MA",320,5623,5943
"5473","Palmer","Hampden County","MA","Palmer","1997","Palmer Town city, MA",308,5747,6055
"5474","Palmer","Hampden County","MA","Palmer","1998","Palmer Town city, MA",294,5769,6063
"5475","Palmer","Hampden County","MA","Palmer","1999","Palmer Town city, MA",249,5784,6033
"5476","Palmer","Hampden County","MA","Palmer","2000","Palmer Town city, MA",209,6548,6757
"5477","Palmer","Hampden County","MA","Palmer","2001","Palmer Town city, MA",277,6594,6871
"5478","Palmer","Hampden County","MA","Palmer","2002","Palmer Town city, MA",381,6598,6979
"5479","Palmer","Hampden County","MA","Palmer","2003","Palmer Town city, MA",443,6574,7017
"5480","Palmer","Hampden County","MA","Palmer","2004","Palmer Town city, MA",452,6616,7068
"5481","Palmer","Hampden County","MA","Palmer","2005","Palmer Town city, MA",366,6654,7020
"5482","Palmer","Hampden County","MA","Palmer","2006","Palmer Town city, MA",402,6699,7101
"5483","Palmer","Hampden County","MA","Palmer","2007","Palmer Town city, MA",373,6678,7051
"5484","Palmer","Hampden County","MA","Palmer","2008","Palmer Town city, MA",424,6662,7086
"5485","Palmer","Hampden County","MA","Palmer","2009","Palmer Town city, MA",624,6442,7066
"5486","Palmer","Hampden County","MA","Palmer","2010","Palmer Town city, MA",659,5984,6643
"5487","Palmer","Hampden County","MA","Palmer","2011","Palmer Town city, MA",556,5925,6481
"5488","Palmer","Hampden County","MA","Palmer","2012","Palmer Town city, MA",522,5928,6450
"5489","Paxton","Worcester County","MA","Paxton","1990","Paxton town, MA",71,2130,2201
"5490","Paxton","Worcester County","MA","Paxton","1991","Paxton town, MA",134,2072,2206
"5491","Paxton","Worcester County","MA","Paxton","1992","Paxton town, MA",139,2119,2258
"5492","Paxton","Worcester County","MA","Paxton","1993","Paxton town, MA",80,2173,2253
"5493","Paxton","Worcester County","MA","Paxton","1994","Paxton town, MA",76,2202,2278
"5494","Paxton","Worcester County","MA","Paxton","1995","Paxton town, MA",69,2140,2209
"5495","Paxton","Worcester County","MA","Paxton","1996","Paxton town, MA",65,2181,2246
"5496","Paxton","Worcester County","MA","Paxton","1997","Paxton town, MA",51,2239,2290
"5497","Paxton","Worcester County","MA","Paxton","1998","Paxton town, MA",52,2385,2437
"5498","Paxton","Worcester County","MA","Paxton","1999","Paxton town, MA",45,2393,2438
"5499","Paxton","Worcester County","MA","Paxton","2000","Paxton town, MA",50,2290,2340
"5500","Paxton","Worcester County","MA","Paxton","2001","Paxton town, MA",66,2297,2363
"5501","Paxton","Worcester County","MA","Paxton","2002","Paxton town, MA",82,2281,2363
"5502","Paxton","Worcester County","MA","Paxton","2003","Paxton town, MA",99,2282,2381
"5503","Paxton","Worcester County","MA","Paxton","2004","Paxton town, MA",82,2284,2366
"5504","Paxton","Worcester County","MA","Paxton","2005","Paxton town, MA",94,2285,2379
"5505","Paxton","Worcester County","MA","Paxton","2006","Paxton town, MA",98,2369,2467
"5506","Paxton","Worcester County","MA","Paxton","2007","Paxton town, MA",94,2397,2491
"5507","Paxton","Worcester County","MA","Paxton","2008","Paxton town, MA",109,2382,2491
"5508","Paxton","Worcester County","MA","Paxton","2009","Paxton town, MA",177,2311,2488
"5509","Paxton","Worcester County","MA","Paxton","2010","Paxton town, MA",191,2307,2498
"5510","Paxton","Worcester County","MA","Paxton","2011","Paxton town, MA",153,2326,2479
"5511","Paxton","Worcester County","MA","Paxton","2012","Paxton town, MA",134,2325,2459
"5512","Peabody","Essex County","MA","Peabody","1990","Peabody city, MA",1643,24859,26502
"5513","Peabody","Essex County","MA","Peabody","1991","Peabody city, MA",2340,24159,26499
"5514","Peabody","Essex County","MA","Peabody","1992","Peabody city, MA",2241,24075,26316
"5515","Peabody","Essex County","MA","Peabody","1993","Peabody city, MA",1746,24373,26119
"5516","Peabody","Essex County","MA","Peabody","1994","Peabody city, MA",1506,24732,26238
"5517","Peabody","Essex County","MA","Peabody","1995","Peabody city, MA",1297,25032,26329
"5518","Peabody","Essex County","MA","Peabody","1996","Peabody city, MA",1034,25578,26612
"5519","Peabody","Essex County","MA","Peabody","1997","Peabody city, MA",946,26392,27338
"5520","Peabody","Essex County","MA","Peabody","1998","Peabody city, MA",871,26875,27746
"5521","Peabody","Essex County","MA","Peabody","1999","Peabody city, MA",814,27145,27959
"5522","Peabody","Essex County","MA","Peabody","2000","Peabody city, MA",635,25235,25870
"5523","Peabody","Essex County","MA","Peabody","2001","Peabody city, MA",917,25525,26442
"5524","Peabody","Essex County","MA","Peabody","2002","Peabody city, MA",1318,25493,26811
"5525","Peabody","Essex County","MA","Peabody","2003","Peabody city, MA",1451,25237,26688
"5526","Peabody","Essex County","MA","Peabody","2004","Peabody city, MA",1354,25407,26761
"5527","Peabody","Essex County","MA","Peabody","2005","Peabody city, MA",1291,25891,27182
"5528","Peabody","Essex County","MA","Peabody","2006","Peabody city, MA",1334,26458,27792
"5529","Peabody","Essex County","MA","Peabody","2007","Peabody city, MA",1203,26406,27609
"5530","Peabody","Essex County","MA","Peabody","2008","Peabody city, MA",1399,26384,27783
"5531","Peabody","Essex County","MA","Peabody","2009","Peabody city, MA",2189,25793,27982
"5532","Peabody","Essex County","MA","Peabody","2010","Peabody city, MA",2182,25610,27792
"5533","Peabody","Essex County","MA","Peabody","2011","Peabody city, MA",1799,25907,27706
"5534","Peabody","Essex County","MA","Peabody","2012","Peabody city, MA",1774,26106,27880
"5535","Pelham","Hampshire County","MA","Pelham","1990","Pelham town, MA",23,815,838
"5536","Pelham","Hampshire County","MA","Pelham","1991","Pelham town, MA",34,769,803
"5537","Pelham","Hampshire County","MA","Pelham","1992","Pelham town, MA",37,740,777
"5538","Pelham","Hampshire County","MA","Pelham","1993","Pelham town, MA",23,739,762
"5539","Pelham","Hampshire County","MA","Pelham","1994","Pelham town, MA",21,779,800
"5540","Pelham","Hampshire County","MA","Pelham","1995","Pelham town, MA",20,845,865
"5541","Pelham","Hampshire County","MA","Pelham","1996","Pelham town, MA",21,847,868
"5542","Pelham","Hampshire County","MA","Pelham","1997","Pelham town, MA",14,867,881
"5543","Pelham","Hampshire County","MA","Pelham","1998","Pelham town, MA",20,884,904
"5544","Pelham","Hampshire County","MA","Pelham","1999","Pelham town, MA",21,902,923
"5545","Pelham","Hampshire County","MA","Pelham","2000","Pelham town, MA",18,782,800
"5546","Pelham","Hampshire County","MA","Pelham","2001","Pelham town, MA",23,801,824
"5547","Pelham","Hampshire County","MA","Pelham","2002","Pelham town, MA",29,800,829
"5548","Pelham","Hampshire County","MA","Pelham","2003","Pelham town, MA",31,814,845
"5549","Pelham","Hampshire County","MA","Pelham","2004","Pelham town, MA",30,815,845
"5550","Pelham","Hampshire County","MA","Pelham","2005","Pelham town, MA",31,814,845
"5551","Pelham","Hampshire County","MA","Pelham","2006","Pelham town, MA",28,817,845
"5552","Pelham","Hampshire County","MA","Pelham","2007","Pelham town, MA",27,822,849
"5553","Pelham","Hampshire County","MA","Pelham","2008","Pelham town, MA",21,782,803
"5554","Pelham","Hampshire County","MA","Pelham","2009","Pelham town, MA",25,761,786
"5555","Pelham","Hampshire County","MA","Pelham","2010","Pelham town, MA",28,705,733
"5556","Pelham","Hampshire County","MA","Pelham","2011","Pelham town, MA",36,708,744
"5557","Pelham","Hampshire County","MA","Pelham","2012","Pelham town, MA",36,714,750
"5558","Pembroke","Plymouth County","MA","Pembroke","1990","Pembroke town, MA",543,7700,8243
"5559","Pembroke","Plymouth County","MA","Pembroke","1991","Pembroke town, MA",756,7560,8316
"5560","Pembroke","Plymouth County","MA","Pembroke","1992","Pembroke town, MA",828,7717,8545
"5561","Pembroke","Plymouth County","MA","Pembroke","1993","Pembroke town, MA",680,7963,8643
"5562","Pembroke","Plymouth County","MA","Pembroke","1994","Pembroke town, MA",520,8287,8807
"5563","Pembroke","Plymouth County","MA","Pembroke","1995","Pembroke town, MA",471,8250,8721
"5564","Pembroke","Plymouth County","MA","Pembroke","1996","Pembroke town, MA",445,8499,8944
"5565","Pembroke","Plymouth County","MA","Pembroke","1997","Pembroke town, MA",374,8869,9243
"5566","Pembroke","Plymouth County","MA","Pembroke","1998","Pembroke town, MA",297,9128,9425
"5567","Pembroke","Plymouth County","MA","Pembroke","1999","Pembroke town, MA",299,9317,9616
"5568","Pembroke","Plymouth County","MA","Pembroke","2000","Pembroke town, MA",229,9235,9464
"5569","Pembroke","Plymouth County","MA","Pembroke","2001","Pembroke town, MA",302,9325,9627
"5570","Pembroke","Plymouth County","MA","Pembroke","2002","Pembroke town, MA",425,9309,9734
"5571","Pembroke","Plymouth County","MA","Pembroke","2003","Pembroke town, MA",515,9260,9775
"5572","Pembroke","Plymouth County","MA","Pembroke","2004","Pembroke town, MA",463,9269,9732
"5573","Pembroke","Plymouth County","MA","Pembroke","2005","Pembroke town, MA",437,9568,10005
"5574","Pembroke","Plymouth County","MA","Pembroke","2006","Pembroke town, MA",446,9673,10119
"5575","Pembroke","Plymouth County","MA","Pembroke","2007","Pembroke town, MA",441,9743,10184
"5576","Pembroke","Plymouth County","MA","Pembroke","2008","Pembroke town, MA",552,9797,10349
"5577","Pembroke","Plymouth County","MA","Pembroke","2009","Pembroke town, MA",834,9510,10344
"5578","Pembroke","Plymouth County","MA","Pembroke","2010","Pembroke town, MA",854,9135,9989
"5579","Pembroke","Plymouth County","MA","Pembroke","2011","Pembroke town, MA",747,9224,9971
"5580","Pembroke","Plymouth County","MA","Pembroke","2012","Pembroke town, MA",659,9325,9984
"5581","Pepperell","Middlesex County","MA","Pepperell","1990","Pepperell town, MA",364,5427,5791
"5582","Pepperell","Middlesex County","MA","Pepperell","1991","Pepperell town, MA",496,5243,5739
"5583","Pepperell","Middlesex County","MA","Pepperell","1992","Pepperell town, MA",454,5284,5738
"5584","Pepperell","Middlesex County","MA","Pepperell","1993","Pepperell town, MA",395,5358,5753
"5585","Pepperell","Middlesex County","MA","Pepperell","1994","Pepperell town, MA",337,5503,5840
"5586","Pepperell","Middlesex County","MA","Pepperell","1995","Pepperell town, MA",287,5334,5621
"5587","Pepperell","Middlesex County","MA","Pepperell","1996","Pepperell town, MA",236,5573,5809
"5588","Pepperell","Middlesex County","MA","Pepperell","1997","Pepperell town, MA",194,5862,6056
"5589","Pepperell","Middlesex County","MA","Pepperell","1998","Pepperell town, MA",194,6084,6278
"5590","Pepperell","Middlesex County","MA","Pepperell","1999","Pepperell town, MA",191,6304,6495
"5591","Pepperell","Middlesex County","MA","Pepperell","2000","Pepperell town, MA",146,6101,6247
"5592","Pepperell","Middlesex County","MA","Pepperell","2001","Pepperell town, MA",219,6117,6336
"5593","Pepperell","Middlesex County","MA","Pepperell","2002","Pepperell town, MA",373,5971,6344
"5594","Pepperell","Middlesex County","MA","Pepperell","2003","Pepperell town, MA",370,6069,6439
"5595","Pepperell","Middlesex County","MA","Pepperell","2004","Pepperell town, MA",308,6139,6447
"5596","Pepperell","Middlesex County","MA","Pepperell","2005","Pepperell town, MA",268,6204,6472
"5597","Pepperell","Middlesex County","MA","Pepperell","2006","Pepperell town, MA",262,6206,6468
"5598","Pepperell","Middlesex County","MA","Pepperell","2007","Pepperell town, MA",244,6212,6456
"5599","Pepperell","Middlesex County","MA","Pepperell","2008","Pepperell town, MA",277,6172,6449
"5600","Pepperell","Middlesex County","MA","Pepperell","2009","Pepperell town, MA",471,5966,6437
"5601","Pepperell","Middlesex County","MA","Pepperell","2010","Pepperell town, MA",485,6058,6543
"5602","Pepperell","Middlesex County","MA","Pepperell","2011","Pepperell town, MA",414,6077,6491
"5603","Pepperell","Middlesex County","MA","Pepperell","2012","Pepperell town, MA",370,6130,6500
"5604","Peru","Berkshire County","MA","Peru","1990","Peru town, MA",20,378,398
"5605","Peru","Berkshire County","MA","Peru","1991","Peru town, MA",38,360,398
"5606","Peru","Berkshire County","MA","Peru","1992","Peru town, MA",36,407,443
"5607","Peru","Berkshire County","MA","Peru","1993","Peru town, MA",23,417,440
"5608","Peru","Berkshire County","MA","Peru","1994","Peru town, MA",23,467,490
"5609","Peru","Berkshire County","MA","Peru","1995","Peru town, MA",21,428,449
"5610","Peru","Berkshire County","MA","Peru","1996","Peru town, MA",19,415,434
"5611","Peru","Berkshire County","MA","Peru","1997","Peru town, MA",19,421,440
"5612","Peru","Berkshire County","MA","Peru","1998","Peru town, MA",20,440,460
"5613","Peru","Berkshire County","MA","Peru","1999","Peru town, MA",18,479,497
"5614","Peru","Berkshire County","MA","Peru","2000","Peru town, MA",11,445,456
"5615","Peru","Berkshire County","MA","Peru","2001","Peru town, MA",11,444,455
"5616","Peru","Berkshire County","MA","Peru","2002","Peru town, MA",19,449,468
"5617","Peru","Berkshire County","MA","Peru","2003","Peru town, MA",21,450,471
"5618","Peru","Berkshire County","MA","Peru","2004","Peru town, MA",24,456,480
"5619","Peru","Berkshire County","MA","Peru","2005","Peru town, MA",22,472,494
"5620","Peru","Berkshire County","MA","Peru","2006","Peru town, MA",18,487,505
"5621","Peru","Berkshire County","MA","Peru","2007","Peru town, MA",25,484,509
"5622","Peru","Berkshire County","MA","Peru","2008","Peru town, MA",15,477,492
"5623","Peru","Berkshire County","MA","Peru","2009","Peru town, MA",20,462,482
"5624","Peru","Berkshire County","MA","Peru","2010","Peru town, MA",24,456,480
"5625","Peru","Berkshire County","MA","Peru","2011","Peru town, MA",17,460,477
"5626","Peru","Berkshire County","MA","Peru","2012","Peru town, MA",17,458,475
"5627","Petersham","Worcester County","MA","Petersham","1990","Petersham town, MA",23,556,579
"5628","Petersham","Worcester County","MA","Petersham","1991","Petersham town, MA",47,520,567
"5629","Petersham","Worcester County","MA","Petersham","1992","Petersham town, MA",49,521,570
"5630","Petersham","Worcester County","MA","Petersham","1993","Petersham town, MA",37,531,568
"5631","Petersham","Worcester County","MA","Petersham","1994","Petersham town, MA",35,548,583
"5632","Petersham","Worcester County","MA","Petersham","1995","Petersham town, MA",30,533,563
"5633","Petersham","Worcester County","MA","Petersham","1996","Petersham town, MA",19,529,548
"5634","Petersham","Worcester County","MA","Petersham","1997","Petersham town, MA",28,542,570
"5635","Petersham","Worcester County","MA","Petersham","1998","Petersham town, MA",17,535,552
"5636","Petersham","Worcester County","MA","Petersham","1999","Petersham town, MA",20,537,557
"5637","Petersham","Worcester County","MA","Petersham","2000","Petersham town, MA",16,615,631
"5638","Petersham","Worcester County","MA","Petersham","2001","Petersham town, MA",17,617,634
"5639","Petersham","Worcester County","MA","Petersham","2002","Petersham town, MA",27,615,642
"5640","Petersham","Worcester County","MA","Petersham","2003","Petersham town, MA",30,627,657
"5641","Petersham","Worcester County","MA","Petersham","2004","Petersham town, MA",28,635,663
"5642","Petersham","Worcester County","MA","Petersham","2005","Petersham town, MA",29,643,672
"5643","Petersham","Worcester County","MA","Petersham","2006","Petersham town, MA",26,653,679
"5644","Petersham","Worcester County","MA","Petersham","2007","Petersham town, MA",27,657,684
"5645","Petersham","Worcester County","MA","Petersham","2008","Petersham town, MA",31,650,681
"5646","Petersham","Worcester County","MA","Petersham","2009","Petersham town, MA",52,635,687
"5647","Petersham","Worcester County","MA","Petersham","2010","Petersham town, MA",57,591,648
"5648","Petersham","Worcester County","MA","Petersham","2011","Petersham town, MA",42,596,638
"5649","Petersham","Worcester County","MA","Petersham","2012","Petersham town, MA",37,596,633
"5650","Phillipston","Worcester County","MA","Phillipston","1990","Phillipston town, MA",48,712,760
"5651","Phillipston","Worcester County","MA","Phillipston","1991","Phillipston town, MA",67,647,714
"5652","Phillipston","Worcester County","MA","Phillipston","1992","Phillipston town, MA",78,661,739
"5653","Phillipston","Worcester County","MA","Phillipston","1993","Phillipston town, MA",60,710,770
"5654","Phillipston","Worcester County","MA","Phillipston","1994","Phillipston town, MA",96,741,837
"5655","Phillipston","Worcester County","MA","Phillipston","1995","Phillipston town, MA",64,714,778
"5656","Phillipston","Worcester County","MA","Phillipston","1996","Phillipston town, MA",59,711,770
"5657","Phillipston","Worcester County","MA","Phillipston","1997","Phillipston town, MA",50,726,776
"5658","Phillipston","Worcester County","MA","Phillipston","1998","Phillipston town, MA",42,636,678
"5659","Phillipston","Worcester County","MA","Phillipston","1999","Phillipston town, MA",49,635,684
"5660","Phillipston","Worcester County","MA","Phillipston","2000","Phillipston town, MA",29,877,906
"5661","Phillipston","Worcester County","MA","Phillipston","2001","Phillipston town, MA",38,866,904
"5662","Phillipston","Worcester County","MA","Phillipston","2002","Phillipston town, MA",60,858,918
"5663","Phillipston","Worcester County","MA","Phillipston","2003","Phillipston town, MA",51,871,922
"5664","Phillipston","Worcester County","MA","Phillipston","2004","Phillipston town, MA",58,885,943
"5665","Phillipston","Worcester County","MA","Phillipston","2005","Phillipston town, MA",62,889,951
"5666","Phillipston","Worcester County","MA","Phillipston","2006","Phillipston town, MA",52,909,961
"5667","Phillipston","Worcester County","MA","Phillipston","2007","Phillipston town, MA",45,917,962
"5668","Phillipston","Worcester County","MA","Phillipston","2008","Phillipston town, MA",60,904,964
"5669","Phillipston","Worcester County","MA","Phillipston","2009","Phillipston town, MA",97,854,951
"5670","Phillipston","Worcester County","MA","Phillipston","2010","Phillipston town, MA",91,821,912
"5671","Phillipston","Worcester County","MA","Phillipston","2011","Phillipston town, MA",76,820,896
"5672","Phillipston","Worcester County","MA","Phillipston","2012","Phillipston town, MA",83,820,903
"5673","Pittsfield","Berkshire County","MA","Pittsfield","1990","Pittsfield city, MA",1666,22141,23807
"5674","Pittsfield","Berkshire County","MA","Pittsfield","1991","Pittsfield city, MA",2793,20960,23753
"5675","Pittsfield","Berkshire County","MA","Pittsfield","1992","Pittsfield city, MA",2725,20401,23126
"5676","Pittsfield","Berkshire County","MA","Pittsfield","1993","Pittsfield city, MA",2127,20306,22433
"5677","Pittsfield","Berkshire County","MA","Pittsfield","1994","Pittsfield city, MA",1962,19912,21874
"5678","Pittsfield","Berkshire County","MA","Pittsfield","1995","Pittsfield city, MA",1543,20085,21628
"5679","Pittsfield","Berkshire County","MA","Pittsfield","1996","Pittsfield city, MA",1217,20335,21552
"5680","Pittsfield","Berkshire County","MA","Pittsfield","1997","Pittsfield city, MA",1189,20385,21574
"5681","Pittsfield","Berkshire County","MA","Pittsfield","1998","Pittsfield city, MA",952,20472,21424
"5682","Pittsfield","Berkshire County","MA","Pittsfield","1999","Pittsfield city, MA",945,20523,21468
"5683","Pittsfield","Berkshire County","MA","Pittsfield","2000","Pittsfield city, MA",740,22147,22887
"5684","Pittsfield","Berkshire County","MA","Pittsfield","2001","Pittsfield city, MA",882,22050,22932
"5685","Pittsfield","Berkshire County","MA","Pittsfield","2002","Pittsfield city, MA",1133,22270,23403
"5686","Pittsfield","Berkshire County","MA","Pittsfield","2003","Pittsfield city, MA",1240,22007,23247
"5687","Pittsfield","Berkshire County","MA","Pittsfield","2004","Pittsfield city, MA",1142,21906,23048
"5688","Pittsfield","Berkshire County","MA","Pittsfield","2005","Pittsfield city, MA",1052,22075,23127
"5689","Pittsfield","Berkshire County","MA","Pittsfield","2006","Pittsfield city, MA",1049,22374,23423
"5690","Pittsfield","Berkshire County","MA","Pittsfield","2007","Pittsfield city, MA",1042,22144,23186
"5691","Pittsfield","Berkshire County","MA","Pittsfield","2008","Pittsfield city, MA",1248,21847,23095
"5692","Pittsfield","Berkshire County","MA","Pittsfield","2009","Pittsfield city, MA",1889,21135,23024
"5693","Pittsfield","Berkshire County","MA","Pittsfield","2010","Pittsfield city, MA",2011,21483,23494
"5694","Pittsfield","Berkshire County","MA","Pittsfield","2011","Pittsfield city, MA",1849,21683,23532
"5695","Pittsfield","Berkshire County","MA","Pittsfield","2012","Pittsfield city, MA",1749,21585,23334
"5696","Plainfield","Hampshire County","MA","Plainfield","1990","Plainfield town, MA",22,280,302
"5697","Plainfield","Hampshire County","MA","Plainfield","1991","Plainfield town, MA",37,267,304
"5698","Plainfield","Hampshire County","MA","Plainfield","1992","Plainfield town, MA",39,291,330
"5699","Plainfield","Hampshire County","MA","Plainfield","1993","Plainfield town, MA",24,289,313
"5700","Plainfield","Hampshire County","MA","Plainfield","1994","Plainfield town, MA",24,324,348
"5701","Plainfield","Hampshire County","MA","Plainfield","1995","Plainfield town, MA",19,347,366
"5702","Plainfield","Hampshire County","MA","Plainfield","1996","Plainfield town, MA",21,339,360
"5703","Plainfield","Hampshire County","MA","Plainfield","1997","Plainfield town, MA",24,342,366
"5704","Plainfield","Hampshire County","MA","Plainfield","1998","Plainfield town, MA",17,360,377
"5705","Plainfield","Hampshire County","MA","Plainfield","1999","Plainfield town, MA",15,392,407
"5706","Plainfield","Hampshire County","MA","Plainfield","2000","Plainfield town, MA",10,289,299
"5707","Plainfield","Hampshire County","MA","Plainfield","2001","Plainfield town, MA",13,291,304
"5708","Plainfield","Hampshire County","MA","Plainfield","2002","Plainfield town, MA",17,291,308
"5709","Plainfield","Hampshire County","MA","Plainfield","2003","Plainfield town, MA",20,289,309
"5710","Plainfield","Hampshire County","MA","Plainfield","2004","Plainfield town, MA",18,290,308
"5711","Plainfield","Hampshire County","MA","Plainfield","2005","Plainfield town, MA",15,289,304
"5712","Plainfield","Hampshire County","MA","Plainfield","2006","Plainfield town, MA",16,292,308
"5713","Plainfield","Hampshire County","MA","Plainfield","2007","Plainfield town, MA",15,292,307
"5714","Plainfield","Hampshire County","MA","Plainfield","2008","Plainfield town, MA",19,285,304
"5715","Plainfield","Hampshire County","MA","Plainfield","2009","Plainfield town, MA",25,272,297
"5716","Plainfield","Hampshire County","MA","Plainfield","2010","Plainfield town, MA",27,299,326
"5717","Plainfield","Hampshire County","MA","Plainfield","2011","Plainfield town, MA",23,296,319
"5718","Plainfield","Hampshire County","MA","Plainfield","2012","Plainfield town, MA",19,296,315
"5719","Plainville","Norfolk County","MA","Plainville","1990","Plainville town, MA",189,3776,3965
"5720","Plainville","Norfolk County","MA","Plainville","1991","Plainville town, MA",377,3694,4071
"5721","Plainville","Norfolk County","MA","Plainville","1992","Plainville town, MA",357,3668,4025
"5722","Plainville","Norfolk County","MA","Plainville","1993","Plainville town, MA",245,3820,4065
"5723","Plainville","Norfolk County","MA","Plainville","1994","Plainville town, MA",235,4004,4239
"5724","Plainville","Norfolk County","MA","Plainville","1995","Plainville town, MA",203,3889,4092
"5725","Plainville","Norfolk County","MA","Plainville","1996","Plainville town, MA",155,3985,4140
"5726","Plainville","Norfolk County","MA","Plainville","1997","Plainville town, MA",153,4104,4257
"5727","Plainville","Norfolk County","MA","Plainville","1998","Plainville town, MA",117,4228,4345
"5728","Plainville","Norfolk County","MA","Plainville","1999","Plainville town, MA",120,4312,4432
"5729","Plainville","Norfolk County","MA","Plainville","2000","Plainville town, MA",130,4418,4548
"5730","Plainville","Norfolk County","MA","Plainville","2001","Plainville town, MA",172,4418,4590
"5731","Plainville","Norfolk County","MA","Plainville","2002","Plainville town, MA",251,4464,4715
"5732","Plainville","Norfolk County","MA","Plainville","2003","Plainville town, MA",238,4516,4754
"5733","Plainville","Norfolk County","MA","Plainville","2004","Plainville town, MA",235,4512,4747
"5734","Plainville","Norfolk County","MA","Plainville","2005","Plainville town, MA",219,4596,4815
"5735","Plainville","Norfolk County","MA","Plainville","2006","Plainville town, MA",239,4695,4934
"5736","Plainville","Norfolk County","MA","Plainville","2007","Plainville town, MA",214,4823,5037
"5737","Plainville","Norfolk County","MA","Plainville","2008","Plainville town, MA",275,4690,4965
"5738","Plainville","Norfolk County","MA","Plainville","2009","Plainville town, MA",497,4527,5024
"5739","Plainville","Norfolk County","MA","Plainville","2010","Plainville town, MA",502,4489,4991
"5740","Plainville","Norfolk County","MA","Plainville","2011","Plainville town, MA",419,4550,4969
"5741","Plainville","Norfolk County","MA","Plainville","2012","Plainville town, MA",414,4557,4971
"5742","Plymouth","Plymouth County","MA","Plymouth","1990","Plymouth town, MA",1730,21973,23703
"5743","Plymouth","Plymouth County","MA","Plymouth","1991","Plymouth town, MA",2251,21636,23887
"5744","Plymouth","Plymouth County","MA","Plymouth","1992","Plymouth town, MA",2343,21712,24055
"5745","Plymouth","Plymouth County","MA","Plymouth","1993","Plymouth town, MA",2082,22291,24373
"5746","Plymouth","Plymouth County","MA","Plymouth","1994","Plymouth town, MA",1716,22990,24706
"5747","Plymouth","Plymouth County","MA","Plymouth","1995","Plymouth town, MA",1511,22710,24221
"5748","Plymouth","Plymouth County","MA","Plymouth","1996","Plymouth town, MA",1398,23273,24671
"5749","Plymouth","Plymouth County","MA","Plymouth","1997","Plymouth town, MA",1280,24105,25385
"5750","Plymouth","Plymouth County","MA","Plymouth","1998","Plymouth town, MA",1040,24839,25879
"5751","Plymouth","Plymouth County","MA","Plymouth","1999","Plymouth town, MA",900,25458,26358
"5752","Plymouth","Plymouth County","MA","Plymouth","2000","Plymouth town, MA",798,26811,27609
"5753","Plymouth","Plymouth County","MA","Plymouth","2001","Plymouth town, MA",969,27153,28122
"5754","Plymouth","Plymouth County","MA","Plymouth","2002","Plymouth town, MA",1397,27073,28470
"5755","Plymouth","Plymouth County","MA","Plymouth","2003","Plymouth town, MA",1607,26949,28556
"5756","Plymouth","Plymouth County","MA","Plymouth","2004","Plymouth town, MA",1504,27141,28645
"5757","Plymouth","Plymouth County","MA","Plymouth","2005","Plymouth town, MA",1436,27590,29026
"5758","Plymouth","Plymouth County","MA","Plymouth","2006","Plymouth town, MA",1485,27782,29267
"5759","Plymouth","Plymouth County","MA","Plymouth","2007","Plymouth town, MA",1500,27993,29493
"5760","Plymouth","Plymouth County","MA","Plymouth","2008","Plymouth town, MA",1778,27987,29765
"5761","Plymouth","Plymouth County","MA","Plymouth","2009","Plymouth town, MA",2658,27248,29906
"5762","Plymouth","Plymouth County","MA","Plymouth","2010","Plymouth town, MA",2730,27475,30205
"5763","Plymouth","Plymouth County","MA","Plymouth","2011","Plymouth town, MA",2310,27739,30049
"5764","Plymouth","Plymouth County","MA","Plymouth","2012","Plymouth town, MA",2037,28043,30080
"5765",NA,"Plymouth County","MA","Plymouth County","1990","Plymouth County, MA",16591,213304,229895
"5766",NA,"Plymouth County","MA","Plymouth County","1991","Plymouth County, MA",23024,206112,229136
"5767",NA,"Plymouth County","MA","Plymouth County","1992","Plymouth County, MA",23072,205069,228141
"5768",NA,"Plymouth County","MA","Plymouth County","1993","Plymouth County, MA",18655,211148,229803
"5769",NA,"Plymouth County","MA","Plymouth County","1994","Plymouth County, MA",15324,219713,235037
"5770",NA,"Plymouth County","MA","Plymouth County","1995","Plymouth County, MA",13857,222783,236640
"5771",NA,"Plymouth County","MA","Plymouth County","1996","Plymouth County, MA",12338,226755,239093
"5772",NA,"Plymouth County","MA","Plymouth County","1997","Plymouth County, MA",10979,234614,245593
"5773",NA,"Plymouth County","MA","Plymouth County","1998","Plymouth County, MA",8806,239095,247901
"5774",NA,"Plymouth County","MA","Plymouth County","1999","Plymouth County, MA",8417,243802,252219
"5775",NA,"Plymouth County","MA","Plymouth County","2000","Plymouth County, MA",6852,244511,251363
"5776",NA,"Plymouth County","MA","Plymouth County","2001","Plymouth County, MA",8853,245526,254379
"5777",NA,"Plymouth County","MA","Plymouth County","2002","Plymouth County, MA",12531,244480,257011
"5778",NA,"Plymouth County","MA","Plymouth County","2003","Plymouth County, MA",14335,241944,256279
"5779",NA,"Plymouth County","MA","Plymouth County","2004","Plymouth County, MA",13478,243072,256550
"5780",NA,"Plymouth County","MA","Plymouth County","2005","Plymouth County, MA",12553,245802,258355
"5781",NA,"Plymouth County","MA","Plymouth County","2006","Plymouth County, MA",12630,246134,258764
"5782",NA,"Plymouth County","MA","Plymouth County","2007","Plymouth County, MA",12468,247825,260293
"5783",NA,"Plymouth County","MA","Plymouth County","2008","Plymouth County, MA",14829,247395,262224
"5784",NA,"Plymouth County","MA","Plymouth County","2009","Plymouth County, MA",22505,241335,263840
"5785",NA,"Plymouth County","MA","Plymouth County","2010","Plymouth County, MA",23297,241283,264580
"5786",NA,"Plymouth County","MA","Plymouth County","2011","Plymouth County, MA",20344,243563,263907
"5787",NA,"Plymouth County","MA","Plymouth County","2012","Plymouth County, MA",18274,246026,264300
"5788","Plympton","Plymouth County","MA","Plympton","1990","Plympton town, MA",96,1271,1367
"5789","Plympton","Plymouth County","MA","Plympton","1991","Plympton town, MA",130,1268,1398
"5790","Plympton","Plymouth County","MA","Plympton","1992","Plympton town, MA",144,1231,1375
"5791","Plympton","Plymouth County","MA","Plympton","1993","Plympton town, MA",135,1314,1449
"5792","Plympton","Plymouth County","MA","Plympton","1994","Plympton town, MA",108,1406,1514
"5793","Plympton","Plymouth County","MA","Plympton","1995","Plympton town, MA",92,1406,1498
"5794","Plympton","Plymouth County","MA","Plympton","1996","Plympton town, MA",85,1423,1508
"5795","Plympton","Plymouth County","MA","Plympton","1997","Plympton town, MA",57,1472,1529
"5796","Plympton","Plymouth County","MA","Plympton","1998","Plympton town, MA",53,1500,1553
"5797","Plympton","Plymouth County","MA","Plympton","1999","Plympton town, MA",51,1531,1582
"5798","Plympton","Plymouth County","MA","Plympton","2000","Plympton town, MA",42,1521,1563
"5799","Plympton","Plymouth County","MA","Plympton","2001","Plympton town, MA",47,1520,1567
"5800","Plympton","Plymouth County","MA","Plympton","2002","Plympton town, MA",62,1512,1574
"5801","Plympton","Plymouth County","MA","Plympton","2003","Plympton town, MA",91,1490,1581
"5802","Plympton","Plymouth County","MA","Plympton","2004","Plympton town, MA",85,1500,1585
"5803","Plympton","Plymouth County","MA","Plympton","2005","Plympton town, MA",76,1520,1596
"5804","Plympton","Plymouth County","MA","Plympton","2006","Plympton town, MA",82,1530,1612
"5805","Plympton","Plymouth County","MA","Plympton","2007","Plympton town, MA",82,1556,1638
"5806","Plympton","Plymouth County","MA","Plympton","2008","Plympton town, MA",97,1552,1649
"5807","Plympton","Plymouth County","MA","Plympton","2009","Plympton town, MA",133,1507,1640
"5808","Plympton","Plymouth County","MA","Plympton","2010","Plympton town, MA",136,1516,1652
"5809","Plympton","Plymouth County","MA","Plympton","2011","Plympton town, MA",121,1532,1653
"5810","Plympton","Plymouth County","MA","Plympton","2012","Plympton town, MA",112,1545,1657
"5811","Princeton","Worcester County","MA","Princeton","1990","Princeton town, MA",74,1790,1864
"5812","Princeton","Worcester County","MA","Princeton","1991","Princeton town, MA",110,1741,1851
"5813","Princeton","Worcester County","MA","Princeton","1992","Princeton town, MA",99,1759,1858
"5814","Princeton","Worcester County","MA","Princeton","1993","Princeton town, MA",100,1835,1935
"5815","Princeton","Worcester County","MA","Princeton","1994","Princeton town, MA",86,1911,1997
"5816","Princeton","Worcester County","MA","Princeton","1995","Princeton town, MA",90,1837,1927
"5817","Princeton","Worcester County","MA","Princeton","1996","Princeton town, MA",55,1879,1934
"5818","Princeton","Worcester County","MA","Princeton","1997","Princeton town, MA",48,1939,1987
"5819","Princeton","Worcester County","MA","Princeton","1998","Princeton town, MA",43,1989,2032
"5820","Princeton","Worcester County","MA","Princeton","1999","Princeton town, MA",51,1993,2044
"5821","Princeton","Worcester County","MA","Princeton","2000","Princeton town, MA",41,1869,1910
"5822","Princeton","Worcester County","MA","Princeton","2001","Princeton town, MA",53,1879,1932
"5823","Princeton","Worcester County","MA","Princeton","2002","Princeton town, MA",87,1879,1966
"5824","Princeton","Worcester County","MA","Princeton","2003","Princeton town, MA",96,1882,1978
"5825","Princeton","Worcester County","MA","Princeton","2004","Princeton town, MA",92,1878,1970
"5826","Princeton","Worcester County","MA","Princeton","2005","Princeton town, MA",88,1885,1973
"5827","Princeton","Worcester County","MA","Princeton","2006","Princeton town, MA",75,1896,1971
"5828","Princeton","Worcester County","MA","Princeton","2007","Princeton town, MA",68,1895,1963
"5829","Princeton","Worcester County","MA","Princeton","2008","Princeton town, MA",92,1852,1944
"5830","Princeton","Worcester County","MA","Princeton","2009","Princeton town, MA",128,1801,1929
"5831","Princeton","Worcester County","MA","Princeton","2010","Princeton town, MA",123,1748,1871
"5832","Princeton","Worcester County","MA","Princeton","2011","Princeton town, MA",107,1763,1870
"5833","Princeton","Worcester County","MA","Princeton","2012","Princeton town, MA",103,1762,1865
"5834","Provincetown","Barnstable County","MA","Provincetown","1990","Provincetown town, MA",712,2516,3228
"5835","Provincetown","Barnstable County","MA","Provincetown","1991","Provincetown town, MA",864,2489,3353
"5836","Provincetown","Barnstable County","MA","Provincetown","1992","Provincetown town, MA",1004,2492,3496
"5837","Provincetown","Barnstable County","MA","Provincetown","1993","Provincetown town, MA",1100,2560,3660
"5838","Provincetown","Barnstable County","MA","Provincetown","1994","Provincetown town, MA",1047,2562,3609
"5839","Provincetown","Barnstable County","MA","Provincetown","1995","Provincetown town, MA",940,2670,3610
"5840","Provincetown","Barnstable County","MA","Provincetown","1996","Provincetown town, MA",816,2667,3483
"5841","Provincetown","Barnstable County","MA","Provincetown","1997","Provincetown town, MA",811,2660,3471
"5842","Provincetown","Barnstable County","MA","Provincetown","1998","Provincetown town, MA",705,2702,3407
"5843","Provincetown","Barnstable County","MA","Provincetown","1999","Provincetown town, MA",632,2751,3383
"5844","Provincetown","Barnstable County","MA","Provincetown","2000","Provincetown town, MA",369,1756,2125
"5845","Provincetown","Barnstable County","MA","Provincetown","2001","Provincetown town, MA",357,1774,2131
"5846","Provincetown","Barnstable County","MA","Provincetown","2002","Provincetown town, MA",392,1794,2186
"5847","Provincetown","Barnstable County","MA","Provincetown","2003","Provincetown town, MA",420,1818,2238
"5848","Provincetown","Barnstable County","MA","Provincetown","2004","Provincetown town, MA",412,1825,2237
"5849","Provincetown","Barnstable County","MA","Provincetown","2005","Provincetown town, MA",401,1824,2225
"5850","Provincetown","Barnstable County","MA","Provincetown","2006","Provincetown town, MA",394,1834,2228
"5851","Provincetown","Barnstable County","MA","Provincetown","2007","Provincetown town, MA",340,1832,2172
"5852","Provincetown","Barnstable County","MA","Provincetown","2008","Provincetown town, MA",354,1822,2176
"5853","Provincetown","Barnstable County","MA","Provincetown","2009","Provincetown town, MA",458,1793,2251
"5854","Provincetown","Barnstable County","MA","Provincetown","2010","Provincetown town, MA",490,1566,2056
"5855","Provincetown","Barnstable County","MA","Provincetown","2011","Provincetown town, MA",518,1563,2081
"5856","Provincetown","Barnstable County","MA","Provincetown","2012","Provincetown town, MA",485,1589,2074
"5857","Quincy","Norfolk County","MA","Quincy","1990","Quincy city, MA",2899,46343,49242
"5858","Quincy","Norfolk County","MA","Quincy","1991","Quincy city, MA",4258,44640,48898
"5859","Quincy","Norfolk County","MA","Quincy","1992","Quincy city, MA",4231,44318,48549
"5860","Quincy","Norfolk County","MA","Quincy","1993","Quincy city, MA",3478,44636,48114
"5861","Quincy","Norfolk County","MA","Quincy","1994","Quincy city, MA",2836,44913,47749
"5862","Quincy","Norfolk County","MA","Quincy","1995","Quincy city, MA",2738,46116,48854
"5863","Quincy","Norfolk County","MA","Quincy","1996","Quincy city, MA",2220,46910,49130
"5864","Quincy","Norfolk County","MA","Quincy","1997","Quincy city, MA",1980,48041,50021
"5865","Quincy","Norfolk County","MA","Quincy","1998","Quincy city, MA",1579,48706,50285
"5866","Quincy","Norfolk County","MA","Quincy","1999","Quincy city, MA",1495,49068,50563
"5867","Quincy","Norfolk County","MA","Quincy","2000","Quincy city, MA",1377,49550,50927
"5868","Quincy","Norfolk County","MA","Quincy","2001","Quincy city, MA",1816,49688,51504
"5869","Quincy","Norfolk County","MA","Quincy","2002","Quincy city, MA",2662,48904,51566
"5870","Quincy","Norfolk County","MA","Quincy","2003","Quincy city, MA",3054,48181,51235
"5871","Quincy","Norfolk County","MA","Quincy","2004","Quincy city, MA",2689,48657,51346
"5872","Quincy","Norfolk County","MA","Quincy","2005","Quincy city, MA",2409,49345,51754
"5873","Quincy","Norfolk County","MA","Quincy","2006","Quincy city, MA",2366,48596,50962
"5874","Quincy","Norfolk County","MA","Quincy","2007","Quincy city, MA",2227,48903,51130
"5875","Quincy","Norfolk County","MA","Quincy","2008","Quincy city, MA",2752,48871,51623
"5876","Quincy","Norfolk County","MA","Quincy","2009","Quincy city, MA",4200,47494,51694
"5877","Quincy","Norfolk County","MA","Quincy","2010","Quincy city, MA",4296,48866,53162
"5878","Quincy","Norfolk County","MA","Quincy","2011","Quincy city, MA",3680,49414,53094
"5879","Quincy","Norfolk County","MA","Quincy","2012","Quincy city, MA",3226,49955,53181
"5880","Randolph","Norfolk County","MA","Randolph","1990","Randolph town, MA",1026,15894,16920
"5881","Randolph","Norfolk County","MA","Randolph","1991","Randolph town, MA",1498,15483,16981
"5882","Randolph","Norfolk County","MA","Randolph","1992","Randolph town, MA",1490,15400,16890
"5883","Randolph","Norfolk County","MA","Randolph","1993","Randolph town, MA",1190,15485,16675
"5884","Randolph","Norfolk County","MA","Randolph","1994","Randolph town, MA",1074,15574,16648
"5885","Randolph","Norfolk County","MA","Randolph","1995","Randolph town, MA",946,15934,16880
"5886","Randolph","Norfolk County","MA","Randolph","1996","Randolph town, MA",820,16210,17030
"5887","Randolph","Norfolk County","MA","Randolph","1997","Randolph town, MA",701,16580,17281
"5888","Randolph","Norfolk County","MA","Randolph","1998","Randolph town, MA",607,16794,17401
"5889","Randolph","Norfolk County","MA","Randolph","1999","Randolph town, MA",566,16879,17445
"5890","Randolph","Norfolk County","MA","Randolph","2000","Randolph town, MA",466,16662,17128
"5891","Randolph","Norfolk County","MA","Randolph","2001","Randolph town, MA",653,16592,17245
"5892","Randolph","Norfolk County","MA","Randolph","2002","Randolph town, MA",995,16286,17281
"5893","Randolph","Norfolk County","MA","Randolph","2003","Randolph town, MA",1087,16000,17087
"5894","Randolph","Norfolk County","MA","Randolph","2004","Randolph town, MA",953,15936,16889
"5895","Randolph","Norfolk County","MA","Randolph","2005","Randolph town, MA",872,15953,16825
"5896","Randolph","Norfolk County","MA","Randolph","2006","Randolph town, MA",896,15655,16551
"5897","Randolph","Norfolk County","MA","Randolph","2007","Randolph town, MA",809,15743,16552
"5898","Randolph","Norfolk County","MA","Randolph","2008","Randolph town, MA",973,15711,16684
"5899","Randolph","Norfolk County","MA","Randolph","2009","Randolph town, MA",1439,15500,16939
"5900","Randolph","Norfolk County","MA","Randolph","2010","Randolph town, MA",1564,16286,17850
"5901","Randolph","Norfolk County","MA","Randolph","2011","Randolph town, MA",1367,16470,17837
"5902","Randolph","Norfolk County","MA","Randolph","2012","Randolph town, MA",1246,16650,17896
"5903","Raynham","Bristol County","MA","Raynham","1990","Raynham town, MA",371,5100,5471
"5904","Raynham","Bristol County","MA","Raynham","1991","Raynham town, MA",544,4904,5448
"5905","Raynham","Bristol County","MA","Raynham","1992","Raynham town, MA",561,4869,5430
"5906","Raynham","Bristol County","MA","Raynham","1993","Raynham town, MA",437,5152,5589
"5907","Raynham","Bristol County","MA","Raynham","1994","Raynham town, MA",420,5480,5900
"5908","Raynham","Bristol County","MA","Raynham","1995","Raynham town, MA",376,5487,5863
"5909","Raynham","Bristol County","MA","Raynham","1996","Raynham town, MA",319,5562,5881
"5910","Raynham","Bristol County","MA","Raynham","1997","Raynham town, MA",283,5756,6039
"5911","Raynham","Bristol County","MA","Raynham","1998","Raynham town, MA",202,5822,6024
"5912","Raynham","Bristol County","MA","Raynham","1999","Raynham town, MA",207,5957,6164
"5913","Raynham","Bristol County","MA","Raynham","2000","Raynham town, MA",150,6592,6742
"5914","Raynham","Bristol County","MA","Raynham","2001","Raynham town, MA",217,6664,6881
"5915","Raynham","Bristol County","MA","Raynham","2002","Raynham town, MA",321,6754,7075
"5916","Raynham","Bristol County","MA","Raynham","2003","Raynham town, MA",362,6854,7216
"5917","Raynham","Bristol County","MA","Raynham","2004","Raynham town, MA",365,7237,7602
"5918","Raynham","Bristol County","MA","Raynham","2005","Raynham town, MA",329,7462,7791
"5919","Raynham","Bristol County","MA","Raynham","2006","Raynham town, MA",333,7648,7981
"5920","Raynham","Bristol County","MA","Raynham","2007","Raynham town, MA",333,7701,8034
"5921","Raynham","Bristol County","MA","Raynham","2008","Raynham town, MA",412,7648,8060
"5922","Raynham","Bristol County","MA","Raynham","2009","Raynham town, MA",624,7354,7978
"5923","Raynham","Bristol County","MA","Raynham","2010","Raynham town, MA",619,7228,7847
"5924","Raynham","Bristol County","MA","Raynham","2011","Raynham town, MA",569,7304,7873
"5925","Raynham","Bristol County","MA","Raynham","2012","Raynham town, MA",477,7282,7759
"5926","Reading","Middlesex County","MA","Reading","1990","Reading town, MA",635,12258,12893
"5927","Reading","Middlesex County","MA","Reading","1991","Reading town, MA",897,11856,12753
"5928","Reading","Middlesex County","MA","Reading","1992","Reading town, MA",904,11803,12707
"5929","Reading","Middlesex County","MA","Reading","1993","Reading town, MA",641,11962,12603
"5930","Reading","Middlesex County","MA","Reading","1994","Reading town, MA",565,12156,12721
"5931","Reading","Middlesex County","MA","Reading","1995","Reading town, MA",473,12266,12739
"5932","Reading","Middlesex County","MA","Reading","1996","Reading town, MA",418,12532,12950
"5933","Reading","Middlesex County","MA","Reading","1997","Reading town, MA",382,12970,13352
"5934","Reading","Middlesex County","MA","Reading","1998","Reading town, MA",308,13226,13534
"5935","Reading","Middlesex County","MA","Reading","1999","Reading town, MA",309,13317,13626
"5936","Reading","Middlesex County","MA","Reading","2000","Reading town, MA",268,12909,13177
"5937","Reading","Middlesex County","MA","Reading","2001","Reading town, MA",393,12840,13233
"5938","Reading","Middlesex County","MA","Reading","2002","Reading town, MA",597,12567,13164
"5939","Reading","Middlesex County","MA","Reading","2003","Reading town, MA",666,12327,12993
"5940","Reading","Middlesex County","MA","Reading","2004","Reading town, MA",537,12247,12784
"5941","Reading","Middlesex County","MA","Reading","2005","Reading town, MA",478,12272,12750
"5942","Reading","Middlesex County","MA","Reading","2006","Reading town, MA",461,12119,12580
"5943","Reading","Middlesex County","MA","Reading","2007","Reading town, MA",425,12209,12634
"5944","Reading","Middlesex County","MA","Reading","2008","Reading town, MA",518,12202,12720
"5945","Reading","Middlesex County","MA","Reading","2009","Reading town, MA",878,11884,12762
"5946","Reading","Middlesex County","MA","Reading","2010","Reading town, MA",820,12699,13519
"5947","Reading","Middlesex County","MA","Reading","2011","Reading town, MA",738,12884,13622
"5948","Reading","Middlesex County","MA","Reading","2012","Reading town, MA",652,13025,13677
"5949","Rehoboth","Bristol County","MA","Rehoboth","1990","Rehoboth town, MA",297,4609,4906
"5950","Rehoboth","Bristol County","MA","Rehoboth","1991","Rehoboth town, MA",516,4464,4980
"5951","Rehoboth","Bristol County","MA","Rehoboth","1992","Rehoboth town, MA",572,4575,5147
"5952","Rehoboth","Bristol County","MA","Rehoboth","1993","Rehoboth town, MA",469,4725,5194
"5953","Rehoboth","Bristol County","MA","Rehoboth","1994","Rehoboth town, MA",437,4882,5319
"5954","Rehoboth","Bristol County","MA","Rehoboth","1995","Rehoboth town, MA",364,4950,5314
"5955","Rehoboth","Bristol County","MA","Rehoboth","1996","Rehoboth town, MA",321,5011,5332
"5956","Rehoboth","Bristol County","MA","Rehoboth","1997","Rehoboth town, MA",268,5154,5422
"5957","Rehoboth","Bristol County","MA","Rehoboth","1998","Rehoboth town, MA",205,5302,5507
"5958","Rehoboth","Bristol County","MA","Rehoboth","1999","Rehoboth town, MA",181,5414,5595
"5959","Rehoboth","Bristol County","MA","Rehoboth","2000","Rehoboth town, MA",197,5850,6047
"5960","Rehoboth","Bristol County","MA","Rehoboth","2001","Rehoboth town, MA",238,5939,6177
"5961","Rehoboth","Bristol County","MA","Rehoboth","2002","Rehoboth town, MA",308,6055,6363
"5962","Rehoboth","Bristol County","MA","Rehoboth","2003","Rehoboth town, MA",321,6208,6529
"5963","Rehoboth","Bristol County","MA","Rehoboth","2004","Rehoboth town, MA",310,6307,6617
"5964","Rehoboth","Bristol County","MA","Rehoboth","2005","Rehoboth town, MA",305,6420,6725
"5965","Rehoboth","Bristol County","MA","Rehoboth","2006","Rehoboth town, MA",333,6555,6888
"5966","Rehoboth","Bristol County","MA","Rehoboth","2007","Rehoboth town, MA",300,6635,6935
"5967","Rehoboth","Bristol County","MA","Rehoboth","2008","Rehoboth town, MA",404,6530,6934
"5968","Rehoboth","Bristol County","MA","Rehoboth","2009","Rehoboth town, MA",645,6247,6892
"5969","Rehoboth","Bristol County","MA","Rehoboth","2010","Rehoboth town, MA",648,6279,6927
"5970","Rehoboth","Bristol County","MA","Rehoboth","2011","Rehoboth town, MA",592,6324,6916
"5971","Rehoboth","Bristol County","MA","Rehoboth","2012","Rehoboth town, MA",547,6334,6881
"5972","Revere","Suffolk County","MA","Revere","1990","Revere city, MA",1649,20331,21980
"5973","Revere","Suffolk County","MA","Revere","1991","Revere city, MA",2346,19788,22134
"5974","Revere","Suffolk County","MA","Revere","1992","Revere city, MA",2370,19516,21886
"5975","Revere","Suffolk County","MA","Revere","1993","Revere city, MA",1847,19532,21379
"5976","Revere","Suffolk County","MA","Revere","1994","Revere city, MA",1601,19470,21071
"5977","Revere","Suffolk County","MA","Revere","1995","Revere city, MA",1500,19684,21184
"5978","Revere","Suffolk County","MA","Revere","1996","Revere city, MA",1138,19942,21080
"5979","Revere","Suffolk County","MA","Revere","1997","Revere city, MA",1098,20330,21428
"5980","Revere","Suffolk County","MA","Revere","1998","Revere city, MA",874,20606,21480
"5981","Revere","Suffolk County","MA","Revere","1999","Revere city, MA",926,20792,21718
"5982","Revere","Suffolk County","MA","Revere","2000","Revere city, MA",749,21873,22622
"5983","Revere","Suffolk County","MA","Revere","2001","Revere city, MA",945,21874,22819
"5984","Revere","Suffolk County","MA","Revere","2002","Revere city, MA",1433,21377,22810
"5985","Revere","Suffolk County","MA","Revere","2003","Revere city, MA",1703,20782,22485
"5986","Revere","Suffolk County","MA","Revere","2004","Revere city, MA",1418,20534,21952
"5987","Revere","Suffolk County","MA","Revere","2005","Revere city, MA",1324,20616,21940
"5988","Revere","Suffolk County","MA","Revere","2006","Revere city, MA",1348,22245,23593
"5989","Revere","Suffolk County","MA","Revere","2007","Revere city, MA",1238,22871,24109
"5990","Revere","Suffolk County","MA","Revere","2008","Revere city, MA",1499,22744,24243
"5991","Revere","Suffolk County","MA","Revere","2009","Revere city, MA",2222,22201,24423
"5992","Revere","Suffolk County","MA","Revere","2010","Revere city, MA",2286,22562,24848
"5993","Revere","Suffolk County","MA","Revere","2011","Revere city, MA",2035,22966,25001
"5994","Revere","Suffolk County","MA","Revere","2012","Revere city, MA",1884,23218,25102
"5995","Richmond","Berkshire County","MA","Richmond","1990","Richmond town, MA",28,861,889
"5996","Richmond","Berkshire County","MA","Richmond","1991","Richmond town, MA",44,835,879
"5997","Richmond","Berkshire County","MA","Richmond","1992","Richmond town, MA",65,826,891
"5998","Richmond","Berkshire County","MA","Richmond","1993","Richmond town, MA",43,812,855
"5999","Richmond","Berkshire County","MA","Richmond","1994","Richmond town, MA",31,815,846
"6000","Richmond","Berkshire County","MA","Richmond","1995","Richmond town, MA",33,793,826
"6001","Richmond","Berkshire County","MA","Richmond","1996","Richmond town, MA",23,803,826
"6002","Richmond","Berkshire County","MA","Richmond","1997","Richmond town, MA",25,813,838
"6003","Richmond","Berkshire County","MA","Richmond","1998","Richmond town, MA",23,820,843
"6004","Richmond","Berkshire County","MA","Richmond","1999","Richmond town, MA",19,828,847
"6005","Richmond","Berkshire County","MA","Richmond","2000","Richmond town, MA",15,917,932
"6006","Richmond","Berkshire County","MA","Richmond","2001","Richmond town, MA",18,921,939
"6007","Richmond","Berkshire County","MA","Richmond","2002","Richmond town, MA",23,940,963
"6008","Richmond","Berkshire County","MA","Richmond","2003","Richmond town, MA",34,941,975
"6009","Richmond","Berkshire County","MA","Richmond","2004","Richmond town, MA",32,951,983
"6010","Richmond","Berkshire County","MA","Richmond","2005","Richmond town, MA",33,961,994
"6011","Richmond","Berkshire County","MA","Richmond","2006","Richmond town, MA",26,973,999
"6012","Richmond","Berkshire County","MA","Richmond","2007","Richmond town, MA",30,967,997
"6013","Richmond","Berkshire County","MA","Richmond","2008","Richmond town, MA",29,949,978
"6014","Richmond","Berkshire County","MA","Richmond","2009","Richmond town, MA",48,922,970
"6015","Richmond","Berkshire County","MA","Richmond","2010","Richmond town, MA",40,835,875
"6016","Richmond","Berkshire County","MA","Richmond","2011","Richmond town, MA",39,842,881
"6017","Richmond","Berkshire County","MA","Richmond","2012","Richmond town, MA",28,838,866
"6018","Rochester","Plymouth County","MA","Rochester","1990","Rochester town, MA",138,2003,2141
"6019","Rochester","Plymouth County","MA","Rochester","1991","Rochester town, MA",200,1961,2161
"6020","Rochester","Plymouth County","MA","Rochester","1992","Rochester town, MA",194,1993,2187
"6021","Rochester","Plymouth County","MA","Rochester","1993","Rochester town, MA",162,2132,2294
"6022","Rochester","Plymouth County","MA","Rochester","1994","Rochester town, MA",158,2236,2394
"6023","Rochester","Plymouth County","MA","Rochester","1995","Rochester town, MA",160,2170,2330
"6024","Rochester","Plymouth County","MA","Rochester","1996","Rochester town, MA",128,2182,2310
"6025","Rochester","Plymouth County","MA","Rochester","1997","Rochester town, MA",121,2269,2390
"6026","Rochester","Plymouth County","MA","Rochester","1998","Rochester town, MA",87,2340,2427
"6027","Rochester","Plymouth County","MA","Rochester","1999","Rochester town, MA",83,2414,2497
"6028","Rochester","Plymouth County","MA","Rochester","2000","Rochester town, MA",67,2561,2628
"6029","Rochester","Plymouth County","MA","Rochester","2001","Rochester town, MA",83,2626,2709
"6030","Rochester","Plymouth County","MA","Rochester","2002","Rochester town, MA",125,2694,2819
"6031","Rochester","Plymouth County","MA","Rochester","2003","Rochester town, MA",135,2705,2840
"6032","Rochester","Plymouth County","MA","Rochester","2004","Rochester town, MA",130,2788,2918
"6033","Rochester","Plymouth County","MA","Rochester","2005","Rochester town, MA",125,2892,3017
"6034","Rochester","Plymouth County","MA","Rochester","2006","Rochester town, MA",113,2996,3109
"6035","Rochester","Plymouth County","MA","Rochester","2007","Rochester town, MA",124,2900,3024
"6036","Rochester","Plymouth County","MA","Rochester","2008","Rochester town, MA",143,2851,2994
"6037","Rochester","Plymouth County","MA","Rochester","2009","Rochester town, MA",222,2782,3004
"6038","Rochester","Plymouth County","MA","Rochester","2010","Rochester town, MA",233,2714,2947
"6039","Rochester","Plymouth County","MA","Rochester","2011","Rochester town, MA",217,2755,2972
"6040","Rochester","Plymouth County","MA","Rochester","2012","Rochester town, MA",194,2787,2981
"6041","Rockland","Plymouth County","MA","Rockland","1990","Rockland town, MA",675,8160,8835
"6042","Rockland","Plymouth County","MA","Rockland","1991","Rockland town, MA",912,7868,8780
"6043","Rockland","Plymouth County","MA","Rockland","1992","Rockland town, MA",854,7921,8775
"6044","Rockland","Plymouth County","MA","Rockland","1993","Rockland town, MA",694,8054,8748
"6045","Rockland","Plymouth County","MA","Rockland","1994","Rockland town, MA",570,8249,8819
"6046","Rockland","Plymouth County","MA","Rockland","1995","Rockland town, MA",544,8477,9021
"6047","Rockland","Plymouth County","MA","Rockland","1996","Rockland town, MA",455,8736,9191
"6048","Rockland","Plymouth County","MA","Rockland","1997","Rockland town, MA",383,9067,9450
"6049","Rockland","Plymouth County","MA","Rockland","1998","Rockland town, MA",326,9283,9609
"6050","Rockland","Plymouth County","MA","Rockland","1999","Rockland town, MA",339,9482,9821
"6051","Rockland","Plymouth County","MA","Rockland","2000","Rockland town, MA",286,9680,9966
"6052","Rockland","Plymouth County","MA","Rockland","2001","Rockland town, MA",322,9698,10020
"6053","Rockland","Plymouth County","MA","Rockland","2002","Rockland town, MA",480,9610,10090
"6054","Rockland","Plymouth County","MA","Rockland","2003","Rockland town, MA",544,9448,9992
"6055","Rockland","Plymouth County","MA","Rockland","2004","Rockland town, MA",543,9402,9945
"6056","Rockland","Plymouth County","MA","Rockland","2005","Rockland town, MA",494,9491,9985
"6057","Rockland","Plymouth County","MA","Rockland","2006","Rockland town, MA",496,9347,9843
"6058","Rockland","Plymouth County","MA","Rockland","2007","Rockland town, MA",507,9431,9938
"6059","Rockland","Plymouth County","MA","Rockland","2008","Rockland town, MA",558,9455,10013
"6060","Rockland","Plymouth County","MA","Rockland","2009","Rockland town, MA",867,9182,10049
"6061","Rockland","Plymouth County","MA","Rockland","2010","Rockland town, MA",899,9012,9911
"6062","Rockland","Plymouth County","MA","Rockland","2011","Rockland town, MA",710,9099,9809
"6063","Rockland","Plymouth County","MA","Rockland","2012","Rockland town, MA",654,9199,9853
"6064","Rockport","Essex County","MA","Rockport","1990","Rockport town, MA",281,3778,4059
"6065","Rockport","Essex County","MA","Rockport","1991","Rockport town, MA",367,3672,4039
"6066","Rockport","Essex County","MA","Rockport","1992","Rockport town, MA",408,3688,4096
"6067","Rockport","Essex County","MA","Rockport","1993","Rockport town, MA",345,3796,4141
"6068","Rockport","Essex County","MA","Rockport","1994","Rockport town, MA",275,3876,4151
"6069","Rockport","Essex County","MA","Rockport","1995","Rockport town, MA",236,3760,3996
"6070","Rockport","Essex County","MA","Rockport","1996","Rockport town, MA",207,3839,4046
"6071","Rockport","Essex County","MA","Rockport","1997","Rockport town, MA",180,3935,4115
"6072","Rockport","Essex County","MA","Rockport","1998","Rockport town, MA",165,4016,4181
"6073","Rockport","Essex County","MA","Rockport","1999","Rockport town, MA",137,4059,4196
"6074","Rockport","Essex County","MA","Rockport","2000","Rockport town, MA",124,4094,4218
"6075","Rockport","Essex County","MA","Rockport","2001","Rockport town, MA",175,4096,4271
"6076","Rockport","Essex County","MA","Rockport","2002","Rockport town, MA",219,4036,4255
"6077","Rockport","Essex County","MA","Rockport","2003","Rockport town, MA",247,3973,4220
"6078","Rockport","Essex County","MA","Rockport","2004","Rockport town, MA",223,3953,4176
"6079","Rockport","Essex County","MA","Rockport","2005","Rockport town, MA",195,3976,4171
"6080","Rockport","Essex County","MA","Rockport","2006","Rockport town, MA",190,3850,4040
"6081","Rockport","Essex County","MA","Rockport","2007","Rockport town, MA",172,3870,4042
"6082","Rockport","Essex County","MA","Rockport","2008","Rockport town, MA",218,3870,4088
"6083","Rockport","Essex County","MA","Rockport","2009","Rockport town, MA",313,3750,4063
"6084","Rockport","Essex County","MA","Rockport","2010","Rockport town, MA",317,3448,3765
"6085","Rockport","Essex County","MA","Rockport","2011","Rockport town, MA",287,3490,3777
"6086","Rockport","Essex County","MA","Rockport","2012","Rockport town, MA",235,3529,3764
"6087","Rowe","Franklin County","MA","Rowe","1990","Rowe town, MA",18,152,170
"6088","Rowe","Franklin County","MA","Rowe","1991","Rowe town, MA",12,149,161
"6089","Rowe","Franklin County","MA","Rowe","1992","Rowe town, MA",18,150,168
"6090","Rowe","Franklin County","MA","Rowe","1993","Rowe town, MA",21,152,173
"6091","Rowe","Franklin County","MA","Rowe","1994","Rowe town, MA",19,159,178
"6092","Rowe","Franklin County","MA","Rowe","1995","Rowe town, MA",12,155,167
"6093","Rowe","Franklin County","MA","Rowe","1996","Rowe town, MA",11,155,166
"6094","Rowe","Franklin County","MA","Rowe","1997","Rowe town, MA",8,158,166
"6095","Rowe","Franklin County","MA","Rowe","1998","Rowe town, MA",10,160,170
"6096","Rowe","Franklin County","MA","Rowe","1999","Rowe town, MA",7,163,170
"6097","Rowe","Franklin County","MA","Rowe","2000","Rowe town, MA",8,182,190
"6098","Rowe","Franklin County","MA","Rowe","2001","Rowe town, MA",6,180,186
"6099","Rowe","Franklin County","MA","Rowe","2002","Rowe town, MA",9,182,191
"6100","Rowe","Franklin County","MA","Rowe","2003","Rowe town, MA",13,182,195
"6101","Rowe","Franklin County","MA","Rowe","2004","Rowe town, MA",10,178,188
"6102","Rowe","Franklin County","MA","Rowe","2005","Rowe town, MA",11,178,189
"6103","Rowe","Franklin County","MA","Rowe","2006","Rowe town, MA",10,181,191
"6104","Rowe","Franklin County","MA","Rowe","2007","Rowe town, MA",11,177,188
"6105","Rowe","Franklin County","MA","Rowe","2008","Rowe town, MA",8,175,183
"6106","Rowe","Franklin County","MA","Rowe","2009","Rowe town, MA",16,169,185
"6107","Rowe","Franklin County","MA","Rowe","2010","Rowe town, MA",16,194,210
"6108","Rowe","Franklin County","MA","Rowe","2011","Rowe town, MA",14,195,209
"6109","Rowe","Franklin County","MA","Rowe","2012","Rowe town, MA",11,196,207
"6110","Rowley","Essex County","MA","Rowley","1990","Rowley town, MA",190,2480,2670
"6111","Rowley","Essex County","MA","Rowley","1991","Rowley town, MA",191,2488,2679
"6112","Rowley","Essex County","MA","Rowley","1992","Rowley town, MA",190,2574,2764
"6113","Rowley","Essex County","MA","Rowley","1993","Rowley town, MA",125,2705,2830
"6114","Rowley","Essex County","MA","Rowley","1994","Rowley town, MA",122,2801,2923
"6115","Rowley","Essex County","MA","Rowley","1995","Rowley town, MA",108,2816,2924
"6116","Rowley","Essex County","MA","Rowley","1996","Rowley town, MA",105,2892,2997
"6117","Rowley","Essex County","MA","Rowley","1997","Rowley town, MA",103,2990,3093
"6118","Rowley","Essex County","MA","Rowley","1998","Rowley town, MA",76,3075,3151
"6119","Rowley","Essex County","MA","Rowley","1999","Rowley town, MA",67,3173,3240
"6120","Rowley","Essex County","MA","Rowley","2000","Rowley town, MA",59,3139,3198
"6121","Rowley","Essex County","MA","Rowley","2001","Rowley town, MA",90,3152,3242
"6122","Rowley","Essex County","MA","Rowley","2002","Rowley town, MA",154,3113,3267
"6123","Rowley","Essex County","MA","Rowley","2003","Rowley town, MA",160,3085,3245
"6124","Rowley","Essex County","MA","Rowley","2004","Rowley town, MA",140,3134,3274
"6125","Rowley","Essex County","MA","Rowley","2005","Rowley town, MA",145,3239,3384
"6126","Rowley","Essex County","MA","Rowley","2006","Rowley town, MA",134,3128,3262
"6127","Rowley","Essex County","MA","Rowley","2007","Rowley town, MA",123,3148,3271
"6128","Rowley","Essex County","MA","Rowley","2008","Rowley town, MA",150,3150,3300
"6129","Rowley","Essex County","MA","Rowley","2009","Rowley town, MA",244,3080,3324
"6130","Rowley","Essex County","MA","Rowley","2010","Rowley town, MA",249,3143,3392
"6131","Rowley","Essex County","MA","Rowley","2011","Rowley town, MA",232,3182,3414
"6132","Rowley","Essex County","MA","Rowley","2012","Rowley town, MA",187,3217,3404
"6133","Royalston","Worcester County","MA","Royalston","1990","Royalston town, MA",27,507,534
"6134","Royalston","Worcester County","MA","Royalston","1991","Royalston town, MA",57,506,563
"6135","Royalston","Worcester County","MA","Royalston","1992","Royalston town, MA",31,495,526
"6136","Royalston","Worcester County","MA","Royalston","1993","Royalston town, MA",43,498,541
"6137","Royalston","Worcester County","MA","Royalston","1994","Royalston town, MA",42,494,536
"6138","Royalston","Worcester County","MA","Royalston","1995","Royalston town, MA",29,496,525
"6139","Royalston","Worcester County","MA","Royalston","1996","Royalston town, MA",27,491,518
"6140","Royalston","Worcester County","MA","Royalston","1997","Royalston town, MA",23,503,526
"6141","Royalston","Worcester County","MA","Royalston","1998","Royalston town, MA",22,470,492
"6142","Royalston","Worcester County","MA","Royalston","1999","Royalston town, MA",21,473,494
"6143","Royalston","Worcester County","MA","Royalston","2000","Royalston town, MA",16,614,630
"6144","Royalston","Worcester County","MA","Royalston","2001","Royalston town, MA",27,611,638
"6145","Royalston","Worcester County","MA","Royalston","2002","Royalston town, MA",43,616,659
"6146","Royalston","Worcester County","MA","Royalston","2003","Royalston town, MA",46,615,661
"6147","Royalston","Worcester County","MA","Royalston","2004","Royalston town, MA",43,626,669
"6148","Royalston","Worcester County","MA","Royalston","2005","Royalston town, MA",40,625,665
"6149","Royalston","Worcester County","MA","Royalston","2006","Royalston town, MA",41,636,677
"6150","Royalston","Worcester County","MA","Royalston","2007","Royalston town, MA",37,638,675
"6151","Royalston","Worcester County","MA","Royalston","2008","Royalston town, MA",49,628,677
"6152","Royalston","Worcester County","MA","Royalston","2009","Royalston town, MA",64,583,647
"6153","Royalston","Worcester County","MA","Royalston","2010","Royalston town, MA",64,554,618
"6154","Royalston","Worcester County","MA","Royalston","2011","Royalston town, MA",63,554,617
"6155","Royalston","Worcester County","MA","Royalston","2012","Royalston town, MA",51,553,604
"6156","Russell","Hampden County","MA","Russell","1990","Russell town, MA",41,830,871
"6157","Russell","Hampden County","MA","Russell","1991","Russell town, MA",73,800,873
"6158","Russell","Hampden County","MA","Russell","1992","Russell town, MA",73,823,896
"6159","Russell","Hampden County","MA","Russell","1993","Russell town, MA",65,827,892
"6160","Russell","Hampden County","MA","Russell","1994","Russell town, MA",71,839,910
"6161","Russell","Hampden County","MA","Russell","1995","Russell town, MA",64,814,878
"6162","Russell","Hampden County","MA","Russell","1996","Russell town, MA",39,824,863
"6163","Russell","Hampden County","MA","Russell","1997","Russell town, MA",29,848,877
"6164","Russell","Hampden County","MA","Russell","1998","Russell town, MA",24,855,879
"6165","Russell","Hampden County","MA","Russell","1999","Russell town, MA",37,859,896
"6166","Russell","Hampden County","MA","Russell","2000","Russell town, MA",26,905,931
"6167","Russell","Hampden County","MA","Russell","2001","Russell town, MA",38,909,947
"6168","Russell","Hampden County","MA","Russell","2002","Russell town, MA",50,912,962
"6169","Russell","Hampden County","MA","Russell","2003","Russell town, MA",52,911,963
"6170","Russell","Hampden County","MA","Russell","2004","Russell town, MA",47,918,965
"6171","Russell","Hampden County","MA","Russell","2005","Russell town, MA",49,929,978
"6172","Russell","Hampden County","MA","Russell","2006","Russell town, MA",55,942,997
"6173","Russell","Hampden County","MA","Russell","2007","Russell town, MA",50,940,990
"6174","Russell","Hampden County","MA","Russell","2008","Russell town, MA",56,926,982
"6175","Russell","Hampden County","MA","Russell","2009","Russell town, MA",79,909,988
"6176","Russell","Hampden County","MA","Russell","2010","Russell town, MA",86,915,1001
"6177","Russell","Hampden County","MA","Russell","2011","Russell town, MA",70,905,975
"6178","Russell","Hampden County","MA","Russell","2012","Russell town, MA",65,906,971
"6179","Rutland","Worcester County","MA","Rutland","1990","Rutland town, MA",131,2647,2778
"6180","Rutland","Worcester County","MA","Rutland","1991","Rutland town, MA",244,2610,2854
"6181","Rutland","Worcester County","MA","Rutland","1992","Rutland town, MA",253,2639,2892
"6182","Rutland","Worcester County","MA","Rutland","1993","Rutland town, MA",187,2786,2973
"6183","Rutland","Worcester County","MA","Rutland","1994","Rutland town, MA",139,2903,3042
"6184","Rutland","Worcester County","MA","Rutland","1995","Rutland town, MA",129,2726,2855
"6185","Rutland","Worcester County","MA","Rutland","1996","Rutland town, MA",111,2794,2905
"6186","Rutland","Worcester County","MA","Rutland","1997","Rutland town, MA",94,2916,3010
"6187","Rutland","Worcester County","MA","Rutland","1998","Rutland town, MA",96,3028,3124
"6188","Rutland","Worcester County","MA","Rutland","1999","Rutland town, MA",85,3098,3183
"6189","Rutland","Worcester County","MA","Rutland","2000","Rutland town, MA",90,3514,3604
"6190","Rutland","Worcester County","MA","Rutland","2001","Rutland town, MA",110,3577,3687
"6191","Rutland","Worcester County","MA","Rutland","2002","Rutland town, MA",181,3658,3839
"6192","Rutland","Worcester County","MA","Rutland","2003","Rutland town, MA",200,3745,3945
"6193","Rutland","Worcester County","MA","Rutland","2004","Rutland town, MA",188,3847,4035
"6194","Rutland","Worcester County","MA","Rutland","2005","Rutland town, MA",163,3942,4105
"6195","Rutland","Worcester County","MA","Rutland","2006","Rutland town, MA",156,4055,4211
"6196","Rutland","Worcester County","MA","Rutland","2007","Rutland town, MA",182,4205,4387
"6197","Rutland","Worcester County","MA","Rutland","2008","Rutland town, MA",197,4171,4368
"6198","Rutland","Worcester County","MA","Rutland","2009","Rutland town, MA",342,4087,4429
"6199","Rutland","Worcester County","MA","Rutland","2010","Rutland town, MA",321,4040,4361
"6200","Rutland","Worcester County","MA","Rutland","2011","Rutland town, MA",291,4077,4368
"6201","Rutland","Worcester County","MA","Rutland","2012","Rutland town, MA",285,4076,4361
"6202","Salem","Essex County","MA","Salem","1990","Salem city, MA",1295,19877,21172
"6203","Salem","Essex County","MA","Salem","1991","Salem city, MA",1820,19163,20983
"6204","Salem","Essex County","MA","Salem","1992","Salem city, MA",2062,18858,20920
"6205","Salem","Essex County","MA","Salem","1993","Salem city, MA",1443,18981,20424
"6206","Salem","Essex County","MA","Salem","1994","Salem city, MA",1170,19180,20350
"6207","Salem","Essex County","MA","Salem","1995","Salem city, MA",1107,19597,20704
"6208","Salem","Essex County","MA","Salem","1996","Salem city, MA",956,19952,20908
"6209","Salem","Essex County","MA","Salem","1997","Salem city, MA",872,20507,21379
"6210","Salem","Essex County","MA","Salem","1998","Salem city, MA",771,20843,21614
"6211","Salem","Essex County","MA","Salem","1999","Salem city, MA",747,20992,21739
"6212","Salem","Essex County","MA","Salem","2000","Salem city, MA",588,22477,23065
"6213","Salem","Essex County","MA","Salem","2001","Salem city, MA",860,22726,23586
"6214","Salem","Essex County","MA","Salem","2002","Salem city, MA",1270,23007,24277
"6215","Salem","Essex County","MA","Salem","2003","Salem city, MA",1431,22716,24147
"6216","Salem","Essex County","MA","Salem","2004","Salem city, MA",1307,22432,23739
"6217","Salem","Essex County","MA","Salem","2005","Salem city, MA",1144,22389,23533
"6218","Salem","Essex County","MA","Salem","2006","Salem city, MA",1115,22435,23550
"6219","Salem","Essex County","MA","Salem","2007","Salem city, MA",1048,22289,23337
"6220","Salem","Essex County","MA","Salem","2008","Salem city, MA",1251,22502,23753
"6221","Salem","Essex County","MA","Salem","2009","Salem city, MA",1940,21889,23829
"6222","Salem","Essex County","MA","Salem","2010","Salem city, MA",1931,21920,23851
"6223","Salem","Essex County","MA","Salem","2011","Salem city, MA",1702,22168,23870
"6224","Salem","Essex County","MA","Salem","2012","Salem city, MA",1575,22339,23914
"6225","Salisbury","Essex County","MA","Salisbury","1990","Salisbury town, MA",286,3472,3758
"6226","Salisbury","Essex County","MA","Salisbury","1991","Salisbury town, MA",392,3387,3779
"6227","Salisbury","Essex County","MA","Salisbury","1992","Salisbury town, MA",342,3378,3720
"6228","Salisbury","Essex County","MA","Salisbury","1993","Salisbury town, MA",348,3431,3779
"6229","Salisbury","Essex County","MA","Salisbury","1994","Salisbury town, MA",272,3481,3753
"6230","Salisbury","Essex County","MA","Salisbury","1995","Salisbury town, MA",236,3508,3744
"6231","Salisbury","Essex County","MA","Salisbury","1996","Salisbury town, MA",190,3599,3789
"6232","Salisbury","Essex County","MA","Salisbury","1997","Salisbury town, MA",173,3714,3887
"6233","Salisbury","Essex County","MA","Salisbury","1998","Salisbury town, MA",176,3797,3973
"6234","Salisbury","Essex County","MA","Salisbury","1999","Salisbury town, MA",173,3850,4023
"6235","Salisbury","Essex County","MA","Salisbury","2000","Salisbury town, MA",132,4212,4344
"6236","Salisbury","Essex County","MA","Salisbury","2001","Salisbury town, MA",196,4192,4388
"6237","Salisbury","Essex County","MA","Salisbury","2002","Salisbury town, MA",277,4076,4353
"6238","Salisbury","Essex County","MA","Salisbury","2003","Salisbury town, MA",284,4001,4285
"6239","Salisbury","Essex County","MA","Salisbury","2004","Salisbury town, MA",269,4021,4290
"6240","Salisbury","Essex County","MA","Salisbury","2005","Salisbury town, MA",250,4117,4367
"6241","Salisbury","Essex County","MA","Salisbury","2006","Salisbury town, MA",244,4232,4476
"6242","Salisbury","Essex County","MA","Salisbury","2007","Salisbury town, MA",206,4280,4486
"6243","Salisbury","Essex County","MA","Salisbury","2008","Salisbury town, MA",264,4165,4429
"6244","Salisbury","Essex County","MA","Salisbury","2009","Salisbury town, MA",388,4128,4516
"6245","Salisbury","Essex County","MA","Salisbury","2010","Salisbury town, MA",456,4064,4520
"6246","Salisbury","Essex County","MA","Salisbury","2011","Salisbury town, MA",357,4116,4473
"6247","Salisbury","Essex County","MA","Salisbury","2012","Salisbury town, MA",305,4170,4475
"6248","Sandisfield","Berkshire County","MA","Sandisfield","1990","Sandisfield town, MA",16,264,280
"6249","Sandisfield","Berkshire County","MA","Sandisfield","1991","Sandisfield town, MA",30,265,295
"6250","Sandisfield","Berkshire County","MA","Sandisfield","1992","Sandisfield town, MA",32,274,306
"6251","Sandisfield","Berkshire County","MA","Sandisfield","1993","Sandisfield town, MA",40,284,324
"6252","Sandisfield","Berkshire County","MA","Sandisfield","1994","Sandisfield town, MA",35,301,336
"6253","Sandisfield","Berkshire County","MA","Sandisfield","1995","Sandisfield town, MA",24,283,307
"6254","Sandisfield","Berkshire County","MA","Sandisfield","1996","Sandisfield town, MA",21,289,310
"6255","Sandisfield","Berkshire County","MA","Sandisfield","1997","Sandisfield town, MA",21,295,316
"6256","Sandisfield","Berkshire County","MA","Sandisfield","1998","Sandisfield town, MA",9,294,303
"6257","Sandisfield","Berkshire County","MA","Sandisfield","1999","Sandisfield town, MA",13,293,306
"6258","Sandisfield","Berkshire County","MA","Sandisfield","2000","Sandisfield town, MA",11,436,447
"6259","Sandisfield","Berkshire County","MA","Sandisfield","2001","Sandisfield town, MA",15,451,466
"6260","Sandisfield","Berkshire County","MA","Sandisfield","2002","Sandisfield town, MA",23,465,488
"6261","Sandisfield","Berkshire County","MA","Sandisfield","2003","Sandisfield town, MA",25,465,490
"6262","Sandisfield","Berkshire County","MA","Sandisfield","2004","Sandisfield town, MA",27,464,491
"6263","Sandisfield","Berkshire County","MA","Sandisfield","2005","Sandisfield town, MA",19,476,495
"6264","Sandisfield","Berkshire County","MA","Sandisfield","2006","Sandisfield town, MA",20,485,505
"6265","Sandisfield","Berkshire County","MA","Sandisfield","2007","Sandisfield town, MA",15,477,492
"6266","Sandisfield","Berkshire County","MA","Sandisfield","2008","Sandisfield town, MA",23,485,508
"6267","Sandisfield","Berkshire County","MA","Sandisfield","2009","Sandisfield town, MA",36,471,507
"6268","Sandisfield","Berkshire County","MA","Sandisfield","2010","Sandisfield town, MA",42,512,554
"6269","Sandisfield","Berkshire County","MA","Sandisfield","2011","Sandisfield town, MA",36,516,552
"6270","Sandisfield","Berkshire County","MA","Sandisfield","2012","Sandisfield town, MA",30,512,542
"6271","Sandwich","Barnstable County","MA","Sandwich","1990","Sandwich town, MA",391,7970,8361
"6272","Sandwich","Barnstable County","MA","Sandwich","1991","Sandwich town, MA",684,7873,8557
"6273","Sandwich","Barnstable County","MA","Sandwich","1992","Sandwich town, MA",722,7988,8710
"6274","Sandwich","Barnstable County","MA","Sandwich","1993","Sandwich town, MA",635,8350,8985
"6275","Sandwich","Barnstable County","MA","Sandwich","1994","Sandwich town, MA",553,8708,9261
"6276","Sandwich","Barnstable County","MA","Sandwich","1995","Sandwich town, MA",509,8769,9278
"6277","Sandwich","Barnstable County","MA","Sandwich","1996","Sandwich town, MA",394,9068,9462
"6278","Sandwich","Barnstable County","MA","Sandwich","1997","Sandwich town, MA",407,9258,9665
"6279","Sandwich","Barnstable County","MA","Sandwich","1998","Sandwich town, MA",316,9506,9822
"6280","Sandwich","Barnstable County","MA","Sandwich","1999","Sandwich town, MA",289,9963,10252
"6281","Sandwich","Barnstable County","MA","Sandwich","2000","Sandwich town, MA",260,10503,10763
"6282","Sandwich","Barnstable County","MA","Sandwich","2001","Sandwich town, MA",329,10648,10977
"6283","Sandwich","Barnstable County","MA","Sandwich","2002","Sandwich town, MA",427,10870,11297
"6284","Sandwich","Barnstable County","MA","Sandwich","2003","Sandwich town, MA",496,11133,11629
"6285","Sandwich","Barnstable County","MA","Sandwich","2004","Sandwich town, MA",492,11219,11711
"6286","Sandwich","Barnstable County","MA","Sandwich","2005","Sandwich town, MA",441,11231,11672
"6287","Sandwich","Barnstable County","MA","Sandwich","2006","Sandwich town, MA",485,11220,11705
"6288","Sandwich","Barnstable County","MA","Sandwich","2007","Sandwich town, MA",462,11146,11608
"6289","Sandwich","Barnstable County","MA","Sandwich","2008","Sandwich town, MA",585,11063,11648
"6290","Sandwich","Barnstable County","MA","Sandwich","2009","Sandwich town, MA",867,10664,11531
"6291","Sandwich","Barnstable County","MA","Sandwich","2010","Sandwich town, MA",887,11203,12090
"6292","Sandwich","Barnstable County","MA","Sandwich","2011","Sandwich town, MA",798,11185,11983
"6293","Sandwich","Barnstable County","MA","Sandwich","2012","Sandwich town, MA",739,11373,12112
"6294","Saugus","Essex County","MA","Saugus","1990","Saugus town, MA",832,13445,14277
"6295","Saugus","Essex County","MA","Saugus","1991","Saugus town, MA",1222,13008,14230
"6296","Saugus","Essex County","MA","Saugus","1992","Saugus town, MA",1335,12894,14229
"6297","Saugus","Essex County","MA","Saugus","1993","Saugus town, MA",893,13085,13978
"6298","Saugus","Essex County","MA","Saugus","1994","Saugus town, MA",831,13354,14185
"6299","Saugus","Essex County","MA","Saugus","1995","Saugus town, MA",718,13564,14282
"6300","Saugus","Essex County","MA","Saugus","1996","Saugus town, MA",589,13849,14438
"6301","Saugus","Essex County","MA","Saugus","1997","Saugus town, MA",550,14239,14789
"6302","Saugus","Essex County","MA","Saugus","1998","Saugus town, MA",457,14604,15061
"6303","Saugus","Essex County","MA","Saugus","1999","Saugus town, MA",492,14764,15256
"6304","Saugus","Essex County","MA","Saugus","2000","Saugus town, MA",371,13925,14296
"6305","Saugus","Essex County","MA","Saugus","2001","Saugus town, MA",476,13965,14441
"6306","Saugus","Essex County","MA","Saugus","2002","Saugus town, MA",721,13786,14507
"6307","Saugus","Essex County","MA","Saugus","2003","Saugus town, MA",881,13610,14491
"6308","Saugus","Essex County","MA","Saugus","2004","Saugus town, MA",830,13722,14552
"6309","Saugus","Essex County","MA","Saugus","2005","Saugus town, MA",736,13957,14693
"6310","Saugus","Essex County","MA","Saugus","2006","Saugus town, MA",735,13697,14432
"6311","Saugus","Essex County","MA","Saugus","2007","Saugus town, MA",676,13917,14593
"6312","Saugus","Essex County","MA","Saugus","2008","Saugus town, MA",788,14082,14870
"6313","Saugus","Essex County","MA","Saugus","2009","Saugus town, MA",1259,13826,15085
"6314","Saugus","Essex County","MA","Saugus","2010","Saugus town, MA",1205,13375,14580
"6315","Saugus","Essex County","MA","Saugus","2011","Saugus town, MA",1024,13537,14561
"6316","Saugus","Essex County","MA","Saugus","2012","Saugus town, MA",928,13685,14613
"6317","Savoy","Berkshire County","MA","Savoy","1990","Savoy town, MA",81,339,420
"6318","Savoy","Berkshire County","MA","Savoy","1991","Savoy town, MA",78,335,413
"6319","Savoy","Berkshire County","MA","Savoy","1992","Savoy town, MA",56,343,399
"6320","Savoy","Berkshire County","MA","Savoy","1993","Savoy town, MA",48,389,437
"6321","Savoy","Berkshire County","MA","Savoy","1994","Savoy town, MA",36,399,435
"6322","Savoy","Berkshire County","MA","Savoy","1995","Savoy town, MA",30,359,389
"6323","Savoy","Berkshire County","MA","Savoy","1996","Savoy town, MA",24,369,393
"6324","Savoy","Berkshire County","MA","Savoy","1997","Savoy town, MA",27,377,404
"6325","Savoy","Berkshire County","MA","Savoy","1998","Savoy town, MA",25,384,409
"6326","Savoy","Berkshire County","MA","Savoy","1999","Savoy town, MA",24,391,415
"6327","Savoy","Berkshire County","MA","Savoy","2000","Savoy town, MA",16,373,389
"6328","Savoy","Berkshire County","MA","Savoy","2001","Savoy town, MA",19,374,393
"6329","Savoy","Berkshire County","MA","Savoy","2002","Savoy town, MA",25,383,408
"6330","Savoy","Berkshire County","MA","Savoy","2003","Savoy town, MA",32,384,416
"6331","Savoy","Berkshire County","MA","Savoy","2004","Savoy town, MA",23,388,411
"6332","Savoy","Berkshire County","MA","Savoy","2005","Savoy town, MA",24,397,421
"6333","Savoy","Berkshire County","MA","Savoy","2006","Savoy town, MA",21,408,429
"6334","Savoy","Berkshire County","MA","Savoy","2007","Savoy town, MA",21,404,425
"6335","Savoy","Berkshire County","MA","Savoy","2008","Savoy town, MA",25,402,427
"6336","Savoy","Berkshire County","MA","Savoy","2009","Savoy town, MA",39,390,429
"6337","Savoy","Berkshire County","MA","Savoy","2010","Savoy town, MA",43,361,404
"6338","Savoy","Berkshire County","MA","Savoy","2011","Savoy town, MA",34,364,398
"6339","Savoy","Berkshire County","MA","Savoy","2012","Savoy town, MA",39,363,402
"6340","Scituate","Plymouth County","MA","Scituate","1990","Scituate town, MA",404,8697,9101
"6341","Scituate","Plymouth County","MA","Scituate","1991","Scituate town, MA",581,8412,8993
"6342","Scituate","Plymouth County","MA","Scituate","1992","Scituate town, MA",620,8358,8978
"6343","Scituate","Plymouth County","MA","Scituate","1993","Scituate town, MA",508,8577,9085
"6344","Scituate","Plymouth County","MA","Scituate","1994","Scituate town, MA",410,8744,9154
"6345","Scituate","Plymouth County","MA","Scituate","1995","Scituate town, MA",359,8756,9115
"6346","Scituate","Plymouth County","MA","Scituate","1996","Scituate town, MA",322,8984,9306
"6347","Scituate","Plymouth County","MA","Scituate","1997","Scituate town, MA",293,9279,9572
"6348","Scituate","Plymouth County","MA","Scituate","1998","Scituate town, MA",255,9462,9717
"6349","Scituate","Plymouth County","MA","Scituate","1999","Scituate town, MA",223,9608,9831
"6350","Scituate","Plymouth County","MA","Scituate","2000","Scituate town, MA",208,9311,9519
"6351","Scituate","Plymouth County","MA","Scituate","2001","Scituate town, MA",278,9318,9596
"6352","Scituate","Plymouth County","MA","Scituate","2002","Scituate town, MA",397,9231,9628
"6353","Scituate","Plymouth County","MA","Scituate","2003","Scituate town, MA",410,9127,9537
"6354","Scituate","Plymouth County","MA","Scituate","2004","Scituate town, MA",400,9117,9517
"6355","Scituate","Plymouth County","MA","Scituate","2005","Scituate town, MA",373,9176,9549
"6356","Scituate","Plymouth County","MA","Scituate","2006","Scituate town, MA",362,9083,9445
"6357","Scituate","Plymouth County","MA","Scituate","2007","Scituate town, MA",363,9168,9531
"6358","Scituate","Plymouth County","MA","Scituate","2008","Scituate town, MA",412,9128,9540
"6359","Scituate","Plymouth County","MA","Scituate","2009","Scituate town, MA",648,8840,9488
"6360","Scituate","Plymouth County","MA","Scituate","2010","Scituate town, MA",661,8893,9554
"6361","Scituate","Plymouth County","MA","Scituate","2011","Scituate town, MA",542,8981,9523
"6362","Scituate","Plymouth County","MA","Scituate","2012","Scituate town, MA",512,9080,9592
"6363","Seekonk","Bristol County","MA","Seekonk","1990","Seekonk town, MA",463,6891,7354
"6364","Seekonk","Bristol County","MA","Seekonk","1991","Seekonk town, MA",697,6590,7287
"6365","Seekonk","Bristol County","MA","Seekonk","1992","Seekonk town, MA",781,6637,7418
"6366","Seekonk","Bristol County","MA","Seekonk","1993","Seekonk town, MA",627,6780,7407
"6367","Seekonk","Bristol County","MA","Seekonk","1994","Seekonk town, MA",603,6909,7512
"6368","Seekonk","Bristol County","MA","Seekonk","1995","Seekonk town, MA",507,7019,7526
"6369","Seekonk","Bristol County","MA","Seekonk","1996","Seekonk town, MA",439,7060,7499
"6370","Seekonk","Bristol County","MA","Seekonk","1997","Seekonk town, MA",360,7200,7560
"6371","Seekonk","Bristol County","MA","Seekonk","1998","Seekonk town, MA",293,7338,7631
"6372","Seekonk","Bristol County","MA","Seekonk","1999","Seekonk town, MA",238,7389,7627
"6373","Seekonk","Bristol County","MA","Seekonk","2000","Seekonk town, MA",245,7119,7364
"6374","Seekonk","Bristol County","MA","Seekonk","2001","Seekonk town, MA",314,7080,7394
"6375","Seekonk","Bristol County","MA","Seekonk","2002","Seekonk town, MA",386,7149,7535
"6376","Seekonk","Bristol County","MA","Seekonk","2003","Seekonk town, MA",399,7214,7613
"6377","Seekonk","Bristol County","MA","Seekonk","2004","Seekonk town, MA",395,7207,7602
"6378","Seekonk","Bristol County","MA","Seekonk","2005","Seekonk town, MA",380,7225,7605
"6379","Seekonk","Bristol County","MA","Seekonk","2006","Seekonk town, MA",399,7290,7689
"6380","Seekonk","Bristol County","MA","Seekonk","2007","Seekonk town, MA",365,7280,7645
"6381","Seekonk","Bristol County","MA","Seekonk","2008","Seekonk town, MA",479,7162,7641
"6382","Seekonk","Bristol County","MA","Seekonk","2009","Seekonk town, MA",793,6925,7718
"6383","Seekonk","Bristol County","MA","Seekonk","2010","Seekonk town, MA",786,6880,7666
"6384","Seekonk","Bristol County","MA","Seekonk","2011","Seekonk town, MA",725,6931,7656
"6385","Seekonk","Bristol County","MA","Seekonk","2012","Seekonk town, MA",646,6942,7588
"6386","Sharon","Norfolk County","MA","Sharon","1990","Sharon town, MA",385,8334,8719
"6387","Sharon","Norfolk County","MA","Sharon","1991","Sharon town, MA",508,8072,8580
"6388","Sharon","Norfolk County","MA","Sharon","1992","Sharon town, MA",499,8128,8627
"6389","Sharon","Norfolk County","MA","Sharon","1993","Sharon town, MA",433,8375,8808
"6390","Sharon","Norfolk County","MA","Sharon","1994","Sharon town, MA",406,8698,9104
"6391","Sharon","Norfolk County","MA","Sharon","1995","Sharon town, MA",331,8775,9106
"6392","Sharon","Norfolk County","MA","Sharon","1996","Sharon town, MA",302,9004,9306
"6393","Sharon","Norfolk County","MA","Sharon","1997","Sharon town, MA",252,9275,9527
"6394","Sharon","Norfolk County","MA","Sharon","1998","Sharon town, MA",187,9442,9629
"6395","Sharon","Norfolk County","MA","Sharon","1999","Sharon town, MA",213,9532,9745
"6396","Sharon","Norfolk County","MA","Sharon","2000","Sharon town, MA",207,9212,9419
"6397","Sharon","Norfolk County","MA","Sharon","2001","Sharon town, MA",279,9205,9484
"6398","Sharon","Norfolk County","MA","Sharon","2002","Sharon town, MA",417,9044,9461
"6399","Sharon","Norfolk County","MA","Sharon","2003","Sharon town, MA",376,8882,9258
"6400","Sharon","Norfolk County","MA","Sharon","2004","Sharon town, MA",347,8833,9180
"6401","Sharon","Norfolk County","MA","Sharon","2005","Sharon town, MA",315,8852,9167
"6402","Sharon","Norfolk County","MA","Sharon","2006","Sharon town, MA",315,8690,9005
"6403","Sharon","Norfolk County","MA","Sharon","2007","Sharon town, MA",316,8742,9058
"6404","Sharon","Norfolk County","MA","Sharon","2008","Sharon town, MA",394,8947,9341
"6405","Sharon","Norfolk County","MA","Sharon","2009","Sharon town, MA",617,8853,9470
"6406","Sharon","Norfolk County","MA","Sharon","2010","Sharon town, MA",573,8775,9348
"6407","Sharon","Norfolk County","MA","Sharon","2011","Sharon town, MA",513,8875,9388
"6408","Sharon","Norfolk County","MA","Sharon","2012","Sharon town, MA",463,8972,9435
"6409","Sheffield","Berkshire County","MA","Sheffield","1990","Sheffield town, MA",75,1474,1549
"6410","Sheffield","Berkshire County","MA","Sheffield","1991","Sheffield town, MA",108,1467,1575
"6411","Sheffield","Berkshire County","MA","Sheffield","1992","Sheffield town, MA",128,1463,1591
"6412","Sheffield","Berkshire County","MA","Sheffield","1993","Sheffield town, MA",115,1545,1660
"6413","Sheffield","Berkshire County","MA","Sheffield","1994","Sheffield town, MA",89,1586,1675
"6414","Sheffield","Berkshire County","MA","Sheffield","1995","Sheffield town, MA",77,1615,1692
"6415","Sheffield","Berkshire County","MA","Sheffield","1996","Sheffield town, MA",62,1656,1718
"6416","Sheffield","Berkshire County","MA","Sheffield","1997","Sheffield town, MA",60,1698,1758
"6417","Sheffield","Berkshire County","MA","Sheffield","1998","Sheffield town, MA",42,1697,1739
"6418","Sheffield","Berkshire County","MA","Sheffield","1999","Sheffield town, MA",39,1695,1734
"6419","Sheffield","Berkshire County","MA","Sheffield","2000","Sheffield town, MA",42,1847,1889
"6420","Sheffield","Berkshire County","MA","Sheffield","2001","Sheffield town, MA",43,1911,1954
"6421","Sheffield","Berkshire County","MA","Sheffield","2002","Sheffield town, MA",58,1971,2029
"6422","Sheffield","Berkshire County","MA","Sheffield","2003","Sheffield town, MA",76,1989,2065
"6423","Sheffield","Berkshire County","MA","Sheffield","2004","Sheffield town, MA",65,1977,2042
"6424","Sheffield","Berkshire County","MA","Sheffield","2005","Sheffield town, MA",62,2019,2081
"6425","Sheffield","Berkshire County","MA","Sheffield","2006","Sheffield town, MA",78,2037,2115
"6426","Sheffield","Berkshire County","MA","Sheffield","2007","Sheffield town, MA",76,1989,2065
"6427","Sheffield","Berkshire County","MA","Sheffield","2008","Sheffield town, MA",76,1979,2055
"6428","Sheffield","Berkshire County","MA","Sheffield","2009","Sheffield town, MA",138,1917,2055
"6429","Sheffield","Berkshire County","MA","Sheffield","2010","Sheffield town, MA",122,1910,2032
"6430","Sheffield","Berkshire County","MA","Sheffield","2011","Sheffield town, MA",110,1919,2029
"6431","Sheffield","Berkshire County","MA","Sheffield","2012","Sheffield town, MA",105,1903,2008
"6432","Shelburne","Franklin County","MA","Shelburne","1990","Shelburne town, MA",100,996,1096
"6433","Shelburne","Franklin County","MA","Shelburne","1991","Shelburne town, MA",144,977,1121
"6434","Shelburne","Franklin County","MA","Shelburne","1992","Shelburne town, MA",142,938,1080
"6435","Shelburne","Franklin County","MA","Shelburne","1993","Shelburne town, MA",115,920,1035
"6436","Shelburne","Franklin County","MA","Shelburne","1994","Shelburne town, MA",97,925,1022
"6437","Shelburne","Franklin County","MA","Shelburne","1995","Shelburne town, MA",94,1009,1103
"6438","Shelburne","Franklin County","MA","Shelburne","1996","Shelburne town, MA",82,1012,1094
"6439","Shelburne","Franklin County","MA","Shelburne","1997","Shelburne town, MA",95,1035,1130
"6440","Shelburne","Franklin County","MA","Shelburne","1998","Shelburne town, MA",57,1055,1112
"6441","Shelburne","Franklin County","MA","Shelburne","1999","Shelburne town, MA",53,1072,1125
"6442","Shelburne","Franklin County","MA","Shelburne","2000","Shelburne town, MA",45,1062,1107
"6443","Shelburne","Franklin County","MA","Shelburne","2001","Shelburne town, MA",52,1061,1113
"6444","Shelburne","Franklin County","MA","Shelburne","2002","Shelburne town, MA",70,1074,1144
"6445","Shelburne","Franklin County","MA","Shelburne","2003","Shelburne town, MA",69,1072,1141
"6446","Shelburne","Franklin County","MA","Shelburne","2004","Shelburne town, MA",66,1051,1117
"6447","Shelburne","Franklin County","MA","Shelburne","2005","Shelburne town, MA",61,1045,1106
"6448","Shelburne","Franklin County","MA","Shelburne","2006","Shelburne town, MA",72,1047,1119
"6449","Shelburne","Franklin County","MA","Shelburne","2007","Shelburne town, MA",56,1035,1091
"6450","Shelburne","Franklin County","MA","Shelburne","2008","Shelburne town, MA",76,1018,1094
"6451","Shelburne","Franklin County","MA","Shelburne","2009","Shelburne town, MA",115,987,1102
"6452","Shelburne","Franklin County","MA","Shelburne","2010","Shelburne town, MA",120,937,1057
"6453","Shelburne","Franklin County","MA","Shelburne","2011","Shelburne town, MA",100,938,1038
"6454","Shelburne","Franklin County","MA","Shelburne","2012","Shelburne town, MA",84,941,1025
"6455","Sherborn","Middlesex County","MA","Sherborn","1990","Sherborn town, MA",58,2067,2125
"6456","Sherborn","Middlesex County","MA","Sherborn","1991","Sherborn town, MA",91,2001,2092
"6457","Sherborn","Middlesex County","MA","Sherborn","1992","Sherborn town, MA",73,2028,2101
"6458","Sherborn","Middlesex County","MA","Sherborn","1993","Sherborn town, MA",70,2078,2148
"6459","Sherborn","Middlesex County","MA","Sherborn","1994","Sherborn town, MA",57,2109,2166
"6460","Sherborn","Middlesex County","MA","Sherborn","1995","Sherborn town, MA",55,2083,2138
"6461","Sherborn","Middlesex County","MA","Sherborn","1996","Sherborn town, MA",49,2138,2187
"6462","Sherborn","Middlesex County","MA","Sherborn","1997","Sherborn town, MA",42,2196,2238
"6463","Sherborn","Middlesex County","MA","Sherborn","1998","Sherborn town, MA",34,2234,2268
"6464","Sherborn","Middlesex County","MA","Sherborn","1999","Sherborn town, MA",34,2254,2288
"6465","Sherborn","Middlesex County","MA","Sherborn","2000","Sherborn town, MA",38,1934,1972
"6466","Sherborn","Middlesex County","MA","Sherborn","2001","Sherborn town, MA",57,1928,1985
"6467","Sherborn","Middlesex County","MA","Sherborn","2002","Sherborn town, MA",80,1891,1971
"6468","Sherborn","Middlesex County","MA","Sherborn","2003","Sherborn town, MA",89,1884,1973
"6469","Sherborn","Middlesex County","MA","Sherborn","2004","Sherborn town, MA",76,1874,1950
"6470","Sherborn","Middlesex County","MA","Sherborn","2005","Sherborn town, MA",70,1891,1961
"6471","Sherborn","Middlesex County","MA","Sherborn","2006","Sherborn town, MA",63,1863,1926
"6472","Sherborn","Middlesex County","MA","Sherborn","2007","Sherborn town, MA",60,1877,1937
"6473","Sherborn","Middlesex County","MA","Sherborn","2008","Sherborn town, MA",68,1875,1943
"6474","Sherborn","Middlesex County","MA","Sherborn","2009","Sherborn town, MA",119,1832,1951
"6475","Sherborn","Middlesex County","MA","Sherborn","2010","Sherborn town, MA",114,1786,1900
"6476","Sherborn","Middlesex County","MA","Sherborn","2011","Sherborn town, MA",88,1813,1901
"6477","Sherborn","Middlesex County","MA","Sherborn","2012","Sherborn town, MA",77,1832,1909
"6478","Shirley","Middlesex County","MA","Shirley","1990","Shirley town, MA",183,2776,2959
"6479","Shirley","Middlesex County","MA","Shirley","1991","Shirley town, MA",236,2702,2938
"6480","Shirley","Middlesex County","MA","Shirley","1992","Shirley town, MA",226,3084,3310
"6481","Shirley","Middlesex County","MA","Shirley","1993","Shirley town, MA",191,3128,3319
"6482","Shirley","Middlesex County","MA","Shirley","1994","Shirley town, MA",172,3168,3340
"6483","Shirley","Middlesex County","MA","Shirley","1995","Shirley town, MA",157,3321,3478
"6484","Shirley","Middlesex County","MA","Shirley","1996","Shirley town, MA",133,3397,3530
"6485","Shirley","Middlesex County","MA","Shirley","1997","Shirley town, MA",106,3510,3616
"6486","Shirley","Middlesex County","MA","Shirley","1998","Shirley town, MA",96,3429,3525
"6487","Shirley","Middlesex County","MA","Shirley","1999","Shirley town, MA",104,3510,3614
"6488","Shirley","Middlesex County","MA","Shirley","2000","Shirley town, MA",83,3517,3600
"6489","Shirley","Middlesex County","MA","Shirley","2001","Shirley town, MA",136,3545,3681
"6490","Shirley","Middlesex County","MA","Shirley","2002","Shirley town, MA",193,3399,3592
"6491","Shirley","Middlesex County","MA","Shirley","2003","Shirley town, MA",210,3365,3575
"6492","Shirley","Middlesex County","MA","Shirley","2004","Shirley town, MA",167,3368,3535
"6493","Shirley","Middlesex County","MA","Shirley","2005","Shirley town, MA",166,3415,3581
"6494","Shirley","Middlesex County","MA","Shirley","2006","Shirley town, MA",179,3431,3610
"6495","Shirley","Middlesex County","MA","Shirley","2007","Shirley town, MA",177,3526,3703
"6496","Shirley","Middlesex County","MA","Shirley","2008","Shirley town, MA",202,3575,3777
"6497","Shirley","Middlesex County","MA","Shirley","2009","Shirley town, MA",306,3473,3779
"6498","Shirley","Middlesex County","MA","Shirley","2010","Shirley town, MA",285,3134,3419
"6499","Shirley","Middlesex County","MA","Shirley","2011","Shirley town, MA",244,3175,3419
"6500","Shirley","Middlesex County","MA","Shirley","2012","Shirley town, MA",247,3210,3457
"6501","Shrewsbury","Worcester County","MA","Shrewsbury","1990","Shrewsbury town, MA",704,12653,13357
"6502","Shrewsbury","Worcester County","MA","Shrewsbury","1991","Shrewsbury town, MA",1002,12257,13259
"6503","Shrewsbury","Worcester County","MA","Shrewsbury","1992","Shrewsbury town, MA",1016,12491,13507
"6504","Shrewsbury","Worcester County","MA","Shrewsbury","1993","Shrewsbury town, MA",818,13134,13952
"6505","Shrewsbury","Worcester County","MA","Shrewsbury","1994","Shrewsbury town, MA",686,13654,14340
"6506","Shrewsbury","Worcester County","MA","Shrewsbury","1995","Shrewsbury town, MA",582,13810,14392
"6507","Shrewsbury","Worcester County","MA","Shrewsbury","1996","Shrewsbury town, MA",463,14159,14622
"6508","Shrewsbury","Worcester County","MA","Shrewsbury","1997","Shrewsbury town, MA",428,14686,15114
"6509","Shrewsbury","Worcester County","MA","Shrewsbury","1998","Shrewsbury town, MA",371,15156,15527
"6510","Shrewsbury","Worcester County","MA","Shrewsbury","1999","Shrewsbury town, MA",416,15369,15785
"6511","Shrewsbury","Worcester County","MA","Shrewsbury","2000","Shrewsbury town, MA",378,16439,16817
"6512","Shrewsbury","Worcester County","MA","Shrewsbury","2001","Shrewsbury town, MA",542,16598,17140
"6513","Shrewsbury","Worcester County","MA","Shrewsbury","2002","Shrewsbury town, MA",781,16564,17345
"6514","Shrewsbury","Worcester County","MA","Shrewsbury","2003","Shrewsbury town, MA",860,16576,17436
"6515","Shrewsbury","Worcester County","MA","Shrewsbury","2004","Shrewsbury town, MA",757,16576,17333
"6516","Shrewsbury","Worcester County","MA","Shrewsbury","2005","Shrewsbury town, MA",677,16533,17210
"6517","Shrewsbury","Worcester County","MA","Shrewsbury","2006","Shrewsbury town, MA",666,16936,17602
"6518","Shrewsbury","Worcester County","MA","Shrewsbury","2007","Shrewsbury town, MA",655,16950,17605
"6519","Shrewsbury","Worcester County","MA","Shrewsbury","2008","Shrewsbury town, MA",773,16617,17390
"6520","Shrewsbury","Worcester County","MA","Shrewsbury","2009","Shrewsbury town, MA",1217,16150,17367
"6521","Shrewsbury","Worcester County","MA","Shrewsbury","2010","Shrewsbury town, MA",1286,16987,18273
"6522","Shrewsbury","Worcester County","MA","Shrewsbury","2011","Shrewsbury town, MA",1093,17138,18231
"6523","Shrewsbury","Worcester County","MA","Shrewsbury","2012","Shrewsbury town, MA",1022,17132,18154
"6524","Shutesbury","Franklin County","MA","Shutesbury","1990","Shutesbury town, MA",24,876,900
"6525","Shutesbury","Franklin County","MA","Shutesbury","1991","Shutesbury town, MA",55,904,959
"6526","Shutesbury","Franklin County","MA","Shutesbury","1992","Shutesbury town, MA",54,888,942
"6527","Shutesbury","Franklin County","MA","Shutesbury","1993","Shutesbury town, MA",34,918,952
"6528","Shutesbury","Franklin County","MA","Shutesbury","1994","Shutesbury town, MA",31,934,965
"6529","Shutesbury","Franklin County","MA","Shutesbury","1995","Shutesbury town, MA",26,951,977
"6530","Shutesbury","Franklin County","MA","Shutesbury","1996","Shutesbury town, MA",32,961,993
"6531","Shutesbury","Franklin County","MA","Shutesbury","1997","Shutesbury town, MA",32,984,1016
"6532","Shutesbury","Franklin County","MA","Shutesbury","1998","Shutesbury town, MA",17,998,1015
"6533","Shutesbury","Franklin County","MA","Shutesbury","1999","Shutesbury town, MA",19,1020,1039
"6534","Shutesbury","Franklin County","MA","Shutesbury","2000","Shutesbury town, MA",21,1043,1064
"6535","Shutesbury","Franklin County","MA","Shutesbury","2001","Shutesbury town, MA",23,1072,1095
"6536","Shutesbury","Franklin County","MA","Shutesbury","2002","Shutesbury town, MA",31,1074,1105
"6537","Shutesbury","Franklin County","MA","Shutesbury","2003","Shutesbury town, MA",39,1087,1126
"6538","Shutesbury","Franklin County","MA","Shutesbury","2004","Shutesbury town, MA",38,1100,1138
"6539","Shutesbury","Franklin County","MA","Shutesbury","2005","Shutesbury town, MA",34,1102,1136
"6540","Shutesbury","Franklin County","MA","Shutesbury","2006","Shutesbury town, MA",37,1117,1154
"6541","Shutesbury","Franklin County","MA","Shutesbury","2007","Shutesbury town, MA",34,1113,1147
"6542","Shutesbury","Franklin County","MA","Shutesbury","2008","Shutesbury town, MA",44,1082,1126
"6543","Shutesbury","Franklin County","MA","Shutesbury","2009","Shutesbury town, MA",57,1045,1102
"6544","Shutesbury","Franklin County","MA","Shutesbury","2010","Shutesbury town, MA",62,981,1043
"6545","Shutesbury","Franklin County","MA","Shutesbury","2011","Shutesbury town, MA",50,991,1041
"6546","Shutesbury","Franklin County","MA","Shutesbury","2012","Shutesbury town, MA",48,1000,1048
"6547","Somerset","Bristol County","MA","Somerset","1990","Somerset town, MA",753,8944,9697
"6548","Somerset","Bristol County","MA","Somerset","1991","Somerset town, MA",1033,8584,9617
"6549","Somerset","Bristol County","MA","Somerset","1992","Somerset town, MA",1023,8574,9597
"6550","Somerset","Bristol County","MA","Somerset","1993","Somerset town, MA",1002,8707,9709
"6551","Somerset","Bristol County","MA","Somerset","1994","Somerset town, MA",773,8796,9569
"6552","Somerset","Bristol County","MA","Somerset","1995","Somerset town, MA",671,9027,9698
"6553","Somerset","Bristol County","MA","Somerset","1996","Somerset town, MA",664,9059,9723
"6554","Somerset","Bristol County","MA","Somerset","1997","Somerset town, MA",539,9205,9744
"6555","Somerset","Bristol County","MA","Somerset","1998","Somerset town, MA",383,9258,9641
"6556","Somerset","Bristol County","MA","Somerset","1999","Somerset town, MA",360,9382,9742
"6557","Somerset","Bristol County","MA","Somerset","2000","Somerset town, MA",340,9310,9650
"6558","Somerset","Bristol County","MA","Somerset","2001","Somerset town, MA",425,9286,9711
"6559","Somerset","Bristol County","MA","Somerset","2002","Somerset town, MA",544,9384,9928
"6560","Somerset","Bristol County","MA","Somerset","2003","Somerset town, MA",546,9441,9987
"6561","Somerset","Bristol County","MA","Somerset","2004","Somerset town, MA",563,9441,10004
"6562","Somerset","Bristol County","MA","Somerset","2005","Somerset town, MA",556,9446,10002
"6563","Somerset","Bristol County","MA","Somerset","2006","Somerset town, MA",576,9473,10049
"6564","Somerset","Bristol County","MA","Somerset","2007","Somerset town, MA",547,9414,9961
"6565","Somerset","Bristol County","MA","Somerset","2008","Somerset town, MA",660,9165,9825
"6566","Somerset","Bristol County","MA","Somerset","2009","Somerset town, MA",1018,8975,9993
"6567","Somerset","Bristol County","MA","Somerset","2010","Somerset town, MA",1036,8763,9799
"6568","Somerset","Bristol County","MA","Somerset","2011","Somerset town, MA",924,8827,9751
"6569","Somerset","Bristol County","MA","Somerset","2012","Somerset town, MA",887,8841,9728
"6570","Somerville","Middlesex County","MA","Somerville","1990","Somerville city, MA",2232,43162,45394
"6571","Somerville","Middlesex County","MA","Somerville","1991","Somerville city, MA",3145,40505,43650
"6572","Somerville","Middlesex County","MA","Somerville","1992","Somerville city, MA",3163,38907,42070
"6573","Somerville","Middlesex County","MA","Somerville","1993","Somerville city, MA",2659,38663,41322
"6574","Somerville","Middlesex County","MA","Somerville","1994","Somerville city, MA",2158,38571,40729
"6575","Somerville","Middlesex County","MA","Somerville","1995","Somerville city, MA",1789,42034,43823
"6576","Somerville","Middlesex County","MA","Somerville","1996","Somerville city, MA",1482,42694,44176
"6577","Somerville","Middlesex County","MA","Somerville","1997","Somerville city, MA",1325,43666,44991
"6578","Somerville","Middlesex County","MA","Somerville","1998","Somerville city, MA",1086,44133,45219
"6579","Somerville","Middlesex County","MA","Somerville","1999","Somerville city, MA",1043,44240,45283
"6580","Somerville","Middlesex County","MA","Somerville","2000","Somerville city, MA",951,47505,48456
"6581","Somerville","Middlesex County","MA","Somerville","2001","Somerville city, MA",1471,47120,48591
"6582","Somerville","Middlesex County","MA","Somerville","2002","Somerville city, MA",2147,46025,48172
"6583","Somerville","Middlesex County","MA","Somerville","2003","Somerville city, MA",2295,45031,47326
"6584","Somerville","Middlesex County","MA","Somerville","2004","Somerville city, MA",1882,44673,46555
"6585","Somerville","Middlesex County","MA","Somerville","2005","Somerville city, MA",1627,44677,46304
"6586","Somerville","Middlesex County","MA","Somerville","2006","Somerville city, MA",1597,44679,46276
"6587","Somerville","Middlesex County","MA","Somerville","2007","Somerville city, MA",1471,44905,46376
"6588","Somerville","Middlesex County","MA","Somerville","2008","Somerville city, MA",1799,44697,46496
"6589","Somerville","Middlesex County","MA","Somerville","2009","Somerville city, MA",2846,43502,46348
"6590","Somerville","Middlesex County","MA","Somerville","2010","Somerville city, MA",2858,43730,46588
"6591","Somerville","Middlesex County","MA","Somerville","2011","Somerville city, MA",2391,44361,46752
"6592","Somerville","Middlesex County","MA","Somerville","2012","Somerville city, MA",2135,44847,46982
"6593","South Hadley","Hampshire County","MA","South Hadley","1990","South Hadley town, MA",476,8886,9362
"6594","South Hadley","Hampshire County","MA","South Hadley","1991","South Hadley town, MA",666,8570,9236
"6595","South Hadley","Hampshire County","MA","South Hadley","1992","South Hadley town, MA",681,8588,9269
"6596","South Hadley","Hampshire County","MA","South Hadley","1993","South Hadley town, MA",577,8705,9282
"6597","South Hadley","Hampshire County","MA","South Hadley","1994","South Hadley town, MA",526,8790,9316
"6598","South Hadley","Hampshire County","MA","South Hadley","1995","South Hadley town, MA",470,8758,9228
"6599","South Hadley","Hampshire County","MA","South Hadley","1996","South Hadley town, MA",335,8963,9298
"6600","South Hadley","Hampshire County","MA","South Hadley","1997","South Hadley town, MA",291,9196,9487
"6601","South Hadley","Hampshire County","MA","South Hadley","1998","South Hadley town, MA",262,9245,9507
"6602","South Hadley","Hampshire County","MA","South Hadley","1999","South Hadley town, MA",235,9329,9564
"6603","South Hadley","Hampshire County","MA","South Hadley","2000","South Hadley town, MA",225,9337,9562
"6604","South Hadley","Hampshire County","MA","South Hadley","2001","South Hadley town, MA",283,9307,9590
"6605","South Hadley","Hampshire County","MA","South Hadley","2002","South Hadley town, MA",380,9230,9610
"6606","South Hadley","Hampshire County","MA","South Hadley","2003","South Hadley town, MA",452,9175,9627
"6607","South Hadley","Hampshire County","MA","South Hadley","2004","South Hadley town, MA",423,9132,9555
"6608","South Hadley","Hampshire County","MA","South Hadley","2005","South Hadley town, MA",403,9115,9518
"6609","South Hadley","Hampshire County","MA","South Hadley","2006","South Hadley town, MA",394,9161,9555
"6610","South Hadley","Hampshire County","MA","South Hadley","2007","South Hadley town, MA",369,9143,9512
"6611","South Hadley","Hampshire County","MA","South Hadley","2008","South Hadley town, MA",440,9216,9656
"6612","South Hadley","Hampshire County","MA","South Hadley","2009","South Hadley town, MA",655,8830,9485
"6613","South Hadley","Hampshire County","MA","South Hadley","2010","South Hadley town, MA",680,8957,9637
"6614","South Hadley","Hampshire County","MA","South Hadley","2011","South Hadley town, MA",610,8848,9458
"6615","South Hadley","Hampshire County","MA","South Hadley","2012","South Hadley town, MA",572,8853,9425
"6616","Southampton","Hampshire County","MA","Southampton","1990","Southampton town, MA",131,2488,2619
"6617","Southampton","Hampshire County","MA","Southampton","1991","Southampton town, MA",208,2426,2634
"6618","Southampton","Hampshire County","MA","Southampton","1992","Southampton town, MA",203,2471,2674
"6619","Southampton","Hampshire County","MA","Southampton","1993","Southampton town, MA",193,2507,2700
"6620","Southampton","Hampshire County","MA","Southampton","1994","Southampton town, MA",174,2622,2796
"6621","Southampton","Hampshire County","MA","Southampton","1995","Southampton town, MA",146,2569,2715
"6622","Southampton","Hampshire County","MA","Southampton","1996","Southampton town, MA",111,2644,2755
"6623","Southampton","Hampshire County","MA","Southampton","1997","Southampton town, MA",94,2730,2824
"6624","Southampton","Hampshire County","MA","Southampton","1998","Southampton town, MA",93,2847,2940
"6625","Southampton","Hampshire County","MA","Southampton","1999","Southampton town, MA",95,2901,2996
"6626","Southampton","Hampshire County","MA","Southampton","2000","Southampton town, MA",69,3151,3220
"6627","Southampton","Hampshire County","MA","Southampton","2001","Southampton town, MA",95,3185,3280
"6628","Southampton","Hampshire County","MA","Southampton","2002","Southampton town, MA",125,3216,3341
"6629","Southampton","Hampshire County","MA","Southampton","2003","Southampton town, MA",151,3246,3397
"6630","Southampton","Hampshire County","MA","Southampton","2004","Southampton town, MA",150,3295,3445
"6631","Southampton","Hampshire County","MA","Southampton","2005","Southampton town, MA",136,3352,3488
"6632","Southampton","Hampshire County","MA","Southampton","2006","Southampton town, MA",128,3428,3556
"6633","Southampton","Hampshire County","MA","Southampton","2007","Southampton town, MA",137,3453,3590
"6634","Southampton","Hampshire County","MA","Southampton","2008","Southampton town, MA",152,3428,3580
"6635","Southampton","Hampshire County","MA","Southampton","2009","Southampton town, MA",224,3267,3491
"6636","Southampton","Hampshire County","MA","Southampton","2010","Southampton town, MA",228,3182,3410
"6637","Southampton","Hampshire County","MA","Southampton","2011","Southampton town, MA",194,3142,3336
"6638","Southampton","Hampshire County","MA","Southampton","2012","Southampton town, MA",181,3144,3325
"6639","Southborough","Worcester County","MA","Southborough","1990","Southborough town, MA",184,3632,3816
"6640","Southborough","Worcester County","MA","Southborough","1991","Southborough town, MA",216,3520,3736
"6641","Southborough","Worcester County","MA","Southborough","1992","Southborough town, MA",226,3572,3798
"6642","Southborough","Worcester County","MA","Southborough","1993","Southborough town, MA",199,3675,3874
"6643","Southborough","Worcester County","MA","Southborough","1994","Southborough town, MA",171,3890,4061
"6644","Southborough","Worcester County","MA","Southborough","1995","Southborough town, MA",157,3917,4074
"6645","Southborough","Worcester County","MA","Southborough","1996","Southborough town, MA",129,4054,4183
"6646","Southborough","Worcester County","MA","Southborough","1997","Southborough town, MA",104,4256,4360
"6647","Southborough","Worcester County","MA","Southborough","1998","Southborough town, MA",92,4421,4513
"6648","Southborough","Worcester County","MA","Southborough","1999","Southborough town, MA",95,4597,4692
"6649","Southborough","Worcester County","MA","Southborough","2000","Southborough town, MA",96,4467,4563
"6650","Southborough","Worcester County","MA","Southborough","2001","Southborough town, MA",155,4554,4709
"6651","Southborough","Worcester County","MA","Southborough","2002","Southborough town, MA",236,4544,4780
"6652","Southborough","Worcester County","MA","Southborough","2003","Southborough town, MA",237,4569,4806
"6653","Southborough","Worcester County","MA","Southborough","2004","Southborough town, MA",185,4654,4839
"6654","Southborough","Worcester County","MA","Southborough","2005","Southborough town, MA",178,4731,4909
"6655","Southborough","Worcester County","MA","Southborough","2006","Southborough town, MA",175,4754,4929
"6656","Southborough","Worcester County","MA","Southborough","2007","Southborough town, MA",157,4779,4936
"6657","Southborough","Worcester County","MA","Southborough","2008","Southborough town, MA",183,4873,5056
"6658","Southborough","Worcester County","MA","Southborough","2009","Southborough town, MA",299,4710,5009
"6659","Southborough","Worcester County","MA","Southborough","2010","Southborough town, MA",322,4688,5010
"6660","Southborough","Worcester County","MA","Southborough","2011","Southborough town, MA",242,4700,4942
"6661","Southborough","Worcester County","MA","Southborough","2012","Southborough town, MA",241,4743,4984
"6662","Southbridge","Worcester County","MA","Southbridge","1990","Southbridge Town city, MA",681,8076,8757
"6663","Southbridge","Worcester County","MA","Southbridge","1991","Southbridge Town city, MA",1014,7600,8614
"6664","Southbridge","Worcester County","MA","Southbridge","1992","Southbridge Town city, MA",984,7209,8193
"6665","Southbridge","Worcester County","MA","Southbridge","1993","Southbridge Town city, MA",860,7282,8142
"6666","Southbridge","Worcester County","MA","Southbridge","1994","Southbridge Town city, MA",552,7309,7861
"6667","Southbridge","Worcester County","MA","Southbridge","1995","Southbridge Town city, MA",532,7909,8441
"6668","Southbridge","Worcester County","MA","Southbridge","1996","Southbridge Town city, MA",455,7997,8452
"6669","Southbridge","Worcester County","MA","Southbridge","1997","Southbridge Town city, MA",375,8166,8541
"6670","Southbridge","Worcester County","MA","Southbridge","1998","Southbridge Town city, MA",368,8236,8604
"6671","Southbridge","Worcester County","MA","Southbridge","1999","Southbridge Town city, MA",316,8169,8485
"6672","Southbridge","Worcester County","MA","Southbridge","2000","Southbridge Town city, MA",269,7891,8160
"6673","Southbridge","Worcester County","MA","Southbridge","2001","Southbridge Town city, MA",378,7866,8244
"6674","Southbridge","Worcester County","MA","Southbridge","2002","Southbridge Town city, MA",542,7789,8331
"6675","Southbridge","Worcester County","MA","Southbridge","2003","Southbridge Town city, MA",623,7723,8346
"6676","Southbridge","Worcester County","MA","Southbridge","2004","Southbridge Town city, MA",568,7662,8230
"6677","Southbridge","Worcester County","MA","Southbridge","2005","Southbridge Town city, MA",510,7602,8112
"6678","Southbridge","Worcester County","MA","Southbridge","2006","Southbridge Town city, MA",540,7741,8281
"6679","Southbridge","Worcester County","MA","Southbridge","2007","Southbridge Town city, MA",501,7730,8231
"6680","Southbridge","Worcester County","MA","Southbridge","2008","Southbridge Town city, MA",628,7573,8201
"6681","Southbridge","Worcester County","MA","Southbridge","2009","Southbridge Town city, MA",849,7359,8208
"6682","Southbridge","Worcester County","MA","Southbridge","2010","Southbridge Town city, MA",964,7059,8023
"6683","Southbridge","Worcester County","MA","Southbridge","2011","Southbridge Town city, MA",870,7121,7991
"6684","Southbridge","Worcester County","MA","Southbridge","2012","Southbridge Town city, MA",808,7119,7927
"6685","Southwick","Hampden County","MA","Southwick","1990","Southwick town, MA",228,4152,4380
"6686","Southwick","Hampden County","MA","Southwick","1991","Southwick town, MA",374,4082,4456
"6687","Southwick","Hampden County","MA","Southwick","1992","Southwick town, MA",423,4147,4570
"6688","Southwick","Hampden County","MA","Southwick","1993","Southwick town, MA",421,4194,4615
"6689","Southwick","Hampden County","MA","Southwick","1994","Southwick town, MA",384,4262,4646
"6690","Southwick","Hampden County","MA","Southwick","1995","Southwick town, MA",310,4110,4420
"6691","Southwick","Hampden County","MA","Southwick","1996","Southwick town, MA",241,4259,4500
"6692","Southwick","Hampden County","MA","Southwick","1997","Southwick town, MA",201,4441,4642
"6693","Southwick","Hampden County","MA","Southwick","1998","Southwick town, MA",183,4533,4716
"6694","Southwick","Hampden County","MA","Southwick","1999","Southwick town, MA",151,4639,4790
"6695","Southwick","Hampden County","MA","Southwick","2000","Southwick town, MA",147,4704,4851
"6696","Southwick","Hampden County","MA","Southwick","2001","Southwick town, MA",182,4773,4955
"6697","Southwick","Hampden County","MA","Southwick","2002","Southwick town, MA",256,4809,5065
"6698","Southwick","Hampden County","MA","Southwick","2003","Southwick town, MA",268,4843,5111
"6699","Southwick","Hampden County","MA","Southwick","2004","Southwick town, MA",259,4902,5161
"6700","Southwick","Hampden County","MA","Southwick","2005","Southwick town, MA",248,4984,5232
"6701","Southwick","Hampden County","MA","Southwick","2006","Southwick town, MA",244,5046,5290
"6702","Southwick","Hampden County","MA","Southwick","2007","Southwick town, MA",228,4970,5198
"6703","Southwick","Hampden County","MA","Southwick","2008","Southwick town, MA",285,4999,5284
"6704","Southwick","Hampden County","MA","Southwick","2009","Southwick town, MA",448,4830,5278
"6705","Southwick","Hampden County","MA","Southwick","2010","Southwick town, MA",488,4748,5236
"6706","Southwick","Hampden County","MA","Southwick","2011","Southwick town, MA",401,4702,5103
"6707","Southwick","Hampden County","MA","Southwick","2012","Southwick town, MA",353,4705,5058
"6708","Spencer","Worcester County","MA","Spencer","1990","Spencer town, MA",395,5695,6090
"6709","Spencer","Worcester County","MA","Spencer","1991","Spencer town, MA",594,5490,6084
"6710","Spencer","Worcester County","MA","Spencer","1992","Spencer town, MA",586,5569,6155
"6711","Spencer","Worcester County","MA","Spencer","1993","Spencer town, MA",454,5604,6058
"6712","Spencer","Worcester County","MA","Spencer","1994","Spencer town, MA",342,5692,6034
"6713","Spencer","Worcester County","MA","Spencer","1995","Spencer town, MA",338,5810,6148
"6714","Spencer","Worcester County","MA","Spencer","1996","Spencer town, MA",315,5957,6272
"6715","Spencer","Worcester County","MA","Spencer","1997","Spencer town, MA",227,6194,6421
"6716","Spencer","Worcester County","MA","Spencer","1998","Spencer town, MA",214,6328,6542
"6717","Spencer","Worcester County","MA","Spencer","1999","Spencer town, MA",193,6296,6489
"6718","Spencer","Worcester County","MA","Spencer","2000","Spencer town, MA",170,6390,6560
"6719","Spencer","Worcester County","MA","Spencer","2001","Spencer town, MA",226,6398,6624
"6720","Spencer","Worcester County","MA","Spencer","2002","Spencer town, MA",341,6366,6707
"6721","Spencer","Worcester County","MA","Spencer","2003","Spencer town, MA",397,6338,6735
"6722","Spencer","Worcester County","MA","Spencer","2004","Spencer town, MA",380,6332,6712
"6723","Spencer","Worcester County","MA","Spencer","2005","Spencer town, MA",338,6353,6691
"6724","Spencer","Worcester County","MA","Spencer","2006","Spencer town, MA",333,6333,6666
"6725","Spencer","Worcester County","MA","Spencer","2007","Spencer town, MA",329,6325,6654
"6726","Spencer","Worcester County","MA","Spencer","2008","Spencer town, MA",399,6193,6592
"6727","Spencer","Worcester County","MA","Spencer","2009","Spencer town, MA",628,6022,6650
"6728","Spencer","Worcester County","MA","Spencer","2010","Spencer town, MA",671,5878,6549
"6729","Spencer","Worcester County","MA","Spencer","2011","Spencer town, MA",509,5931,6440
"6730","Spencer","Worcester County","MA","Spencer","2012","Spencer town, MA",476,5929,6405
"6731","Springfield","Hampden County","MA","Springfield","1990","Springfield city, MA",5588,64373,69961
"6732","Springfield","Hampden County","MA","Springfield","1991","Springfield city, MA",8018,61502,69520
"6733","Springfield","Hampden County","MA","Springfield","1992","Springfield city, MA",7678,60743,68421
"6734","Springfield","Hampden County","MA","Springfield","1993","Springfield city, MA",7035,59891,66926
"6735","Springfield","Hampden County","MA","Springfield","1994","Springfield city, MA",6152,59274,65426
"6736","Springfield","Hampden County","MA","Springfield","1995","Springfield city, MA",5046,60372,65418
"6737","Springfield","Hampden County","MA","Springfield","1996","Springfield city, MA",4072,60729,64801
"6738","Springfield","Hampden County","MA","Springfield","1997","Springfield city, MA",3814,61863,65677
"6739","Springfield","Hampden County","MA","Springfield","1998","Springfield city, MA",3476,61819,65295
"6740","Springfield","Hampden County","MA","Springfield","1999","Springfield city, MA",3401,61764,65165
"6741","Springfield","Hampden County","MA","Springfield","2000","Springfield city, MA",2698,62316,65014
"6742","Springfield","Hampden County","MA","Springfield","2001","Springfield city, MA",3418,62183,65601
"6743","Springfield","Hampden County","MA","Springfield","2002","Springfield city, MA",4803,61827,66630
"6744","Springfield","Hampden County","MA","Springfield","2003","Springfield city, MA",5409,61137,66546
"6745","Springfield","Hampden County","MA","Springfield","2004","Springfield city, MA",5180,61089,66269
"6746","Springfield","Hampden County","MA","Springfield","2005","Springfield city, MA",4812,61182,65994
"6747","Springfield","Hampden County","MA","Springfield","2006","Springfield city, MA",4936,61374,66310
"6748","Springfield","Hampden County","MA","Springfield","2007","Springfield city, MA",4623,61042,65665
"6749","Springfield","Hampden County","MA","Springfield","2008","Springfield city, MA",5293,60781,66074
"6750","Springfield","Hampden County","MA","Springfield","2009","Springfield city, MA",7563,59911,67474
"6751","Springfield","Hampden County","MA","Springfield","2010","Springfield city, MA",8368,59091,67459
"6752","Springfield","Hampden County","MA","Springfield","2011","Springfield city, MA",7883,58500,66383
"6753","Springfield","Hampden County","MA","Springfield","2012","Springfield city, MA",7200,58535,65735
"6754","Sterling","Worcester County","MA","Sterling","1990","Sterling town, MA",189,3264,3453
"6755","Sterling","Worcester County","MA","Sterling","1991","Sterling town, MA",282,3188,3470
"6756","Sterling","Worcester County","MA","Sterling","1992","Sterling town, MA",328,3279,3607
"6757","Sterling","Worcester County","MA","Sterling","1993","Sterling town, MA",266,3420,3686
"6758","Sterling","Worcester County","MA","Sterling","1994","Sterling town, MA",214,3531,3745
"6759","Sterling","Worcester County","MA","Sterling","1995","Sterling town, MA",181,3384,3565
"6760","Sterling","Worcester County","MA","Sterling","1996","Sterling town, MA",127,3477,3604
"6761","Sterling","Worcester County","MA","Sterling","1997","Sterling town, MA",131,3610,3741
"6762","Sterling","Worcester County","MA","Sterling","1998","Sterling town, MA",90,3742,3832
"6763","Sterling","Worcester County","MA","Sterling","1999","Sterling town, MA",127,3803,3930
"6764","Sterling","Worcester County","MA","Sterling","2000","Sterling town, MA",87,4123,4210
"6765","Sterling","Worcester County","MA","Sterling","2001","Sterling town, MA",127,4167,4294
"6766","Sterling","Worcester County","MA","Sterling","2002","Sterling town, MA",213,4186,4399
"6767","Sterling","Worcester County","MA","Sterling","2003","Sterling town, MA",223,4215,4438
"6768","Sterling","Worcester County","MA","Sterling","2004","Sterling town, MA",202,4232,4434
"6769","Sterling","Worcester County","MA","Sterling","2005","Sterling town, MA",194,4234,4428
"6770","Sterling","Worcester County","MA","Sterling","2006","Sterling town, MA",184,4257,4441
"6771","Sterling","Worcester County","MA","Sterling","2007","Sterling town, MA",179,4252,4431
"6772","Sterling","Worcester County","MA","Sterling","2008","Sterling town, MA",192,4162,4354
"6773","Sterling","Worcester County","MA","Sterling","2009","Sterling town, MA",315,4047,4362
"6774","Sterling","Worcester County","MA","Sterling","2010","Sterling town, MA",347,4073,4420
"6775","Sterling","Worcester County","MA","Sterling","2011","Sterling town, MA",279,4109,4388
"6776","Sterling","Worcester County","MA","Sterling","2012","Sterling town, MA",247,4107,4354
"6777","Stockbridge","Berkshire County","MA","Stockbridge","1990","Stockbridge town, MA",42,1052,1094
"6778","Stockbridge","Berkshire County","MA","Stockbridge","1991","Stockbridge town, MA",65,984,1049
"6779","Stockbridge","Berkshire County","MA","Stockbridge","1992","Stockbridge town, MA",74,979,1053
"6780","Stockbridge","Berkshire County","MA","Stockbridge","1993","Stockbridge town, MA",54,971,1025
"6781","Stockbridge","Berkshire County","MA","Stockbridge","1994","Stockbridge town, MA",60,951,1011
"6782","Stockbridge","Berkshire County","MA","Stockbridge","1995","Stockbridge town, MA",56,974,1030
"6783","Stockbridge","Berkshire County","MA","Stockbridge","1996","Stockbridge town, MA",43,987,1030
"6784","Stockbridge","Berkshire County","MA","Stockbridge","1997","Stockbridge town, MA",38,991,1029
"6785","Stockbridge","Berkshire County","MA","Stockbridge","1998","Stockbridge town, MA",34,988,1022
"6786","Stockbridge","Berkshire County","MA","Stockbridge","1999","Stockbridge town, MA",27,989,1016
"6787","Stockbridge","Berkshire County","MA","Stockbridge","2000","Stockbridge town, MA",25,1258,1283
"6788","Stockbridge","Berkshire County","MA","Stockbridge","2001","Stockbridge town, MA",30,1298,1328
"6789","Stockbridge","Berkshire County","MA","Stockbridge","2002","Stockbridge town, MA",46,1334,1380
"6790","Stockbridge","Berkshire County","MA","Stockbridge","2003","Stockbridge town, MA",50,1332,1382
"6791","Stockbridge","Berkshire County","MA","Stockbridge","2004","Stockbridge town, MA",54,1324,1378
"6792","Stockbridge","Berkshire County","MA","Stockbridge","2005","Stockbridge town, MA",46,1354,1400
"6793","Stockbridge","Berkshire County","MA","Stockbridge","2006","Stockbridge town, MA",47,1366,1413
"6794","Stockbridge","Berkshire County","MA","Stockbridge","2007","Stockbridge town, MA",44,1332,1376
"6795","Stockbridge","Berkshire County","MA","Stockbridge","2008","Stockbridge town, MA",52,1326,1378
"6796","Stockbridge","Berkshire County","MA","Stockbridge","2009","Stockbridge town, MA",68,1277,1345
"6797","Stockbridge","Berkshire County","MA","Stockbridge","2010","Stockbridge town, MA",64,1142,1206
"6798","Stockbridge","Berkshire County","MA","Stockbridge","2011","Stockbridge town, MA",61,1149,1210
"6799","Stockbridge","Berkshire County","MA","Stockbridge","2012","Stockbridge town, MA",50,1139,1189
"6800","Stoneham","Middlesex County","MA","Stoneham","1990","Stoneham town, MA",679,11488,12167
"6801","Stoneham","Middlesex County","MA","Stoneham","1991","Stoneham town, MA",881,11027,11908
"6802","Stoneham","Middlesex County","MA","Stoneham","1992","Stoneham town, MA",898,10985,11883
"6803","Stoneham","Middlesex County","MA","Stoneham","1993","Stoneham town, MA",681,10997,11678
"6804","Stoneham","Middlesex County","MA","Stoneham","1994","Stoneham town, MA",607,11198,11805
"6805","Stoneham","Middlesex County","MA","Stoneham","1995","Stoneham town, MA",613,11338,11951
"6806","Stoneham","Middlesex County","MA","Stoneham","1996","Stoneham town, MA",479,11551,12030
"6807","Stoneham","Middlesex County","MA","Stoneham","1997","Stoneham town, MA",421,11838,12259
"6808","Stoneham","Middlesex County","MA","Stoneham","1998","Stoneham town, MA",361,12066,12427
"6809","Stoneham","Middlesex County","MA","Stoneham","1999","Stoneham town, MA",358,12164,12522
"6810","Stoneham","Middlesex County","MA","Stoneham","2000","Stoneham town, MA",281,12006,12287
"6811","Stoneham","Middlesex County","MA","Stoneham","2001","Stoneham town, MA",405,11938,12343
"6812","Stoneham","Middlesex County","MA","Stoneham","2002","Stoneham town, MA",596,11663,12259
"6813","Stoneham","Middlesex County","MA","Stoneham","2003","Stoneham town, MA",626,11422,12048
"6814","Stoneham","Middlesex County","MA","Stoneham","2004","Stoneham town, MA",580,11333,11913
"6815","Stoneham","Middlesex County","MA","Stoneham","2005","Stoneham town, MA",531,11348,11879
"6816","Stoneham","Middlesex County","MA","Stoneham","2006","Stoneham town, MA",507,11061,11568
"6817","Stoneham","Middlesex County","MA","Stoneham","2007","Stoneham town, MA",491,11142,11633
"6818","Stoneham","Middlesex County","MA","Stoneham","2008","Stoneham town, MA",562,11117,11679
"6819","Stoneham","Middlesex County","MA","Stoneham","2009","Stoneham town, MA",870,10817,11687
"6820","Stoneham","Middlesex County","MA","Stoneham","2010","Stoneham town, MA",840,10918,11758
"6821","Stoneham","Middlesex County","MA","Stoneham","2011","Stoneham town, MA",761,11078,11839
"6822","Stoneham","Middlesex County","MA","Stoneham","2012","Stoneham town, MA",665,11199,11864
"6823","Stoughton","Norfolk County","MA","Stoughton","1990","Stoughton town, MA",904,14302,15206
"6824","Stoughton","Norfolk County","MA","Stoughton","1991","Stoughton town, MA",1257,13910,15167
"6825","Stoughton","Norfolk County","MA","Stoughton","1992","Stoughton town, MA",1377,13834,15211
"6826","Stoughton","Norfolk County","MA","Stoughton","1993","Stoughton town, MA",1123,13970,15093
"6827","Stoughton","Norfolk County","MA","Stoughton","1994","Stoughton town, MA",945,14155,15100
"6828","Stoughton","Norfolk County","MA","Stoughton","1995","Stoughton town, MA",775,14472,15247
"6829","Stoughton","Norfolk County","MA","Stoughton","1996","Stoughton town, MA",641,14759,15400
"6830","Stoughton","Norfolk County","MA","Stoughton","1997","Stoughton town, MA",602,15128,15730
"6831","Stoughton","Norfolk County","MA","Stoughton","1998","Stoughton town, MA",472,15337,15809
"6832","Stoughton","Norfolk County","MA","Stoughton","1999","Stoughton town, MA",517,15523,16040
"6833","Stoughton","Norfolk County","MA","Stoughton","2000","Stoughton town, MA",426,14966,15392
"6834","Stoughton","Norfolk County","MA","Stoughton","2001","Stoughton town, MA",563,14918,15481
"6835","Stoughton","Norfolk County","MA","Stoughton","2002","Stoughton town, MA",794,14630,15424
"6836","Stoughton","Norfolk County","MA","Stoughton","2003","Stoughton town, MA",907,14360,15267
"6837","Stoughton","Norfolk County","MA","Stoughton","2004","Stoughton town, MA",786,14279,15065
"6838","Stoughton","Norfolk County","MA","Stoughton","2005","Stoughton town, MA",729,14314,15043
"6839","Stoughton","Norfolk County","MA","Stoughton","2006","Stoughton town, MA",692,14230,14922
"6840","Stoughton","Norfolk County","MA","Stoughton","2007","Stoughton town, MA",654,14402,15056
"6841","Stoughton","Norfolk County","MA","Stoughton","2008","Stoughton town, MA",813,14406,15219
"6842","Stoughton","Norfolk County","MA","Stoughton","2009","Stoughton town, MA",1202,13896,15098
"6843","Stoughton","Norfolk County","MA","Stoughton","2010","Stoughton town, MA",1219,14004,15223
"6844","Stoughton","Norfolk County","MA","Stoughton","2011","Stoughton town, MA",1023,14163,15186
"6845","Stoughton","Norfolk County","MA","Stoughton","2012","Stoughton town, MA",964,14318,15282
"6846","Stow","Middlesex County","MA","Stow","1990","Stow town, MA",114,3009,3123
"6847","Stow","Middlesex County","MA","Stow","1991","Stow town, MA",177,2899,3076
"6848","Stow","Middlesex County","MA","Stow","1992","Stow town, MA",197,2918,3115
"6849","Stow","Middlesex County","MA","Stow","1993","Stow town, MA",176,2995,3171
"6850","Stow","Middlesex County","MA","Stow","1994","Stow town, MA",149,3064,3213
"6851","Stow","Middlesex County","MA","Stow","1995","Stow town, MA",136,3168,3304
"6852","Stow","Middlesex County","MA","Stow","1996","Stow town, MA",88,3256,3344
"6853","Stow","Middlesex County","MA","Stow","1997","Stow town, MA",74,3357,3431
"6854","Stow","Middlesex County","MA","Stow","1998","Stow town, MA",78,3427,3505
"6855","Stow","Middlesex County","MA","Stow","1999","Stow town, MA",77,3490,3567
"6856","Stow","Middlesex County","MA","Stow","2000","Stow town, MA",65,3263,3328
"6857","Stow","Middlesex County","MA","Stow","2001","Stow town, MA",108,3301,3409
"6858","Stow","Middlesex County","MA","Stow","2002","Stow town, MA",168,3264,3432
"6859","Stow","Middlesex County","MA","Stow","2003","Stow town, MA",172,3247,3419
"6860","Stow","Middlesex County","MA","Stow","2004","Stow town, MA",136,3243,3379
"6861","Stow","Middlesex County","MA","Stow","2005","Stow town, MA",123,3310,3433
"6862","Stow","Middlesex County","MA","Stow","2006","Stow town, MA",125,3293,3418
"6863","Stow","Middlesex County","MA","Stow","2007","Stow town, MA",115,3369,3484
"6864","Stow","Middlesex County","MA","Stow","2008","Stow town, MA",150,3442,3592
"6865","Stow","Middlesex County","MA","Stow","2009","Stow town, MA",222,3410,3632
"6866","Stow","Middlesex County","MA","Stow","2010","Stow town, MA",198,3419,3617
"6867","Stow","Middlesex County","MA","Stow","2011","Stow town, MA",175,3469,3644
"6868","Stow","Middlesex County","MA","Stow","2012","Stow town, MA",167,3507,3674
"6869","Sturbridge","Worcester County","MA","Sturbridge","1990","Sturbridge town, MA",238,4001,4239
"6870","Sturbridge","Worcester County","MA","Sturbridge","1991","Sturbridge town, MA",357,3912,4269
"6871","Sturbridge","Worcester County","MA","Sturbridge","1992","Sturbridge town, MA",365,3992,4357
"6872","Sturbridge","Worcester County","MA","Sturbridge","1993","Sturbridge town, MA",279,4057,4336
"6873","Sturbridge","Worcester County","MA","Sturbridge","1994","Sturbridge town, MA",209,4117,4326
"6874","Sturbridge","Worcester County","MA","Sturbridge","1995","Sturbridge town, MA",184,4020,4204
"6875","Sturbridge","Worcester County","MA","Sturbridge","1996","Sturbridge town, MA",156,4092,4248
"6876","Sturbridge","Worcester County","MA","Sturbridge","1997","Sturbridge town, MA",156,4221,4377
"6877","Sturbridge","Worcester County","MA","Sturbridge","1998","Sturbridge town, MA",119,4311,4430
"6878","Sturbridge","Worcester County","MA","Sturbridge","1999","Sturbridge town, MA",111,4296,4407
"6879","Sturbridge","Worcester County","MA","Sturbridge","2000","Sturbridge town, MA",105,4351,4456
"6880","Sturbridge","Worcester County","MA","Sturbridge","2001","Sturbridge town, MA",133,4420,4553
"6881","Sturbridge","Worcester County","MA","Sturbridge","2002","Sturbridge town, MA",224,4447,4671
"6882","Sturbridge","Worcester County","MA","Sturbridge","2003","Sturbridge town, MA",268,4527,4795
"6883","Sturbridge","Worcester County","MA","Sturbridge","2004","Sturbridge town, MA",249,4636,4885
"6884","Sturbridge","Worcester County","MA","Sturbridge","2005","Sturbridge town, MA",214,4711,4925
"6885","Sturbridge","Worcester County","MA","Sturbridge","2006","Sturbridge town, MA",208,4703,4911
"6886","Sturbridge","Worcester County","MA","Sturbridge","2007","Sturbridge town, MA",221,4715,4936
"6887","Sturbridge","Worcester County","MA","Sturbridge","2008","Sturbridge town, MA",248,4620,4868
"6888","Sturbridge","Worcester County","MA","Sturbridge","2009","Sturbridge town, MA",385,4497,4882
"6889","Sturbridge","Worcester County","MA","Sturbridge","2010","Sturbridge town, MA",381,4717,5098
"6890","Sturbridge","Worcester County","MA","Sturbridge","2011","Sturbridge town, MA",357,4759,5116
"6891","Sturbridge","Worcester County","MA","Sturbridge","2012","Sturbridge town, MA",323,4757,5080
"6892","Sudbury","Middlesex County","MA","Sudbury","1990","Sudbury town, MA",280,7916,8196
"6893","Sudbury","Middlesex County","MA","Sudbury","1991","Sudbury town, MA",344,7729,8073
"6894","Sudbury","Middlesex County","MA","Sudbury","1992","Sudbury town, MA",412,7808,8220
"6895","Sudbury","Middlesex County","MA","Sudbury","1993","Sudbury town, MA",344,7997,8341
"6896","Sudbury","Middlesex County","MA","Sudbury","1994","Sudbury town, MA",317,8250,8567
"6897","Sudbury","Middlesex County","MA","Sudbury","1995","Sudbury town, MA",289,8123,8412
"6898","Sudbury","Middlesex County","MA","Sudbury","1996","Sudbury town, MA",199,8379,8578
"6899","Sudbury","Middlesex County","MA","Sudbury","1997","Sudbury town, MA",167,8680,8847
"6900","Sudbury","Middlesex County","MA","Sudbury","1998","Sudbury town, MA",142,8917,9059
"6901","Sudbury","Middlesex County","MA","Sudbury","1999","Sudbury town, MA",144,9146,9290
"6902","Sudbury","Middlesex County","MA","Sudbury","2000","Sudbury town, MA",153,8305,8458
"6903","Sudbury","Middlesex County","MA","Sudbury","2001","Sudbury town, MA",255,8366,8621
"6904","Sudbury","Middlesex County","MA","Sudbury","2002","Sudbury town, MA",405,8260,8665
"6905","Sudbury","Middlesex County","MA","Sudbury","2003","Sudbury town, MA",408,8136,8544
"6906","Sudbury","Middlesex County","MA","Sudbury","2004","Sudbury town, MA",323,8122,8445
"6907","Sudbury","Middlesex County","MA","Sudbury","2005","Sudbury town, MA",287,8162,8449
"6908","Sudbury","Middlesex County","MA","Sudbury","2006","Sudbury town, MA",308,8054,8362
"6909","Sudbury","Middlesex County","MA","Sudbury","2007","Sudbury town, MA",265,8160,8425
"6910","Sudbury","Middlesex County","MA","Sudbury","2008","Sudbury town, MA",323,8208,8531
"6911","Sudbury","Middlesex County","MA","Sudbury","2009","Sudbury town, MA",515,8061,8576
"6912","Sudbury","Middlesex County","MA","Sudbury","2010","Sudbury town, MA",507,8180,8687
"6913","Sudbury","Middlesex County","MA","Sudbury","2011","Sudbury town, MA",436,8301,8737
"6914","Sudbury","Middlesex County","MA","Sudbury","2012","Sudbury town, MA",395,8392,8787
"6915",NA,"Suffolk County","MA","Suffolk County","1990","Suffolk County, MA",21425,328598,350023
"6916",NA,"Suffolk County","MA","Suffolk County","1991","Suffolk County, MA",29524,312148,341672
"6917",NA,"Suffolk County","MA","Suffolk County","1992","Suffolk County, MA",28585,304876,333461
"6918",NA,"Suffolk County","MA","Suffolk County","1993","Suffolk County, MA",23615,306629,330244
"6919",NA,"Suffolk County","MA","Suffolk County","1994","Suffolk County, MA",20383,308484,328867
"6920",NA,"Suffolk County","MA","Suffolk County","1995","Suffolk County, MA",18920,318455,337375
"6921",NA,"Suffolk County","MA","Suffolk County","1996","Suffolk County, MA",16232,322348,338580
"6922",NA,"Suffolk County","MA","Suffolk County","1997","Suffolk County, MA",14912,328401,343313
"6923",NA,"Suffolk County","MA","Suffolk County","1998","Suffolk County, MA",12289,332037,344326
"6924",NA,"Suffolk County","MA","Suffolk County","1999","Suffolk County, MA",12148,334447,346595
"6925",NA,"Suffolk County","MA","Suffolk County","2000","Suffolk County, MA",10739,340347,351086
"6926",NA,"Suffolk County","MA","Suffolk County","2001","Suffolk County, MA",14645,339407,354052
"6927",NA,"Suffolk County","MA","Suffolk County","2002","Suffolk County, MA",20873,330953,351826
"6928",NA,"Suffolk County","MA","Suffolk County","2003","Suffolk County, MA",22566,321685,344251
"6929",NA,"Suffolk County","MA","Suffolk County","2004","Suffolk County, MA",19356,316149,335505
"6930",NA,"Suffolk County","MA","Suffolk County","2005","Suffolk County, MA",17660,314335,331995
"6931",NA,"Suffolk County","MA","Suffolk County","2006","Suffolk County, MA",17826,340610,358436
"6932",NA,"Suffolk County","MA","Suffolk County","2007","Suffolk County, MA",16381,348430,364811
"6933",NA,"Suffolk County","MA","Suffolk County","2008","Suffolk County, MA",19589,353405,372994
"6934",NA,"Suffolk County","MA","Suffolk County","2009","Suffolk County, MA",29134,345421,374555
"6935",NA,"Suffolk County","MA","Suffolk County","2010","Suffolk County, MA",29709,335890,365599
"6936",NA,"Suffolk County","MA","Suffolk County","2011","Suffolk County, MA",26164,341489,367653
"6937",NA,"Suffolk County","MA","Suffolk County","2012","Suffolk County, MA",24392,345228,369620
"6938","Sunderland","Franklin County","MA","Sunderland","1990","Sunderland town, MA",83,1989,2072
"6939","Sunderland","Franklin County","MA","Sunderland","1991","Sunderland town, MA",120,1884,2004
"6940","Sunderland","Franklin County","MA","Sunderland","1992","Sunderland town, MA",123,1897,2020
"6941","Sunderland","Franklin County","MA","Sunderland","1993","Sunderland town, MA",106,1981,2087
"6942","Sunderland","Franklin County","MA","Sunderland","1994","Sunderland town, MA",98,2014,2112
"6943","Sunderland","Franklin County","MA","Sunderland","1995","Sunderland town, MA",72,2000,2072
"6944","Sunderland","Franklin County","MA","Sunderland","1996","Sunderland town, MA",53,2037,2090
"6945","Sunderland","Franklin County","MA","Sunderland","1997","Sunderland town, MA",45,2080,2125
"6946","Sunderland","Franklin County","MA","Sunderland","1998","Sunderland town, MA",45,2080,2125
"6947","Sunderland","Franklin County","MA","Sunderland","1999","Sunderland town, MA",48,2109,2157
"6948","Sunderland","Franklin County","MA","Sunderland","2000","Sunderland town, MA",41,2197,2238
"6949","Sunderland","Franklin County","MA","Sunderland","2001","Sunderland town, MA",48,2252,2300
"6950","Sunderland","Franklin County","MA","Sunderland","2002","Sunderland town, MA",68,2245,2313
"6951","Sunderland","Franklin County","MA","Sunderland","2003","Sunderland town, MA",81,2265,2346
"6952","Sunderland","Franklin County","MA","Sunderland","2004","Sunderland town, MA",74,2285,2359
"6953","Sunderland","Franklin County","MA","Sunderland","2005","Sunderland town, MA",77,2288,2365
"6954","Sunderland","Franklin County","MA","Sunderland","2006","Sunderland town, MA",80,2297,2377
"6955","Sunderland","Franklin County","MA","Sunderland","2007","Sunderland town, MA",78,2275,2353
"6956","Sunderland","Franklin County","MA","Sunderland","2008","Sunderland town, MA",80,2189,2269
"6957","Sunderland","Franklin County","MA","Sunderland","2009","Sunderland town, MA",119,2243,2362
"6958","Sunderland","Franklin County","MA","Sunderland","2010","Sunderland town, MA",126,2055,2181
"6959","Sunderland","Franklin County","MA","Sunderland","2011","Sunderland town, MA",102,2077,2179
"6960","Sunderland","Franklin County","MA","Sunderland","2012","Sunderland town, MA",92,2096,2188
"6961","Sutton","Worcester County","MA","Sutton","1990","Sutton town, MA",172,3533,3705
"6962","Sutton","Worcester County","MA","Sutton","1991","Sutton town, MA",291,3495,3786
"6963","Sutton","Worcester County","MA","Sutton","1992","Sutton town, MA",297,3558,3855
"6964","Sutton","Worcester County","MA","Sutton","1993","Sutton town, MA",218,3714,3932
"6965","Sutton","Worcester County","MA","Sutton","1994","Sutton town, MA",187,3872,4059
"6966","Sutton","Worcester County","MA","Sutton","1995","Sutton town, MA",170,3707,3877
"6967","Sutton","Worcester County","MA","Sutton","1996","Sutton town, MA",159,3798,3957
"6968","Sutton","Worcester County","MA","Sutton","1997","Sutton town, MA",154,3932,4086
"6969","Sutton","Worcester County","MA","Sutton","1998","Sutton town, MA",112,4004,4116
"6970","Sutton","Worcester County","MA","Sutton","1999","Sutton town, MA",122,4057,4179
"6971","Sutton","Worcester County","MA","Sutton","2000","Sutton town, MA",102,4478,4580
"6972","Sutton","Worcester County","MA","Sutton","2001","Sutton town, MA",155,4565,4720
"6973","Sutton","Worcester County","MA","Sutton","2002","Sutton town, MA",214,4592,4806
"6974","Sutton","Worcester County","MA","Sutton","2003","Sutton town, MA",248,4633,4881
"6975","Sutton","Worcester County","MA","Sutton","2004","Sutton town, MA",233,4625,4858
"6976","Sutton","Worcester County","MA","Sutton","2005","Sutton town, MA",213,4669,4882
"6977","Sutton","Worcester County","MA","Sutton","2006","Sutton town, MA",199,4728,4927
"6978","Sutton","Worcester County","MA","Sutton","2007","Sutton town, MA",196,4752,4948
"6979","Sutton","Worcester County","MA","Sutton","2008","Sutton town, MA",242,4668,4910
"6980","Sutton","Worcester County","MA","Sutton","2009","Sutton town, MA",374,4548,4922
"6981","Sutton","Worcester County","MA","Sutton","2010","Sutton town, MA",387,4456,4843
"6982","Sutton","Worcester County","MA","Sutton","2011","Sutton town, MA",337,4496,4833
"6983","Sutton","Worcester County","MA","Sutton","2012","Sutton town, MA",308,4495,4803
"6984","Swampscott","Essex County","MA","Swampscott","1990","Swampscott town, MA",324,6947,7271
"6985","Swampscott","Essex County","MA","Swampscott","1991","Swampscott town, MA",506,6736,7242
"6986","Swampscott","Essex County","MA","Swampscott","1992","Swampscott town, MA",527,6687,7214
"6987","Swampscott","Essex County","MA","Swampscott","1993","Swampscott town, MA",375,6717,7092
"6988","Swampscott","Essex County","MA","Swampscott","1994","Swampscott town, MA",357,6851,7208
"6989","Swampscott","Essex County","MA","Swampscott","1995","Swampscott town, MA",298,6863,7161
"6990","Swampscott","Essex County","MA","Swampscott","1996","Swampscott town, MA",247,6997,7244
"6991","Swampscott","Essex County","MA","Swampscott","1997","Swampscott town, MA",230,7176,7406
"6992","Swampscott","Essex County","MA","Swampscott","1998","Swampscott town, MA",185,7258,7443
"6993","Swampscott","Essex County","MA","Swampscott","1999","Swampscott town, MA",191,7347,7538
"6994","Swampscott","Essex County","MA","Swampscott","2000","Swampscott town, MA",173,7739,7912
"6995","Swampscott","Essex County","MA","Swampscott","2001","Swampscott town, MA",236,7746,7982
"6996","Swampscott","Essex County","MA","Swampscott","2002","Swampscott town, MA",345,7638,7983
"6997","Swampscott","Essex County","MA","Swampscott","2003","Swampscott town, MA",384,7552,7936
"6998","Swampscott","Essex County","MA","Swampscott","2004","Swampscott town, MA",336,7476,7812
"6999","Swampscott","Essex County","MA","Swampscott","2005","Swampscott town, MA",306,7415,7721
"7000","Swampscott","Essex County","MA","Swampscott","2006","Swampscott town, MA",293,7423,7716
"7001","Swampscott","Essex County","MA","Swampscott","2007","Swampscott town, MA",260,7377,7637
"7002","Swampscott","Essex County","MA","Swampscott","2008","Swampscott town, MA",334,7360,7694
"7003","Swampscott","Essex County","MA","Swampscott","2009","Swampscott town, MA",537,7205,7742
"7004","Swampscott","Essex County","MA","Swampscott","2010","Swampscott town, MA",537,7074,7611
"7005","Swampscott","Essex County","MA","Swampscott","2011","Swampscott town, MA",417,7157,7574
"7006","Swampscott","Essex County","MA","Swampscott","2012","Swampscott town, MA",402,7212,7614
"7007","Swansea","Bristol County","MA","Swansea","1990","Swansea town, MA",635,8192,8827
"7008","Swansea","Bristol County","MA","Swansea","1991","Swansea town, MA",1042,7863,8905
"7009","Swansea","Bristol County","MA","Swansea","1992","Swansea town, MA",1051,7887,8938
"7010","Swansea","Bristol County","MA","Swansea","1993","Swansea town, MA",1034,8050,9084
"7011","Swansea","Bristol County","MA","Swansea","1994","Swansea town, MA",748,8228,8976
"7012","Swansea","Bristol County","MA","Swansea","1995","Swansea town, MA",675,8271,8946
"7013","Swansea","Bristol County","MA","Swansea","1996","Swansea town, MA",613,8320,8933
"7014","Swansea","Bristol County","MA","Swansea","1997","Swansea town, MA",542,8486,9028
"7015","Swansea","Bristol County","MA","Swansea","1998","Swansea town, MA",353,8554,8907
"7016","Swansea","Bristol County","MA","Swansea","1999","Swansea town, MA",333,8567,8900
"7017","Swansea","Bristol County","MA","Swansea","2000","Swansea town, MA",340,8703,9043
"7018","Swansea","Bristol County","MA","Swansea","2001","Swansea town, MA",399,8663,9062
"7019","Swansea","Bristol County","MA","Swansea","2002","Swansea town, MA",506,8731,9237
"7020","Swansea","Bristol County","MA","Swansea","2003","Swansea town, MA",532,8813,9345
"7021","Swansea","Bristol County","MA","Swansea","2004","Swansea town, MA",525,8838,9363
"7022","Swansea","Bristol County","MA","Swansea","2005","Swansea town, MA",493,8864,9357
"7023","Swansea","Bristol County","MA","Swansea","2006","Swansea town, MA",544,8942,9486
"7024","Swansea","Bristol County","MA","Swansea","2007","Swansea town, MA",534,8973,9507
"7025","Swansea","Bristol County","MA","Swansea","2008","Swansea town, MA",643,8794,9437
"7026","Swansea","Bristol County","MA","Swansea","2009","Swansea town, MA",1022,8393,9415
"7027","Swansea","Bristol County","MA","Swansea","2010","Swansea town, MA",1021,8208,9229
"7028","Swansea","Bristol County","MA","Swansea","2011","Swansea town, MA",944,8268,9212
"7029","Swansea","Bristol County","MA","Swansea","2012","Swansea town, MA",879,8281,9160
"7030","Taunton","Bristol County","MA","Taunton","1990","Taunton city, MA",2236,24546,26782
"7031","Taunton","Bristol County","MA","Taunton","1991","Taunton city, MA",2826,23826,26652
"7032","Taunton","Bristol County","MA","Taunton","1992","Taunton city, MA",2859,23872,26731
"7033","Taunton","Bristol County","MA","Taunton","1993","Taunton city, MA",2342,24262,26604
"7034","Taunton","Bristol County","MA","Taunton","1994","Taunton city, MA",2006,24805,26811
"7035","Taunton","Bristol County","MA","Taunton","1995","Taunton city, MA",1813,25127,26940
"7036","Taunton","Bristol County","MA","Taunton","1996","Taunton city, MA",1571,25611,27182
"7037","Taunton","Bristol County","MA","Taunton","1997","Taunton city, MA",1378,26347,27725
"7038","Taunton","Bristol County","MA","Taunton","1998","Taunton city, MA",1073,26921,27994
"7039","Taunton","Bristol County","MA","Taunton","1999","Taunton city, MA",997,27314,28311
"7040","Taunton","Bristol County","MA","Taunton","2000","Taunton city, MA",888,29297,30185
"7041","Taunton","Bristol County","MA","Taunton","2001","Taunton city, MA",1186,29295,30481
"7042","Taunton","Bristol County","MA","Taunton","2002","Taunton city, MA",1640,29178,30818
"7043","Taunton","Bristol County","MA","Taunton","2003","Taunton city, MA",1828,29012,30840
"7044","Taunton","Bristol County","MA","Taunton","2004","Taunton city, MA",1683,28756,30439
"7045","Taunton","Bristol County","MA","Taunton","2005","Taunton city, MA",1577,29068,30645
"7046","Taunton","Bristol County","MA","Taunton","2006","Taunton city, MA",1664,29336,31000
"7047","Taunton","Bristol County","MA","Taunton","2007","Taunton city, MA",1577,29436,31013
"7048","Taunton","Bristol County","MA","Taunton","2008","Taunton city, MA",1951,29355,31306
"7049","Taunton","Bristol County","MA","Taunton","2009","Taunton city, MA",2960,28291,31251
"7050","Taunton","Bristol County","MA","Taunton","2010","Taunton city, MA",2951,28207,31158
"7051","Taunton","Bristol County","MA","Taunton","2011","Taunton city, MA",2653,28500,31153
"7052","Taunton","Bristol County","MA","Taunton","2012","Taunton city, MA",2378,28415,30793
"7053","Templeton","Worcester County","MA","Templeton","1990","Templeton town, MA",281,3042,3323
"7054","Templeton","Worcester County","MA","Templeton","1991","Templeton town, MA",389,3002,3391
"7055","Templeton","Worcester County","MA","Templeton","1992","Templeton town, MA",370,3103,3473
"7056","Templeton","Worcester County","MA","Templeton","1993","Templeton town, MA",257,3116,3373
"7057","Templeton","Worcester County","MA","Templeton","1994","Templeton town, MA",239,3104,3343
"7058","Templeton","Worcester County","MA","Templeton","1995","Templeton town, MA",234,3274,3508
"7059","Templeton","Worcester County","MA","Templeton","1996","Templeton town, MA",217,3281,3498
"7060","Templeton","Worcester County","MA","Templeton","1997","Templeton town, MA",191,3368,3559
"7061","Templeton","Worcester County","MA","Templeton","1998","Templeton town, MA",155,3387,3542
"7062","Templeton","Worcester County","MA","Templeton","1999","Templeton town, MA",158,3397,3555
"7063","Templeton","Worcester County","MA","Templeton","2000","Templeton town, MA",125,3363,3488
"7064","Templeton","Worcester County","MA","Templeton","2001","Templeton town, MA",155,3367,3522
"7065","Templeton","Worcester County","MA","Templeton","2002","Templeton town, MA",231,3397,3628
"7066","Templeton","Worcester County","MA","Templeton","2003","Templeton town, MA",269,3404,3673
"7067","Templeton","Worcester County","MA","Templeton","2004","Templeton town, MA",246,3417,3663
"7068","Templeton","Worcester County","MA","Templeton","2005","Templeton town, MA",259,3457,3716
"7069","Templeton","Worcester County","MA","Templeton","2006","Templeton town, MA",253,3583,3836
"7070","Templeton","Worcester County","MA","Templeton","2007","Templeton town, MA",222,3639,3861
"7071","Templeton","Worcester County","MA","Templeton","2008","Templeton town, MA",266,3612,3878
"7072","Templeton","Worcester County","MA","Templeton","2009","Templeton town, MA",407,3463,3870
"7073","Templeton","Worcester County","MA","Templeton","2010","Templeton town, MA",412,3564,3976
"7074","Templeton","Worcester County","MA","Templeton","2011","Templeton town, MA",364,3561,3925
"7075","Templeton","Worcester County","MA","Templeton","2012","Templeton town, MA",353,3558,3911
"7076","Tewksbury","Middlesex County","MA","Tewksbury","1990","Tewksbury town, MA",1007,15615,16622
"7077","Tewksbury","Middlesex County","MA","Tewksbury","1991","Tewksbury town, MA",1420,15208,16628
"7078","Tewksbury","Middlesex County","MA","Tewksbury","1992","Tewksbury town, MA",1471,15415,16886
"7079","Tewksbury","Middlesex County","MA","Tewksbury","1993","Tewksbury town, MA",1244,15493,16737
"7080","Tewksbury","Middlesex County","MA","Tewksbury","1994","Tewksbury town, MA",985,15635,16620
"7081","Tewksbury","Middlesex County","MA","Tewksbury","1995","Tewksbury town, MA",838,15435,16273
"7082","Tewksbury","Middlesex County","MA","Tewksbury","1996","Tewksbury town, MA",679,16031,16710
"7083","Tewksbury","Middlesex County","MA","Tewksbury","1997","Tewksbury town, MA",611,16725,17336
"7084","Tewksbury","Middlesex County","MA","Tewksbury","1998","Tewksbury town, MA",505,17033,17538
"7085","Tewksbury","Middlesex County","MA","Tewksbury","1999","Tewksbury town, MA",552,17576,18128
"7086","Tewksbury","Middlesex County","MA","Tewksbury","2000","Tewksbury town, MA",398,16224,16622
"7087","Tewksbury","Middlesex County","MA","Tewksbury","2001","Tewksbury town, MA",576,16349,16925
"7088","Tewksbury","Middlesex County","MA","Tewksbury","2002","Tewksbury town, MA",897,16096,16993
"7089","Tewksbury","Middlesex County","MA","Tewksbury","2003","Tewksbury town, MA",1002,15818,16820
"7090","Tewksbury","Middlesex County","MA","Tewksbury","2004","Tewksbury town, MA",823,15683,16506
"7091","Tewksbury","Middlesex County","MA","Tewksbury","2005","Tewksbury town, MA",775,15748,16523
"7092","Tewksbury","Middlesex County","MA","Tewksbury","2006","Tewksbury town, MA",740,15936,16676
"7093","Tewksbury","Middlesex County","MA","Tewksbury","2007","Tewksbury town, MA",700,16031,16731
"7094","Tewksbury","Middlesex County","MA","Tewksbury","2008","Tewksbury town, MA",815,15953,16768
"7095","Tewksbury","Middlesex County","MA","Tewksbury","2009","Tewksbury town, MA",1323,16042,17365
"7096","Tewksbury","Middlesex County","MA","Tewksbury","2010","Tewksbury town, MA",1292,15298,16590
"7097","Tewksbury","Middlesex County","MA","Tewksbury","2011","Tewksbury town, MA",1119,15459,16578
"7098","Tewksbury","Middlesex County","MA","Tewksbury","2012","Tewksbury town, MA",1026,15629,16655
"7099","Tisbury","Dukes County","MA","Tisbury","1990","Tisbury town, MA",125,1838,1963
"7100","Tisbury","Dukes County","MA","Tisbury","1991","Tisbury town, MA",174,1872,2046
"7101","Tisbury","Dukes County","MA","Tisbury","1992","Tisbury town, MA",207,1736,1943
"7102","Tisbury","Dukes County","MA","Tisbury","1993","Tisbury town, MA",196,1774,1970
"7103","Tisbury","Dukes County","MA","Tisbury","1994","Tisbury town, MA",198,1905,2103
"7104","Tisbury","Dukes County","MA","Tisbury","1995","Tisbury town, MA",151,1997,2148
"7105","Tisbury","Dukes County","MA","Tisbury","1996","Tisbury town, MA",153,2074,2227
"7106","Tisbury","Dukes County","MA","Tisbury","1997","Tisbury town, MA",143,2116,2259
"7107","Tisbury","Dukes County","MA","Tisbury","1998","Tisbury town, MA",130,2154,2284
"7108","Tisbury","Dukes County","MA","Tisbury","1999","Tisbury town, MA",121,2190,2311
"7109","Tisbury","Dukes County","MA","Tisbury","2000","Tisbury town, MA",91,2420,2511
"7110","Tisbury","Dukes County","MA","Tisbury","2001","Tisbury town, MA",96,2424,2520
"7111","Tisbury","Dukes County","MA","Tisbury","2002","Tisbury town, MA",137,2507,2644
"7112","Tisbury","Dukes County","MA","Tisbury","2003","Tisbury town, MA",137,2589,2726
"7113","Tisbury","Dukes County","MA","Tisbury","2004","Tisbury town, MA",138,2594,2732
"7114","Tisbury","Dukes County","MA","Tisbury","2005","Tisbury town, MA",132,2545,2677
"7115","Tisbury","Dukes County","MA","Tisbury","2006","Tisbury town, MA",122,2573,2695
"7116","Tisbury","Dukes County","MA","Tisbury","2007","Tisbury town, MA",116,2609,2725
"7117","Tisbury","Dukes County","MA","Tisbury","2008","Tisbury town, MA",135,2606,2741
"7118","Tisbury","Dukes County","MA","Tisbury","2009","Tisbury town, MA",205,2575,2780
"7119","Tisbury","Dukes County","MA","Tisbury","2010","Tisbury town, MA",261,2518,2779
"7120","Tisbury","Dukes County","MA","Tisbury","2011","Tisbury town, MA",231,2538,2769
"7121","Tisbury","Dukes County","MA","Tisbury","2012","Tisbury town, MA",244,2563,2807
"7122","Tolland","Hampden County","MA","Tolland","1990","Tolland town, MA",6,125,131
"7123","Tolland","Hampden County","MA","Tolland","1991","Tolland town, MA",8,120,128
"7124","Tolland","Hampden County","MA","Tolland","1992","Tolland town, MA",13,135,148
"7125","Tolland","Hampden County","MA","Tolland","1993","Tolland town, MA",14,140,154
"7126","Tolland","Hampden County","MA","Tolland","1994","Tolland town, MA",14,143,157
"7127","Tolland","Hampden County","MA","Tolland","1995","Tolland town, MA",18,151,169
"7128","Tolland","Hampden County","MA","Tolland","1996","Tolland town, MA",12,145,157
"7129","Tolland","Hampden County","MA","Tolland","1997","Tolland town, MA",8,147,155
"7130","Tolland","Hampden County","MA","Tolland","1998","Tolland town, MA",5,154,159
"7131","Tolland","Hampden County","MA","Tolland","1999","Tolland town, MA",4,167,171
"7132","Tolland","Hampden County","MA","Tolland","2000","Tolland town, MA",5,234,239
"7133","Tolland","Hampden County","MA","Tolland","2001","Tolland town, MA",4,236,240
"7134","Tolland","Hampden County","MA","Tolland","2002","Tolland town, MA",6,235,241
"7135","Tolland","Hampden County","MA","Tolland","2003","Tolland town, MA",6,235,241
"7136","Tolland","Hampden County","MA","Tolland","2004","Tolland town, MA",8,239,247
"7137","Tolland","Hampden County","MA","Tolland","2005","Tolland town, MA",9,242,251
"7138","Tolland","Hampden County","MA","Tolland","2006","Tolland town, MA",6,244,250
"7139","Tolland","Hampden County","MA","Tolland","2007","Tolland town, MA",8,246,254
"7140","Tolland","Hampden County","MA","Tolland","2008","Tolland town, MA",8,248,256
"7141","Tolland","Hampden County","MA","Tolland","2009","Tolland town, MA",15,240,255
"7142","Tolland","Hampden County","MA","Tolland","2010","Tolland town, MA",13,252,265
"7143","Tolland","Hampden County","MA","Tolland","2011","Tolland town, MA",13,249,262
"7144","Tolland","Hampden County","MA","Tolland","2012","Tolland town, MA",10,249,259
"7145","Topsfield","Essex County","MA","Topsfield","1990","Topsfield town, MA",111,2836,2947
"7146","Topsfield","Essex County","MA","Topsfield","1991","Topsfield town, MA",163,2729,2892
"7147","Topsfield","Essex County","MA","Topsfield","1992","Topsfield town, MA",181,2737,2918
"7148","Topsfield","Essex County","MA","Topsfield","1993","Topsfield town, MA",156,2803,2959
"7149","Topsfield","Essex County","MA","Topsfield","1994","Topsfield town, MA",113,2858,2971
"7150","Topsfield","Essex County","MA","Topsfield","1995","Topsfield town, MA",97,2894,2991
"7151","Topsfield","Essex County","MA","Topsfield","1996","Topsfield town, MA",63,3020,3083
"7152","Topsfield","Essex County","MA","Topsfield","1997","Topsfield town, MA",73,3132,3205
"7153","Topsfield","Essex County","MA","Topsfield","1998","Topsfield town, MA",64,3115,3179
"7154","Topsfield","Essex County","MA","Topsfield","1999","Topsfield town, MA",60,3167,3227
"7155","Topsfield","Essex County","MA","Topsfield","2000","Topsfield town, MA",60,2997,3057
"7156","Topsfield","Essex County","MA","Topsfield","2001","Topsfield town, MA",81,3020,3101
"7157","Topsfield","Essex County","MA","Topsfield","2002","Topsfield town, MA",124,2972,3096
"7158","Topsfield","Essex County","MA","Topsfield","2003","Topsfield town, MA",126,2932,3058
"7159","Topsfield","Essex County","MA","Topsfield","2004","Topsfield town, MA",116,2917,3033
"7160","Topsfield","Essex County","MA","Topsfield","2005","Topsfield town, MA",102,2929,3031
"7161","Topsfield","Essex County","MA","Topsfield","2006","Topsfield town, MA",107,2844,2951
"7162","Topsfield","Essex County","MA","Topsfield","2007","Topsfield town, MA",99,2861,2960
"7163","Topsfield","Essex County","MA","Topsfield","2008","Topsfield town, MA",119,2867,2986
"7164","Topsfield","Essex County","MA","Topsfield","2009","Topsfield town, MA",193,2777,2970
"7165","Topsfield","Essex County","MA","Topsfield","2010","Topsfield town, MA",194,2792,2986
"7166","Topsfield","Essex County","MA","Topsfield","2011","Topsfield town, MA",166,2826,2992
"7167","Topsfield","Essex County","MA","Topsfield","2012","Topsfield town, MA",142,2857,2999
"7168","Townsend","Middlesex County","MA","Townsend","1990","Townsend town, MA",236,4353,4589
"7169","Townsend","Middlesex County","MA","Townsend","1991","Townsend town, MA",336,4220,4556
"7170","Townsend","Middlesex County","MA","Townsend","1992","Townsend town, MA",333,4304,4637
"7171","Townsend","Middlesex County","MA","Townsend","1993","Townsend town, MA",289,4386,4675
"7172","Townsend","Middlesex County","MA","Townsend","1994","Townsend town, MA",241,4543,4784
"7173","Townsend","Middlesex County","MA","Townsend","1995","Townsend town, MA",229,4521,4750
"7174","Townsend","Middlesex County","MA","Townsend","1996","Townsend town, MA",190,4640,4830
"7175","Townsend","Middlesex County","MA","Townsend","1997","Townsend town, MA",176,4785,4961
"7176","Townsend","Middlesex County","MA","Townsend","1998","Townsend town, MA",135,4894,5029
"7177","Townsend","Middlesex County","MA","Townsend","1999","Townsend town, MA",159,4966,5125
"7178","Townsend","Middlesex County","MA","Townsend","2000","Townsend town, MA",120,5007,5127
"7179","Townsend","Middlesex County","MA","Townsend","2001","Townsend town, MA",176,4971,5147
"7180","Townsend","Middlesex County","MA","Townsend","2002","Townsend town, MA",267,4861,5128
"7181","Townsend","Middlesex County","MA","Townsend","2003","Townsend town, MA",287,4960,5247
"7182","Townsend","Middlesex County","MA","Townsend","2004","Townsend town, MA",261,4990,5251
"7183","Townsend","Middlesex County","MA","Townsend","2005","Townsend town, MA",226,5032,5258
"7184","Townsend","Middlesex County","MA","Townsend","2006","Townsend town, MA",211,5055,5266
"7185","Townsend","Middlesex County","MA","Townsend","2007","Townsend town, MA",205,5086,5291
"7186","Townsend","Middlesex County","MA","Townsend","2008","Townsend town, MA",247,5080,5327
"7187","Townsend","Middlesex County","MA","Townsend","2009","Townsend town, MA",388,5003,5391
"7188","Townsend","Middlesex County","MA","Townsend","2010","Townsend town, MA",410,4687,5097
"7189","Townsend","Middlesex County","MA","Townsend","2011","Townsend town, MA",318,4702,5020
"7190","Townsend","Middlesex County","MA","Townsend","2012","Townsend town, MA",303,4743,5046
"7191","Truro","Barnstable County","MA","Truro","1990","Truro town, MA",127,1049,1176
"7192","Truro","Barnstable County","MA","Truro","1991","Truro town, MA",196,1051,1247
"7193","Truro","Barnstable County","MA","Truro","1992","Truro town, MA",200,1037,1237
"7194","Truro","Barnstable County","MA","Truro","1993","Truro town, MA",212,1106,1318
"7195","Truro","Barnstable County","MA","Truro","1994","Truro town, MA",222,1121,1343
"7196","Truro","Barnstable County","MA","Truro","1995","Truro town, MA",188,1170,1358
"7197","Truro","Barnstable County","MA","Truro","1996","Truro town, MA",188,1176,1364
"7198","Truro","Barnstable County","MA","Truro","1997","Truro town, MA",191,1183,1374
"7199","Truro","Barnstable County","MA","Truro","1998","Truro town, MA",150,1207,1357
"7200","Truro","Barnstable County","MA","Truro","1999","Truro town, MA",153,1250,1403
"7201","Truro","Barnstable County","MA","Truro","2000","Truro town, MA",85,1047,1132
"7202","Truro","Barnstable County","MA","Truro","2001","Truro town, MA",85,1061,1146
"7203","Truro","Barnstable County","MA","Truro","2002","Truro town, MA",101,1086,1187
"7204","Truro","Barnstable County","MA","Truro","2003","Truro town, MA",107,1113,1220
"7205","Truro","Barnstable County","MA","Truro","2004","Truro town, MA",114,1129,1243
"7206","Truro","Barnstable County","MA","Truro","2005","Truro town, MA",98,1127,1225
"7207","Truro","Barnstable County","MA","Truro","2006","Truro town, MA",100,1132,1232
"7208","Truro","Barnstable County","MA","Truro","2007","Truro town, MA",91,1129,1220
"7209","Truro","Barnstable County","MA","Truro","2008","Truro town, MA",126,1123,1249
"7210","Truro","Barnstable County","MA","Truro","2009","Truro town, MA",164,1091,1255
"7211","Truro","Barnstable County","MA","Truro","2010","Truro town, MA",177,1043,1220
"7212","Truro","Barnstable County","MA","Truro","2011","Truro town, MA",169,1042,1211
"7213","Truro","Barnstable County","MA","Truro","2012","Truro town, MA",160,1059,1219
"7214","Tyngsborough","Middlesex County","MA","Tyngsborough","1990","Tyngsborough town, MA",343,4810,5153
"7215","Tyngsborough","Middlesex County","MA","Tyngsborough","1991","Tyngsborough town, MA",485,4732,5217
"7216","Tyngsborough","Middlesex County","MA","Tyngsborough","1992","Tyngsborough town, MA",519,4800,5319
"7217","Tyngsborough","Middlesex County","MA","Tyngsborough","1993","Tyngsborough town, MA",438,4887,5325
"7218","Tyngsborough","Middlesex County","MA","Tyngsborough","1994","Tyngsborough town, MA",386,5072,5458
"7219","Tyngsborough","Middlesex County","MA","Tyngsborough","1995","Tyngsborough town, MA",323,5057,5380
"7220","Tyngsborough","Middlesex County","MA","Tyngsborough","1996","Tyngsborough town, MA",234,5344,5578
"7221","Tyngsborough","Middlesex County","MA","Tyngsborough","1997","Tyngsborough town, MA",209,5649,5858
"7222","Tyngsborough","Middlesex County","MA","Tyngsborough","1998","Tyngsborough town, MA",203,5909,6112
"7223","Tyngsborough","Middlesex County","MA","Tyngsborough","1999","Tyngsborough town, MA",212,6206,6418
"7224","Tyngsborough","Middlesex County","MA","Tyngsborough","2000","Tyngsborough town, MA",153,6172,6325
"7225","Tyngsborough","Middlesex County","MA","Tyngsborough","2001","Tyngsborough town, MA",236,6252,6488
"7226","Tyngsborough","Middlesex County","MA","Tyngsborough","2002","Tyngsborough town, MA",340,6154,6494
"7227","Tyngsborough","Middlesex County","MA","Tyngsborough","2003","Tyngsborough town, MA",385,6057,6442
"7228","Tyngsborough","Middlesex County","MA","Tyngsborough","2004","Tyngsborough town, MA",302,6065,6367
"7229","Tyngsborough","Middlesex County","MA","Tyngsborough","2005","Tyngsborough town, MA",282,6083,6365
"7230","Tyngsborough","Middlesex County","MA","Tyngsborough","2006","Tyngsborough town, MA",272,6186,6458
"7231","Tyngsborough","Middlesex County","MA","Tyngsborough","2007","Tyngsborough town, MA",278,6354,6632
"7232","Tyngsborough","Middlesex County","MA","Tyngsborough","2008","Tyngsborough town, MA",317,6421,6738
"7233","Tyngsborough","Middlesex County","MA","Tyngsborough","2009","Tyngsborough town, MA",510,6220,6730
"7234","Tyngsborough","Middlesex County","MA","Tyngsborough","2010","Tyngsborough town, MA",532,5901,6433
"7235","Tyngsborough","Middlesex County","MA","Tyngsborough","2011","Tyngsborough town, MA",463,5965,6428
"7236","Tyngsborough","Middlesex County","MA","Tyngsborough","2012","Tyngsborough town, MA",427,6031,6458
"7237","Tyringham","Berkshire County","MA","Tyringham","1990","Tyringham town, MA",6,206,212
"7238","Tyringham","Berkshire County","MA","Tyringham","1991","Tyringham town, MA",8,204,212
"7239","Tyringham","Berkshire County","MA","Tyringham","1992","Tyringham town, MA",8,196,204
"7240","Tyringham","Berkshire County","MA","Tyringham","1993","Tyringham town, MA",9,216,225
"7241","Tyringham","Berkshire County","MA","Tyringham","1994","Tyringham town, MA",6,205,211
"7242","Tyringham","Berkshire County","MA","Tyringham","1995","Tyringham town, MA",4,222,226
"7243","Tyringham","Berkshire County","MA","Tyringham","1996","Tyringham town, MA",7,228,235
"7244","Tyringham","Berkshire County","MA","Tyringham","1997","Tyringham town, MA",4,232,236
"7245","Tyringham","Berkshire County","MA","Tyringham","1998","Tyringham town, MA",3,229,232
"7246","Tyringham","Berkshire County","MA","Tyringham","1999","Tyringham town, MA",2,226,228
"7247","Tyringham","Berkshire County","MA","Tyringham","2000","Tyringham town, MA",2,237,239
"7248","Tyringham","Berkshire County","MA","Tyringham","2001","Tyringham town, MA",4,249,253
"7249","Tyringham","Berkshire County","MA","Tyringham","2002","Tyringham town, MA",4,261,265
"7250","Tyringham","Berkshire County","MA","Tyringham","2003","Tyringham town, MA",6,259,265
"7251","Tyringham","Berkshire County","MA","Tyringham","2004","Tyringham town, MA",6,255,261
"7252","Tyringham","Berkshire County","MA","Tyringham","2005","Tyringham town, MA",8,258,266
"7253","Tyringham","Berkshire County","MA","Tyringham","2006","Tyringham town, MA",6,257,263
"7254","Tyringham","Berkshire County","MA","Tyringham","2007","Tyringham town, MA",6,251,257
"7255","Tyringham","Berkshire County","MA","Tyringham","2008","Tyringham town, MA",9,248,257
"7256","Tyringham","Berkshire County","MA","Tyringham","2009","Tyringham town, MA",13,242,255
"7257","Tyringham","Berkshire County","MA","Tyringham","2010","Tyringham town, MA",13,234,247
"7258","Tyringham","Berkshire County","MA","Tyringham","2011","Tyringham town, MA",7,235,242
"7259","Tyringham","Berkshire County","MA","Tyringham","2012","Tyringham town, MA",6,233,239
"8019","Upton","Worcester County","MA","Upton","1990","Upton town, MA",166,2502,2668
"8020","Upton","Worcester County","MA","Upton","1991","Upton town, MA",203,2480,2683
"8021","Upton","Worcester County","MA","Upton","1992","Upton town, MA",237,2537,2774
"8022","Upton","Worcester County","MA","Upton","1993","Upton town, MA",170,2667,2837
"8023","Upton","Worcester County","MA","Upton","1994","Upton town, MA",160,2777,2937
"8024","Upton","Worcester County","MA","Upton","1995","Upton town, MA",134,2749,2883
"8025","Upton","Worcester County","MA","Upton","1996","Upton town, MA",124,2851,2975
"8026","Upton","Worcester County","MA","Upton","1997","Upton town, MA",107,2975,3082
"8027","Upton","Worcester County","MA","Upton","1998","Upton town, MA",81,3062,3143
"8028","Upton","Worcester County","MA","Upton","1999","Upton town, MA",75,3122,3197
"8029","Upton","Worcester County","MA","Upton","2000","Upton town, MA",66,2939,3005
"8030","Upton","Worcester County","MA","Upton","2001","Upton town, MA",106,3012,3118
"8031","Upton","Worcester County","MA","Upton","2002","Upton town, MA",202,3031,3233
"8032","Upton","Worcester County","MA","Upton","2003","Upton town, MA",213,3029,3242
"8033","Upton","Worcester County","MA","Upton","2004","Upton town, MA",170,3080,3250
"8034","Upton","Worcester County","MA","Upton","2005","Upton town, MA",154,3195,3349
"8035","Upton","Worcester County","MA","Upton","2006","Upton town, MA",151,3258,3409
"8036","Upton","Worcester County","MA","Upton","2007","Upton town, MA",149,3319,3468
"8037","Upton","Worcester County","MA","Upton","2008","Upton town, MA",181,3380,3561
"8038","Upton","Worcester County","MA","Upton","2009","Upton town, MA",279,3287,3566
"8039","Upton","Worcester County","MA","Upton","2010","Upton town, MA",286,3654,3940
"8040","Upton","Worcester County","MA","Upton","2011","Upton town, MA",233,3665,3898
"8041","Upton","Worcester County","MA","Upton","2012","Upton town, MA",224,3699,3923
"8042","Uxbridge","Worcester County","MA","Uxbridge","1990","Uxbridge town, MA",401,5213,5614
"8043","Uxbridge","Worcester County","MA","Uxbridge","1991","Uxbridge town, MA",550,5079,5629
"8044","Uxbridge","Worcester County","MA","Uxbridge","1992","Uxbridge town, MA",455,5209,5664
"8045","Uxbridge","Worcester County","MA","Uxbridge","1993","Uxbridge town, MA",416,5515,5931
"8046","Uxbridge","Worcester County","MA","Uxbridge","1994","Uxbridge town, MA",284,5695,5979
"8047","Uxbridge","Worcester County","MA","Uxbridge","1995","Uxbridge town, MA",276,5394,5670
"8048","Uxbridge","Worcester County","MA","Uxbridge","1996","Uxbridge town, MA",257,5521,5778
"8049","Uxbridge","Worcester County","MA","Uxbridge","1997","Uxbridge town, MA",220,5702,5922
"8050","Uxbridge","Worcester County","MA","Uxbridge","1998","Uxbridge town, MA",179,5860,6039
"8051","Uxbridge","Worcester County","MA","Uxbridge","1999","Uxbridge town, MA",165,5951,6116
"8052","Uxbridge","Worcester County","MA","Uxbridge","2000","Uxbridge town, MA",150,6083,6233
"8053","Uxbridge","Worcester County","MA","Uxbridge","2001","Uxbridge town, MA",244,6203,6447
"8054","Uxbridge","Worcester County","MA","Uxbridge","2002","Uxbridge town, MA",336,6234,6570
"8055","Uxbridge","Worcester County","MA","Uxbridge","2003","Uxbridge town, MA",374,6322,6696
"8056","Uxbridge","Worcester County","MA","Uxbridge","2004","Uxbridge town, MA",351,6405,6756
"8057","Uxbridge","Worcester County","MA","Uxbridge","2005","Uxbridge town, MA",314,6473,6787
"8058","Uxbridge","Worcester County","MA","Uxbridge","2006","Uxbridge town, MA",327,6618,6945
"8059","Uxbridge","Worcester County","MA","Uxbridge","2007","Uxbridge town, MA",329,6677,7006
"8060","Uxbridge","Worcester County","MA","Uxbridge","2008","Uxbridge town, MA",418,6574,6992
"8061","Uxbridge","Worcester County","MA","Uxbridge","2009","Uxbridge town, MA",630,6411,7041
"8062","Uxbridge","Worcester County","MA","Uxbridge","2010","Uxbridge town, MA",599,6719,7318
"8063","Uxbridge","Worcester County","MA","Uxbridge","2011","Uxbridge town, MA",538,6779,7317
"8064","Uxbridge","Worcester County","MA","Uxbridge","2012","Uxbridge town, MA",520,6777,7297
"8065","Wakefield","Middlesex County","MA","Wakefield","1990","Wakefield town, MA",761,13135,13896
"8066","Wakefield","Middlesex County","MA","Wakefield","1991","Wakefield town, MA",1005,12784,13789
"8067","Wakefield","Middlesex County","MA","Wakefield","1992","Wakefield town, MA",1048,12735,13783
"8068","Wakefield","Middlesex County","MA","Wakefield","1993","Wakefield town, MA",813,12906,13719
"8069","Wakefield","Middlesex County","MA","Wakefield","1994","Wakefield town, MA",699,13054,13753
"8070","Wakefield","Middlesex County","MA","Wakefield","1995","Wakefield town, MA",592,12906,13498
"8071","Wakefield","Middlesex County","MA","Wakefield","1996","Wakefield town, MA",464,13173,13637
"8072","Wakefield","Middlesex County","MA","Wakefield","1997","Wakefield town, MA",418,13486,13904
"8073","Wakefield","Middlesex County","MA","Wakefield","1998","Wakefield town, MA",364,13674,14038
"8074","Wakefield","Middlesex County","MA","Wakefield","1999","Wakefield town, MA",391,13833,14224
"8075","Wakefield","Middlesex County","MA","Wakefield","2000","Wakefield town, MA",310,13649,13959
"8076","Wakefield","Middlesex County","MA","Wakefield","2001","Wakefield town, MA",472,13586,14058
"8077","Wakefield","Middlesex County","MA","Wakefield","2002","Wakefield town, MA",682,13298,13980
"8078","Wakefield","Middlesex County","MA","Wakefield","2003","Wakefield town, MA",728,13090,13818
"8079","Wakefield","Middlesex County","MA","Wakefield","2004","Wakefield town, MA",636,13010,13646
"8080","Wakefield","Middlesex County","MA","Wakefield","2005","Wakefield town, MA",596,13155,13751
"8081","Wakefield","Middlesex County","MA","Wakefield","2006","Wakefield town, MA",592,12972,13564
"8082","Wakefield","Middlesex County","MA","Wakefield","2007","Wakefield town, MA",561,13101,13662
"8083","Wakefield","Middlesex County","MA","Wakefield","2008","Wakefield town, MA",681,13153,13834
"8084","Wakefield","Middlesex County","MA","Wakefield","2009","Wakefield town, MA",1041,12870,13911
"8085","Wakefield","Middlesex County","MA","Wakefield","2010","Wakefield town, MA",1005,12926,13931
"8086","Wakefield","Middlesex County","MA","Wakefield","2011","Wakefield town, MA",831,13117,13948
"8087","Wakefield","Middlesex County","MA","Wakefield","2012","Wakefield town, MA",738,13260,13998
"8088","Wales","Hampden County","MA","Wales","1990","Wales town, MA",62,791,853
"8089","Wales","Hampden County","MA","Wales","1991","Wales town, MA",87,788,875
"8090","Wales","Hampden County","MA","Wales","1992","Wales town, MA",80,772,852
"8091","Wales","Hampden County","MA","Wales","1993","Wales town, MA",95,800,895
"8092","Wales","Hampden County","MA","Wales","1994","Wales town, MA",64,788,852
"8093","Wales","Hampden County","MA","Wales","1995","Wales town, MA",49,857,906
"8094","Wales","Hampden County","MA","Wales","1996","Wales town, MA",61,901,962
"8095","Wales","Hampden County","MA","Wales","1997","Wales town, MA",58,894,952
"8096","Wales","Hampden County","MA","Wales","1998","Wales town, MA",38,849,887
"8097","Wales","Hampden County","MA","Wales","1999","Wales town, MA",36,823,859
"8098","Wales","Hampden County","MA","Wales","2000","Wales town, MA",28,976,1004
"8099","Wales","Hampden County","MA","Wales","2001","Wales town, MA",41,983,1024
"8100","Wales","Hampden County","MA","Wales","2002","Wales town, MA",52,983,1035
"8101","Wales","Hampden County","MA","Wales","2003","Wales town, MA",64,981,1045
"8102","Wales","Hampden County","MA","Wales","2004","Wales town, MA",63,988,1051
"8103","Wales","Hampden County","MA","Wales","2005","Wales town, MA",48,1005,1053
"8104","Wales","Hampden County","MA","Wales","2006","Wales town, MA",59,1022,1081
"8105","Wales","Hampden County","MA","Wales","2007","Wales town, MA",58,1027,1085
"8106","Wales","Hampden County","MA","Wales","2008","Wales town, MA",65,1039,1104
"8107","Wales","Hampden County","MA","Wales","2009","Wales town, MA",94,1002,1096
"8108","Wales","Hampden County","MA","Wales","2010","Wales town, MA",95,971,1066
"8109","Wales","Hampden County","MA","Wales","2011","Wales town, MA",88,962,1050
"8110","Wales","Hampden County","MA","Wales","2012","Wales town, MA",79,962,1041
"8111","Walpole","Norfolk County","MA","Walpole","1990","Walpole town, MA",570,10765,11335
"8112","Walpole","Norfolk County","MA","Walpole","1991","Walpole town, MA",862,10522,11384
"8113","Walpole","Norfolk County","MA","Walpole","1992","Walpole town, MA",815,10602,11417
"8114","Walpole","Norfolk County","MA","Walpole","1993","Walpole town, MA",676,10939,11615
"8115","Walpole","Norfolk County","MA","Walpole","1994","Walpole town, MA",560,11372,11932
"8116","Walpole","Norfolk County","MA","Walpole","1995","Walpole town, MA",491,11572,12063
"8117","Walpole","Norfolk County","MA","Walpole","1996","Walpole town, MA",430,11873,12303
"8118","Walpole","Norfolk County","MA","Walpole","1997","Walpole town, MA",380,12264,12644
"8119","Walpole","Norfolk County","MA","Walpole","1998","Walpole town, MA",313,12599,12912
"8120","Walpole","Norfolk County","MA","Walpole","1999","Walpole town, MA",291,12754,13045
"8121","Walpole","Norfolk County","MA","Walpole","2000","Walpole town, MA",282,11938,12220
"8122","Walpole","Norfolk County","MA","Walpole","2001","Walpole town, MA",392,11963,12355
"8123","Walpole","Norfolk County","MA","Walpole","2002","Walpole town, MA",531,11817,12348
"8124","Walpole","Norfolk County","MA","Walpole","2003","Walpole town, MA",621,11671,12292
"8125","Walpole","Norfolk County","MA","Walpole","2004","Walpole town, MA",518,11671,12189
"8126","Walpole","Norfolk County","MA","Walpole","2005","Walpole town, MA",489,11744,12233
"8127","Walpole","Norfolk County","MA","Walpole","2006","Walpole town, MA",505,11557,12062
"8128","Walpole","Norfolk County","MA","Walpole","2007","Walpole town, MA",484,11723,12207
"8129","Walpole","Norfolk County","MA","Walpole","2008","Walpole town, MA",553,11744,12297
"8130","Walpole","Norfolk County","MA","Walpole","2009","Walpole town, MA",864,11370,12234
"8131","Walpole","Norfolk County","MA","Walpole","2010","Walpole town, MA",901,11846,12747
"8132","Walpole","Norfolk County","MA","Walpole","2011","Walpole town, MA",762,11978,12740
"8133","Walpole","Norfolk County","MA","Walpole","2012","Walpole town, MA",685,12109,12794
"8134","Waltham","Middlesex County","MA","Waltham","1990","Waltham city, MA",1858,32209,34067
"8135","Waltham","Middlesex County","MA","Waltham","1991","Waltham city, MA",2393,30522,32915
"8136","Waltham","Middlesex County","MA","Waltham","1992","Waltham city, MA",2568,29584,32152
"8137","Waltham","Middlesex County","MA","Waltham","1993","Waltham city, MA",2176,29613,31789
"8138","Waltham","Middlesex County","MA","Waltham","1994","Waltham city, MA",1876,29899,31775
"8139","Waltham","Middlesex County","MA","Waltham","1995","Waltham city, MA",1512,31429,32941
"8140","Waltham","Middlesex County","MA","Waltham","1996","Waltham city, MA",1260,32042,33302
"8141","Waltham","Middlesex County","MA","Waltham","1997","Waltham city, MA",1088,33133,34221
"8142","Waltham","Middlesex County","MA","Waltham","1998","Waltham city, MA",890,33844,34734
"8143","Waltham","Middlesex County","MA","Waltham","1999","Waltham city, MA",867,34249,35116
"8144","Waltham","Middlesex County","MA","Waltham","2000","Waltham city, MA",818,34367,35185
"8145","Waltham","Middlesex County","MA","Waltham","2001","Waltham city, MA",1189,34157,35346
"8146","Waltham","Middlesex County","MA","Waltham","2002","Waltham city, MA",1777,33408,35185
"8147","Waltham","Middlesex County","MA","Waltham","2003","Waltham city, MA",1889,32830,34719
"8148","Waltham","Middlesex County","MA","Waltham","2004","Waltham city, MA",1582,33098,34680
"8149","Waltham","Middlesex County","MA","Waltham","2005","Waltham city, MA",1465,33627,35092
"8150","Waltham","Middlesex County","MA","Waltham","2006","Waltham city, MA",1361,33986,35347
"8151","Waltham","Middlesex County","MA","Waltham","2007","Waltham city, MA",1283,33907,35190
"8152","Waltham","Middlesex County","MA","Waltham","2008","Waltham city, MA",1539,33917,35456
"8153","Waltham","Middlesex County","MA","Waltham","2009","Waltham city, MA",2323,32655,34978
"8154","Waltham","Middlesex County","MA","Waltham","2010","Waltham city, MA",2289,33160,35449
"8155","Waltham","Middlesex County","MA","Waltham","2011","Waltham city, MA",1965,33604,35569
"8156","Waltham","Middlesex County","MA","Waltham","2012","Waltham city, MA",1801,33972,35773
"8157","Ware","Hampshire County","MA","Ware","1990","Ware town, MA",365,4605,4970
"8158","Ware","Hampshire County","MA","Ware","1991","Ware town, MA",523,4457,4980
"8159","Ware","Hampshire County","MA","Ware","1992","Ware town, MA",448,4434,4882
"8160","Ware","Hampshire County","MA","Ware","1993","Ware town, MA",409,4395,4804
"8161","Ware","Hampshire County","MA","Ware","1994","Ware town, MA",337,4428,4765
"8162","Ware","Hampshire County","MA","Ware","1995","Ware town, MA",268,4455,4723
"8163","Ware","Hampshire County","MA","Ware","1996","Ware town, MA",236,4528,4764
"8164","Ware","Hampshire County","MA","Ware","1997","Ware town, MA",193,4618,4811
"8165","Ware","Hampshire County","MA","Ware","1998","Ware town, MA",233,4626,4859
"8166","Ware","Hampshire County","MA","Ware","1999","Ware town, MA",210,4652,4862
"8167","Ware","Hampshire County","MA","Ware","2000","Ware town, MA",150,5004,5154
"8168","Ware","Hampshire County","MA","Ware","2001","Ware town, MA",210,5006,5216
"8169","Ware","Hampshire County","MA","Ware","2002","Ware town, MA",263,4984,5247
"8170","Ware","Hampshire County","MA","Ware","2003","Ware town, MA",324,4969,5293
"8171","Ware","Hampshire County","MA","Ware","2004","Ware town, MA",316,5055,5371
"8172","Ware","Hampshire County","MA","Ware","2005","Ware town, MA",291,5072,5363
"8173","Ware","Hampshire County","MA","Ware","2006","Ware town, MA",308,5095,5403
"8174","Ware","Hampshire County","MA","Ware","2007","Ware town, MA",315,5084,5399
"8175","Ware","Hampshire County","MA","Ware","2008","Ware town, MA",344,4984,5328
"8176","Ware","Hampshire County","MA","Ware","2009","Ware town, MA",497,4763,5260
"8177","Ware","Hampshire County","MA","Ware","2010","Ware town, MA",503,4792,5295
"8178","Ware","Hampshire County","MA","Ware","2011","Ware town, MA",467,4733,5200
"8179","Ware","Hampshire County","MA","Ware","2012","Ware town, MA",430,4735,5165
"8180","Wareham","Plymouth County","MA","Wareham","1990","Wareham town, MA",865,8268,9133
"8181","Wareham","Plymouth County","MA","Wareham","1991","Wareham town, MA",1147,8058,9205
"8182","Wareham","Plymouth County","MA","Wareham","1992","Wareham town, MA",1157,8043,9200
"8183","Wareham","Plymouth County","MA","Wareham","1993","Wareham town, MA",1018,8195,9213
"8184","Wareham","Plymouth County","MA","Wareham","1994","Wareham town, MA",839,8463,9302
"8185","Wareham","Plymouth County","MA","Wareham","1995","Wareham town, MA",748,8270,9018
"8186","Wareham","Plymouth County","MA","Wareham","1996","Wareham town, MA",623,8437,9060
"8187","Wareham","Plymouth County","MA","Wareham","1997","Wareham town, MA",598,8669,9267
"8188","Wareham","Plymouth County","MA","Wareham","1998","Wareham town, MA",481,8825,9306
"8189","Wareham","Plymouth County","MA","Wareham","1999","Wareham town, MA",432,8959,9391
"8190","Wareham","Plymouth County","MA","Wareham","2000","Wareham town, MA",373,10508,10881
"8191","Wareham","Plymouth County","MA","Wareham","2001","Wareham town, MA",457,10652,11109
"8192","Wareham","Plymouth County","MA","Wareham","2002","Wareham town, MA",619,10886,11505
"8193","Wareham","Plymouth County","MA","Wareham","2003","Wareham town, MA",714,11142,11856
"8194","Wareham","Plymouth County","MA","Wareham","2004","Wareham town, MA",686,11361,12047
"8195","Wareham","Plymouth County","MA","Wareham","2005","Wareham town, MA",661,11447,12108
"8196","Wareham","Plymouth County","MA","Wareham","2006","Wareham town, MA",656,11572,12228
"8197","Wareham","Plymouth County","MA","Wareham","2007","Wareham town, MA",664,11548,12212
"8198","Wareham","Plymouth County","MA","Wareham","2008","Wareham town, MA",818,11568,12386
"8199","Wareham","Plymouth County","MA","Wareham","2009","Wareham town, MA",1188,11316,12504
"8200","Wareham","Plymouth County","MA","Wareham","2010","Wareham town, MA",1195,11730,12925
"8201","Wareham","Plymouth County","MA","Wareham","2011","Wareham town, MA",1082,11781,12863
"8202","Wareham","Plymouth County","MA","Wareham","2012","Wareham town, MA",1017,11979,12996
"8203","Warren","Worcester County","MA","Warren","1990","Warren town, MA",142,2138,2280
"8204","Warren","Worcester County","MA","Warren","1991","Warren town, MA",194,2045,2239
"8205","Warren","Worcester County","MA","Warren","1992","Warren town, MA",210,1965,2175
"8206","Warren","Worcester County","MA","Warren","1993","Warren town, MA",203,1959,2162
"8207","Warren","Worcester County","MA","Warren","1994","Warren town, MA",182,1955,2137
"8208","Warren","Worcester County","MA","Warren","1995","Warren town, MA",131,2364,2495
"8209","Warren","Worcester County","MA","Warren","1996","Warren town, MA",136,2493,2629
"8210","Warren","Worcester County","MA","Warren","1997","Warren town, MA",119,2491,2610
"8211","Warren","Worcester County","MA","Warren","1998","Warren town, MA",115,2411,2526
"8212","Warren","Worcester County","MA","Warren","1999","Warren town, MA",109,2352,2461
"8213","Warren","Worcester County","MA","Warren","2000","Warren town, MA",71,2270,2341
"8214","Warren","Worcester County","MA","Warren","2001","Warren town, MA",91,2257,2348
"8215","Warren","Worcester County","MA","Warren","2002","Warren town, MA",131,2256,2387
"8216","Warren","Worcester County","MA","Warren","2003","Warren town, MA",163,2265,2428
"8217","Warren","Worcester County","MA","Warren","2004","Warren town, MA",167,2287,2454
"8218","Warren","Worcester County","MA","Warren","2005","Warren town, MA",144,2309,2453
"8219","Warren","Worcester County","MA","Warren","2006","Warren town, MA",178,2401,2579
"8220","Warren","Worcester County","MA","Warren","2007","Warren town, MA",171,2411,2582
"8221","Warren","Worcester County","MA","Warren","2008","Warren town, MA",166,2368,2534
"8222","Warren","Worcester County","MA","Warren","2009","Warren town, MA",234,2308,2542
"8223","Warren","Worcester County","MA","Warren","2010","Warren town, MA",258,2250,2508
"8224","Warren","Worcester County","MA","Warren","2011","Warren town, MA",205,2269,2474
"8225","Warren","Worcester County","MA","Warren","2012","Warren town, MA",197,2269,2466
"8226","Warwick","Franklin County","MA","Warwick","1990","Warwick town, MA",19,333,352
"8227","Warwick","Franklin County","MA","Warwick","1991","Warwick town, MA",31,311,342
"8228","Warwick","Franklin County","MA","Warwick","1992","Warwick town, MA",32,297,329
"8229","Warwick","Franklin County","MA","Warwick","1993","Warwick town, MA",27,275,302
"8230","Warwick","Franklin County","MA","Warwick","1994","Warwick town, MA",23,269,292
"8231","Warwick","Franklin County","MA","Warwick","1995","Warwick town, MA",18,320,338
"8232","Warwick","Franklin County","MA","Warwick","1996","Warwick town, MA",13,318,331
"8233","Warwick","Franklin County","MA","Warwick","1997","Warwick town, MA",15,322,337
"8234","Warwick","Franklin County","MA","Warwick","1998","Warwick town, MA",14,311,325
"8235","Warwick","Franklin County","MA","Warwick","1999","Warwick town, MA",19,311,330
"8236","Warwick","Franklin County","MA","Warwick","2000","Warwick town, MA",14,363,377
"8237","Warwick","Franklin County","MA","Warwick","2001","Warwick town, MA",12,356,368
"8238","Warwick","Franklin County","MA","Warwick","2002","Warwick town, MA",18,357,375
"8239","Warwick","Franklin County","MA","Warwick","2003","Warwick town, MA",26,350,376
"8240","Warwick","Franklin County","MA","Warwick","2004","Warwick town, MA",24,345,369
"8241","Warwick","Franklin County","MA","Warwick","2005","Warwick town, MA",25,343,368
"8242","Warwick","Franklin County","MA","Warwick","2006","Warwick town, MA",26,342,368
"8243","Warwick","Franklin County","MA","Warwick","2007","Warwick town, MA",15,334,349
"8244","Warwick","Franklin County","MA","Warwick","2008","Warwick town, MA",16,337,353
"8245","Warwick","Franklin County","MA","Warwick","2009","Warwick town, MA",30,321,351
"8246","Warwick","Franklin County","MA","Warwick","2010","Warwick town, MA",35,333,368
"8247","Warwick","Franklin County","MA","Warwick","2011","Warwick town, MA",27,332,359
"8248","Warwick","Franklin County","MA","Warwick","2012","Warwick town, MA",24,334,358
"8249","Washington","Berkshire County","MA","Washington","1990","Washington town, MA",14,280,294
"8250","Washington","Berkshire County","MA","Washington","1991","Washington town, MA",27,271,298
"8251","Washington","Berkshire County","MA","Washington","1992","Washington town, MA",28,284,312
"8252","Washington","Berkshire County","MA","Washington","1993","Washington town, MA",14,301,315
"8253","Washington","Berkshire County","MA","Washington","1994","Washington town, MA",15,315,330
"8254","Washington","Berkshire County","MA","Washington","1995","Washington town, MA",15,334,349
"8255","Washington","Berkshire County","MA","Washington","1996","Washington town, MA",14,324,338
"8256","Washington","Berkshire County","MA","Washington","1997","Washington town, MA",14,326,340
"8257","Washington","Berkshire County","MA","Washington","1998","Washington town, MA",11,339,350
"8258","Washington","Berkshire County","MA","Washington","1999","Washington town, MA",15,367,382
"8259","Washington","Berkshire County","MA","Washington","2000","Washington town, MA",11,300,311
"8260","Washington","Berkshire County","MA","Washington","2001","Washington town, MA",12,299,311
"8261","Washington","Berkshire County","MA","Washington","2002","Washington town, MA",12,304,316
"8262","Washington","Berkshire County","MA","Washington","2003","Washington town, MA",18,303,321
"8263","Washington","Berkshire County","MA","Washington","2004","Washington town, MA",13,305,318
"8264","Washington","Berkshire County","MA","Washington","2005","Washington town, MA",13,312,325
"8265","Washington","Berkshire County","MA","Washington","2006","Washington town, MA",12,320,332
"8266","Washington","Berkshire County","MA","Washington","2007","Washington town, MA",15,321,336
"8267","Washington","Berkshire County","MA","Washington","2008","Washington town, MA",16,315,331
"8268","Washington","Berkshire County","MA","Washington","2009","Washington town, MA",23,306,329
"8269","Washington","Berkshire County","MA","Washington","2010","Washington town, MA",30,294,324
"8270","Washington","Berkshire County","MA","Washington","2011","Washington town, MA",20,296,316
"8271","Washington","Berkshire County","MA","Washington","2012","Washington town, MA",16,295,311
"8272","Watertown","Middlesex County","MA","Watertown","1990","Watertown Town city, MA",856,19591,20447
"8273","Watertown","Middlesex County","MA","Watertown","1991","Watertown Town city, MA",1100,18723,19823
"8274","Watertown","Middlesex County","MA","Watertown","1992","Watertown Town city, MA",1188,18216,19404
"8275","Watertown","Middlesex County","MA","Watertown","1993","Watertown Town city, MA",1057,18141,19198
"8276","Watertown","Middlesex County","MA","Watertown","1994","Watertown Town city, MA",876,18176,19052
"8277","Watertown","Middlesex County","MA","Watertown","1995","Watertown Town city, MA",762,18967,19729
"8278","Watertown","Middlesex County","MA","Watertown","1996","Watertown Town city, MA",644,19278,19922
"8279","Watertown","Middlesex County","MA","Watertown","1997","Watertown Town city, MA",505,19733,20238
"8280","Watertown","Middlesex County","MA","Watertown","1998","Watertown Town city, MA",425,19910,20335
"8281","Watertown","Middlesex County","MA","Watertown","1999","Watertown Town city, MA",446,19976,20422
"8282","Watertown","Middlesex County","MA","Watertown","2000","Watertown Town city, MA",414,19938,20352
"8283","Watertown","Middlesex County","MA","Watertown","2001","Watertown Town city, MA",661,19810,20471
"8284","Watertown","Middlesex County","MA","Watertown","2002","Watertown Town city, MA",959,19355,20314
"8285","Watertown","Middlesex County","MA","Watertown","2003","Watertown Town city, MA",969,19116,20085
"8286","Watertown","Middlesex County","MA","Watertown","2004","Watertown Town city, MA",770,18982,19752
"8287","Watertown","Middlesex County","MA","Watertown","2005","Watertown Town city, MA",700,19005,19705
"8288","Watertown","Middlesex County","MA","Watertown","2006","Watertown Town city, MA",699,19050,19749
"8289","Watertown","Middlesex County","MA","Watertown","2007","Watertown Town city, MA",640,19167,19807
"8290","Watertown","Middlesex County","MA","Watertown","2008","Watertown Town city, MA",751,19132,19883
"8291","Watertown","Middlesex County","MA","Watertown","2009","Watertown Town city, MA",1221,18593,19814
"8292","Watertown","Middlesex County","MA","Watertown","2010","Watertown Town city, MA",1205,18187,19392
"8293","Watertown","Middlesex County","MA","Watertown","2011","Watertown Town city, MA",1006,18456,19462
"8294","Watertown","Middlesex County","MA","Watertown","2012","Watertown Town city, MA",918,18658,19576
"8295","Wayland","Middlesex County","MA","Wayland","1990","Wayland town, MA",228,6318,6546
"8296","Wayland","Middlesex County","MA","Wayland","1991","Wayland town, MA",278,6168,6446
"8297","Wayland","Middlesex County","MA","Wayland","1992","Wayland town, MA",300,6220,6520
"8298","Wayland","Middlesex County","MA","Wayland","1993","Wayland town, MA",273,6308,6581
"8299","Wayland","Middlesex County","MA","Wayland","1994","Wayland town, MA",221,6443,6664
"8300","Wayland","Middlesex County","MA","Wayland","1995","Wayland town, MA",183,6287,6470
"8301","Wayland","Middlesex County","MA","Wayland","1996","Wayland town, MA",138,6444,6582
"8302","Wayland","Middlesex County","MA","Wayland","1997","Wayland town, MA",125,6682,6807
"8303","Wayland","Middlesex County","MA","Wayland","1998","Wayland town, MA",100,6800,6900
"8304","Wayland","Middlesex County","MA","Wayland","1999","Wayland town, MA",118,6899,7017
"8305","Wayland","Middlesex County","MA","Wayland","2000","Wayland town, MA",129,6721,6850
"8306","Wayland","Middlesex County","MA","Wayland","2001","Wayland town, MA",197,6728,6925
"8307","Wayland","Middlesex County","MA","Wayland","2002","Wayland town, MA",297,6601,6898
"8308","Wayland","Middlesex County","MA","Wayland","2003","Wayland town, MA",293,6483,6776
"8309","Wayland","Middlesex County","MA","Wayland","2004","Wayland town, MA",248,6442,6690
"8310","Wayland","Middlesex County","MA","Wayland","2005","Wayland town, MA",210,6480,6690
"8311","Wayland","Middlesex County","MA","Wayland","2006","Wayland town, MA",212,6453,6665
"8312","Wayland","Middlesex County","MA","Wayland","2007","Wayland town, MA",197,6523,6720
"8313","Wayland","Middlesex County","MA","Wayland","2008","Wayland town, MA",246,6563,6809
"8314","Wayland","Middlesex County","MA","Wayland","2009","Wayland town, MA",389,6421,6810
"8315","Wayland","Middlesex County","MA","Wayland","2010","Wayland town, MA",392,6272,6664
"8316","Wayland","Middlesex County","MA","Wayland","2011","Wayland town, MA",325,6365,6690
"8317","Wayland","Middlesex County","MA","Wayland","2012","Wayland town, MA",303,6435,6738
"8318","Webster","Worcester County","MA","Webster","1990","Webster town, MA",689,7716,8405
"8319","Webster","Worcester County","MA","Webster","1991","Webster town, MA",848,7448,8296
"8320","Webster","Worcester County","MA","Webster","1992","Webster town, MA",894,7464,8358
"8321","Webster","Worcester County","MA","Webster","1993","Webster town, MA",697,7598,8295
"8322","Webster","Worcester County","MA","Webster","1994","Webster town, MA",505,7710,8215
"8323","Webster","Worcester County","MA","Webster","1995","Webster town, MA",506,7634,8140
"8324","Webster","Worcester County","MA","Webster","1996","Webster town, MA",398,7727,8125
"8325","Webster","Worcester County","MA","Webster","1997","Webster town, MA",367,7895,8262
"8326","Webster","Worcester County","MA","Webster","1998","Webster town, MA",383,8228,8611
"8327","Webster","Worcester County","MA","Webster","1999","Webster town, MA",336,8167,8503
"8328","Webster","Worcester County","MA","Webster","2000","Webster town, MA",277,7973,8250
"8329","Webster","Worcester County","MA","Webster","2001","Webster town, MA",361,7969,8330
"8330","Webster","Worcester County","MA","Webster","2002","Webster town, MA",508,7934,8442
"8331","Webster","Worcester County","MA","Webster","2003","Webster town, MA",622,7932,8554
"8332","Webster","Worcester County","MA","Webster","2004","Webster town, MA",543,7910,8453
"8333","Webster","Worcester County","MA","Webster","2005","Webster town, MA",486,7872,8358
"8334","Webster","Worcester County","MA","Webster","2006","Webster town, MA",513,7910,8423
"8335","Webster","Worcester County","MA","Webster","2007","Webster town, MA",502,7914,8416
"8336","Webster","Worcester County","MA","Webster","2008","Webster town, MA",589,7745,8334
"8337","Webster","Worcester County","MA","Webster","2009","Webster town, MA",898,7520,8418
"8338","Webster","Worcester County","MA","Webster","2010","Webster town, MA",851,7497,8348
"8339","Webster","Worcester County","MA","Webster","2011","Webster town, MA",773,7563,8336
"8340","Webster","Worcester County","MA","Webster","2012","Webster town, MA",717,7561,8278
"8341","Wellesley","Norfolk County","MA","Wellesley","1990","Wellesley town, MA",353,13337,13690
"8342","Wellesley","Norfolk County","MA","Wellesley","1991","Wellesley town, MA",452,12811,13263
"8343","Wellesley","Norfolk County","MA","Wellesley","1992","Wellesley town, MA",484,12867,13351
"8344","Wellesley","Norfolk County","MA","Wellesley","1993","Wellesley town, MA",412,13061,13473
"8345","Wellesley","Norfolk County","MA","Wellesley","1994","Wellesley town, MA",369,13263,13632
"8346","Wellesley","Norfolk County","MA","Wellesley","1995","Wellesley town, MA",326,13273,13599
"8347","Wellesley","Norfolk County","MA","Wellesley","1996","Wellesley town, MA",219,13496,13715
"8348","Wellesley","Norfolk County","MA","Wellesley","1997","Wellesley town, MA",202,13806,14008
"8349","Wellesley","Norfolk County","MA","Wellesley","1998","Wellesley town, MA",199,13944,14143
"8350","Wellesley","Norfolk County","MA","Wellesley","1999","Wellesley town, MA",191,14000,14191
"8351","Wellesley","Norfolk County","MA","Wellesley","2000","Wellesley town, MA",235,13111,13346
"8352","Wellesley","Norfolk County","MA","Wellesley","2001","Wellesley town, MA",340,13050,13390
"8353","Wellesley","Norfolk County","MA","Wellesley","2002","Wellesley town, MA",499,12817,13316
"8354","Wellesley","Norfolk County","MA","Wellesley","2003","Wellesley town, MA",494,12597,13091
"8355","Wellesley","Norfolk County","MA","Wellesley","2004","Wellesley town, MA",453,12581,13034
"8356","Wellesley","Norfolk County","MA","Wellesley","2005","Wellesley town, MA",424,12723,13147
"8357","Wellesley","Norfolk County","MA","Wellesley","2006","Wellesley town, MA",390,12567,12957
"8358","Wellesley","Norfolk County","MA","Wellesley","2007","Wellesley town, MA",395,12718,13113
"8359","Wellesley","Norfolk County","MA","Wellesley","2008","Wellesley town, MA",482,12740,13222
"8360","Wellesley","Norfolk County","MA","Wellesley","2009","Wellesley town, MA",742,12330,13072
"8361","Wellesley","Norfolk County","MA","Wellesley","2010","Wellesley town, MA",705,12782,13487
"8362","Wellesley","Norfolk County","MA","Wellesley","2011","Wellesley town, MA",598,12915,13513
"8363","Wellesley","Norfolk County","MA","Wellesley","2012","Wellesley town, MA",565,13057,13622
"8364","Wellfleet","Barnstable County","MA","Wellfleet","1990","Wellfleet town, MA",157,1663,1820
"8365","Wellfleet","Barnstable County","MA","Wellfleet","1991","Wellfleet town, MA",212,1672,1884
"8366","Wellfleet","Barnstable County","MA","Wellfleet","1992","Wellfleet town, MA",251,1695,1946
"8367","Wellfleet","Barnstable County","MA","Wellfleet","1993","Wellfleet town, MA",231,1782,2013
"8368","Wellfleet","Barnstable County","MA","Wellfleet","1994","Wellfleet town, MA",239,1799,2038
"8369","Wellfleet","Barnstable County","MA","Wellfleet","1995","Wellfleet town, MA",239,1835,2074
"8370","Wellfleet","Barnstable County","MA","Wellfleet","1996","Wellfleet town, MA",156,1844,2000
"8371","Wellfleet","Barnstable County","MA","Wellfleet","1997","Wellfleet town, MA",152,1845,1997
"8372","Wellfleet","Barnstable County","MA","Wellfleet","1998","Wellfleet town, MA",154,1872,2026
"8373","Wellfleet","Barnstable County","MA","Wellfleet","1999","Wellfleet town, MA",133,1915,2048
"8374","Wellfleet","Barnstable County","MA","Wellfleet","2000","Wellfleet town, MA",74,1459,1533
"8375","Wellfleet","Barnstable County","MA","Wellfleet","2001","Wellfleet town, MA",81,1476,1557
"8376","Wellfleet","Barnstable County","MA","Wellfleet","2002","Wellfleet town, MA",99,1506,1605
"8377","Wellfleet","Barnstable County","MA","Wellfleet","2003","Wellfleet town, MA",110,1540,1650
"8378","Wellfleet","Barnstable County","MA","Wellfleet","2004","Wellfleet town, MA",103,1558,1661
"8379","Wellfleet","Barnstable County","MA","Wellfleet","2005","Wellfleet town, MA",108,1557,1665
"8380","Wellfleet","Barnstable County","MA","Wellfleet","2006","Wellfleet town, MA",114,1554,1668
"8381","Wellfleet","Barnstable County","MA","Wellfleet","2007","Wellfleet town, MA",103,1540,1643
"8382","Wellfleet","Barnstable County","MA","Wellfleet","2008","Wellfleet town, MA",129,1524,1653
"8383","Wellfleet","Barnstable County","MA","Wellfleet","2009","Wellfleet town, MA",199,1545,1744
"8384","Wellfleet","Barnstable County","MA","Wellfleet","2010","Wellfleet town, MA",199,1517,1716
"8385","Wellfleet","Barnstable County","MA","Wellfleet","2011","Wellfleet town, MA",206,1515,1721
"8386","Wellfleet","Barnstable County","MA","Wellfleet","2012","Wellfleet town, MA",184,1540,1724
"8387","Wendell","Franklin County","MA","Wendell","1990","Wendell town, MA",31,489,520
"8388","Wendell","Franklin County","MA","Wendell","1991","Wendell town, MA",50,497,547
"8389","Wendell","Franklin County","MA","Wendell","1992","Wendell town, MA",51,477,528
"8390","Wendell","Franklin County","MA","Wendell","1993","Wendell town, MA",37,479,516
"8391","Wendell","Franklin County","MA","Wendell","1994","Wendell town, MA",35,495,530
"8392","Wendell","Franklin County","MA","Wendell","1995","Wendell town, MA",20,520,540
"8393","Wendell","Franklin County","MA","Wendell","1996","Wendell town, MA",20,523,543
"8394","Wendell","Franklin County","MA","Wendell","1997","Wendell town, MA",19,536,555
"8395","Wendell","Franklin County","MA","Wendell","1998","Wendell town, MA",22,549,571
"8396","Wendell","Franklin County","MA","Wendell","1999","Wendell town, MA",15,563,578
"8397","Wendell","Franklin County","MA","Wendell","2000","Wendell town, MA",12,601,613
"8398","Wendell","Franklin County","MA","Wendell","2001","Wendell town, MA",20,592,612
"8399","Wendell","Franklin County","MA","Wendell","2002","Wendell town, MA",21,598,619
"8400","Wendell","Franklin County","MA","Wendell","2003","Wendell town, MA",22,592,614
"8401","Wendell","Franklin County","MA","Wendell","2004","Wendell town, MA",27,587,614
"8402","Wendell","Franklin County","MA","Wendell","2005","Wendell town, MA",18,586,604
"8403","Wendell","Franklin County","MA","Wendell","2006","Wendell town, MA",26,585,611
"8404","Wendell","Franklin County","MA","Wendell","2007","Wendell town, MA",20,561,581
"8405","Wendell","Franklin County","MA","Wendell","2008","Wendell town, MA",27,565,592
"8406","Wendell","Franklin County","MA","Wendell","2009","Wendell town, MA",40,542,582
"8407","Wendell","Franklin County","MA","Wendell","2010","Wendell town, MA",40,455,495
"8408","Wendell","Franklin County","MA","Wendell","2011","Wendell town, MA",35,454,489
"8409","Wendell","Franklin County","MA","Wendell","2012","Wendell town, MA",30,455,485
"8410","Wenham","Essex County","MA","Wenham","1990","Wenham town, MA",70,2225,2295
"8411","Wenham","Essex County","MA","Wenham","1991","Wenham town, MA",92,2151,2243
"8412","Wenham","Essex County","MA","Wenham","1992","Wenham town, MA",78,2183,2261
"8413","Wenham","Essex County","MA","Wenham","1993","Wenham town, MA",73,2251,2324
"8414","Wenham","Essex County","MA","Wenham","1994","Wenham town, MA",61,2289,2350
"8415","Wenham","Essex County","MA","Wenham","1995","Wenham town, MA",58,2310,2368
"8416","Wenham","Essex County","MA","Wenham","1996","Wenham town, MA",53,2352,2405
"8417","Wenham","Essex County","MA","Wenham","1997","Wenham town, MA",51,2419,2470
"8418","Wenham","Essex County","MA","Wenham","1998","Wenham town, MA",40,2504,2544
"8419","Wenham","Essex County","MA","Wenham","1999","Wenham town, MA",38,2539,2577
"8420","Wenham","Essex County","MA","Wenham","2000","Wenham town, MA",43,1771,1814
"8421","Wenham","Essex County","MA","Wenham","2001","Wenham town, MA",65,1758,1823
"8422","Wenham","Essex County","MA","Wenham","2002","Wenham town, MA",98,1734,1832
"8423","Wenham","Essex County","MA","Wenham","2003","Wenham town, MA",102,1709,1811
"8424","Wenham","Essex County","MA","Wenham","2004","Wenham town, MA",90,1703,1793
"8425","Wenham","Essex County","MA","Wenham","2005","Wenham town, MA",90,1715,1805
"8426","Wenham","Essex County","MA","Wenham","2006","Wenham town, MA",73,1636,1709
"8427","Wenham","Essex County","MA","Wenham","2007","Wenham town, MA",72,1733,1805
"8428","Wenham","Essex County","MA","Wenham","2008","Wenham town, MA",98,1727,1825
"8429","Wenham","Essex County","MA","Wenham","2009","Wenham town, MA",151,1671,1822
"8430","Wenham","Essex County","MA","Wenham","2010","Wenham town, MA",148,1742,1890
"8431","Wenham","Essex County","MA","Wenham","2011","Wenham town, MA",130,1759,1889
"8432","Wenham","Essex County","MA","Wenham","2012","Wenham town, MA",122,1778,1900
"8433","West Boylston","Worcester County","MA","West Boylston","1990","West Boylston town, MA",172,2988,3160
"8434","West Boylston","Worcester County","MA","West Boylston","1991","West Boylston town, MA",245,2834,3079
"8435","West Boylston","Worcester County","MA","West Boylston","1992","West Boylston town, MA",254,2853,3107
"8436","West Boylston","Worcester County","MA","West Boylston","1993","West Boylston town, MA",194,2937,3131
"8437","West Boylston","Worcester County","MA","West Boylston","1994","West Boylston town, MA",157,2972,3129
"8438","West Boylston","Worcester County","MA","West Boylston","1995","West Boylston town, MA",138,2969,3107
"8439","West Boylston","Worcester County","MA","West Boylston","1996","West Boylston town, MA",95,3016,3111
"8440","West Boylston","Worcester County","MA","West Boylston","1997","West Boylston town, MA",97,3105,3202
"8441","West Boylston","Worcester County","MA","West Boylston","1998","West Boylston town, MA",78,3163,3241
"8442","West Boylston","Worcester County","MA","West Boylston","1999","West Boylston town, MA",98,3148,3246
"8443","West Boylston","Worcester County","MA","West Boylston","2000","West Boylston town, MA",87,3189,3276
"8444","West Boylston","Worcester County","MA","West Boylston","2001","West Boylston town, MA",103,3194,3297
"8445","West Boylston","Worcester County","MA","West Boylston","2002","West Boylston town, MA",158,3144,3302
"8446","West Boylston","Worcester County","MA","West Boylston","2003","West Boylston town, MA",189,3150,3339
"8447","West Boylston","Worcester County","MA","West Boylston","2004","West Boylston town, MA",170,3131,3301
"8448","West Boylston","Worcester County","MA","West Boylston","2005","West Boylston town, MA",158,3155,3313
"8449","West Boylston","Worcester County","MA","West Boylston","2006","West Boylston town, MA",174,3295,3469
"8450","West Boylston","Worcester County","MA","West Boylston","2007","West Boylston town, MA",165,3347,3512
"8451","West Boylston","Worcester County","MA","West Boylston","2008","West Boylston town, MA",189,3271,3460
"8452","West Boylston","Worcester County","MA","West Boylston","2009","West Boylston town, MA",304,3173,3477
"8453","West Boylston","Worcester County","MA","West Boylston","2010","West Boylston town, MA",298,3008,3306
"8454","West Boylston","Worcester County","MA","West Boylston","2011","West Boylston town, MA",271,3033,3304
"8455","West Boylston","Worcester County","MA","West Boylston","2012","West Boylston town, MA",239,3032,3271
"8456","West Bridgewater","Plymouth County","MA","West Bridgewater","1990","West Bridgewater town, MA",225,3322,3547
"8457","West Bridgewater","Plymouth County","MA","West Bridgewater","1991","West Bridgewater town, MA",329,3160,3489
"8458","West Bridgewater","Plymouth County","MA","West Bridgewater","1992","West Bridgewater town, MA",355,3118,3473
"8459","West Bridgewater","Plymouth County","MA","West Bridgewater","1993","West Bridgewater town, MA",297,3272,3569
"8460","West Bridgewater","Plymouth County","MA","West Bridgewater","1994","West Bridgewater town, MA",234,3408,3642
"8461","West Bridgewater","Plymouth County","MA","West Bridgewater","1995","West Bridgewater town, MA",204,3500,3704
"8462","West Bridgewater","Plymouth County","MA","West Bridgewater","1996","West Bridgewater town, MA",180,3537,3717
"8463","West Bridgewater","Plymouth County","MA","West Bridgewater","1997","West Bridgewater town, MA",164,3648,3812
"8464","West Bridgewater","Plymouth County","MA","West Bridgewater","1998","West Bridgewater town, MA",113,3681,3794
"8465","West Bridgewater","Plymouth County","MA","West Bridgewater","1999","West Bridgewater town, MA",104,3751,3855
"8466","West Bridgewater","Plymouth County","MA","West Bridgewater","2000","West Bridgewater town, MA",91,3420,3511
"8467","West Bridgewater","Plymouth County","MA","West Bridgewater","2001","West Bridgewater town, MA",118,3428,3546
"8468","West Bridgewater","Plymouth County","MA","West Bridgewater","2002","West Bridgewater town, MA",184,3405,3589
"8469","West Bridgewater","Plymouth County","MA","West Bridgewater","2003","West Bridgewater town, MA",193,3336,3529
"8470","West Bridgewater","Plymouth County","MA","West Bridgewater","2004","West Bridgewater town, MA",181,3327,3508
"8471","West Bridgewater","Plymouth County","MA","West Bridgewater","2005","West Bridgewater town, MA",178,3326,3504
"8472","West Bridgewater","Plymouth County","MA","West Bridgewater","2006","West Bridgewater town, MA",167,3344,3511
"8473","West Bridgewater","Plymouth County","MA","West Bridgewater","2007","West Bridgewater town, MA",165,3344,3509
"8474","West Bridgewater","Plymouth County","MA","West Bridgewater","2008","West Bridgewater town, MA",198,3319,3517
"8475","West Bridgewater","Plymouth County","MA","West Bridgewater","2009","West Bridgewater town, MA",301,3213,3514
"8476","West Bridgewater","Plymouth County","MA","West Bridgewater","2010","West Bridgewater town, MA",304,3320,3624
"8477","West Bridgewater","Plymouth County","MA","West Bridgewater","2011","West Bridgewater town, MA",279,3352,3631
"8478","West Bridgewater","Plymouth County","MA","West Bridgewater","2012","West Bridgewater town, MA",254,3381,3635
"8479","West Brookfield","Worcester County","MA","West Brookfield","1990","West Brookfield town, MA",112,1622,1734
"8480","West Brookfield","Worcester County","MA","West Brookfield","1991","West Brookfield town, MA",153,1576,1729
"8481","West Brookfield","Worcester County","MA","West Brookfield","1992","West Brookfield town, MA",150,1595,1745
"8482","West Brookfield","Worcester County","MA","West Brookfield","1993","West Brookfield town, MA",117,1650,1767
"8483","West Brookfield","Worcester County","MA","West Brookfield","1994","West Brookfield town, MA",110,1683,1793
"8484","West Brookfield","Worcester County","MA","West Brookfield","1995","West Brookfield town, MA",97,1645,1742
"8485","West Brookfield","Worcester County","MA","West Brookfield","1996","West Brookfield town, MA",96,1678,1774
"8486","West Brookfield","Worcester County","MA","West Brookfield","1997","West Brookfield town, MA",82,1729,1811
"8487","West Brookfield","Worcester County","MA","West Brookfield","1998","West Brookfield town, MA",64,1776,1840
"8488","West Brookfield","Worcester County","MA","West Brookfield","1999","West Brookfield town, MA",54,1778,1832
"8489","West Brookfield","Worcester County","MA","West Brookfield","2000","West Brookfield town, MA",46,1828,1874
"8490","West Brookfield","Worcester County","MA","West Brookfield","2001","West Brookfield town, MA",65,1831,1896
"8491","West Brookfield","Worcester County","MA","West Brookfield","2002","West Brookfield town, MA",103,1819,1922
"8492","West Brookfield","Worcester County","MA","West Brookfield","2003","West Brookfield town, MA",118,1811,1929
"8493","West Brookfield","Worcester County","MA","West Brookfield","2004","West Brookfield town, MA",117,1806,1923
"8494","West Brookfield","Worcester County","MA","West Brookfield","2005","West Brookfield town, MA",102,1798,1900
"8495","West Brookfield","Worcester County","MA","West Brookfield","2006","West Brookfield town, MA",98,1799,1897
"8496","West Brookfield","Worcester County","MA","West Brookfield","2007","West Brookfield town, MA",97,1795,1892
"8497","West Brookfield","Worcester County","MA","West Brookfield","2008","West Brookfield town, MA",116,1753,1869
"8498","West Brookfield","Worcester County","MA","West Brookfield","2009","West Brookfield town, MA",179,1702,1881
"8499","West Brookfield","Worcester County","MA","West Brookfield","2010","West Brookfield town, MA",183,1636,1819
"8500","West Brookfield","Worcester County","MA","West Brookfield","2011","West Brookfield town, MA",163,1651,1814
"8501","West Brookfield","Worcester County","MA","West Brookfield","2012","West Brookfield town, MA",143,1650,1793
"8502","West Newbury","Essex County","MA","West Newbury","1990","West Newbury town, MA",86,1878,1964
"8503","West Newbury","Essex County","MA","West Newbury","1991","West Newbury town, MA",114,1886,2000
"8504","West Newbury","Essex County","MA","West Newbury","1992","West Newbury town, MA",120,1959,2079
"8505","West Newbury","Essex County","MA","West Newbury","1993","West Newbury town, MA",96,2106,2202
"8506","West Newbury","Essex County","MA","West Newbury","1994","West Newbury town, MA",93,2157,2250
"8507","West Newbury","Essex County","MA","West Newbury","1995","West Newbury town, MA",87,2121,2208
"8508","West Newbury","Essex County","MA","West Newbury","1996","West Newbury town, MA",68,2211,2279
"8509","West Newbury","Essex County","MA","West Newbury","1997","West Newbury town, MA",61,2256,2317
"8510","West Newbury","Essex County","MA","West Newbury","1998","West Newbury town, MA",52,2318,2370
"8511","West Newbury","Essex County","MA","West Newbury","1999","West Newbury town, MA",61,2391,2452
"8512","West Newbury","Essex County","MA","West Newbury","2000","West Newbury town, MA",48,2281,2329
"8513","West Newbury","Essex County","MA","West Newbury","2001","West Newbury town, MA",62,2271,2333
"8514","West Newbury","Essex County","MA","West Newbury","2002","West Newbury town, MA",81,2218,2299
"8515","West Newbury","Essex County","MA","West Newbury","2003","West Newbury town, MA",105,2175,2280
"8516","West Newbury","Essex County","MA","West Newbury","2004","West Newbury town, MA",89,2164,2253
"8517","West Newbury","Essex County","MA","West Newbury","2005","West Newbury town, MA",78,2186,2264
"8518","West Newbury","Essex County","MA","West Newbury","2006","West Newbury town, MA",83,2197,2280
"8519","West Newbury","Essex County","MA","West Newbury","2007","West Newbury town, MA",73,2191,2264
"8520","West Newbury","Essex County","MA","West Newbury","2008","West Newbury town, MA",81,2159,2240
"8521","West Newbury","Essex County","MA","West Newbury","2009","West Newbury town, MA",151,2159,2310
"8522","West Newbury","Essex County","MA","West Newbury","2010","West Newbury town, MA",145,2123,2268
"8523","West Newbury","Essex County","MA","West Newbury","2011","West Newbury town, MA",121,2150,2271
"8524","West Newbury","Essex County","MA","West Newbury","2012","West Newbury town, MA",109,2178,2287
"8525","West Springfield","Hampden County","MA","West Springfield","1990","West Springfield Town city, MA",897,14063,14960
"8526","West Springfield","Hampden County","MA","West Springfield","1991","West Springfield Town city, MA",1238,13479,14717
"8527","West Springfield","Hampden County","MA","West Springfield","1992","West Springfield Town city, MA",1245,13416,14661
"8528","West Springfield","Hampden County","MA","West Springfield","1993","West Springfield Town city, MA",1143,13265,14408
"8529","West Springfield","Hampden County","MA","West Springfield","1994","West Springfield Town city, MA",1338,13246,14584
"8530","West Springfield","Hampden County","MA","West Springfield","1995","West Springfield Town city, MA",1127,13104,14231
"8531","West Springfield","Hampden County","MA","West Springfield","1996","West Springfield Town city, MA",795,13202,13997
"8532","West Springfield","Hampden County","MA","West Springfield","1997","West Springfield Town city, MA",714,13446,14160
"8533","West Springfield","Hampden County","MA","West Springfield","1998","West Springfield Town city, MA",497,13522,14019
"8534","West Springfield","Hampden County","MA","West Springfield","1999","West Springfield Town city, MA",497,13511,14008
"8535","West Springfield","Hampden County","MA","West Springfield","2000","West Springfield Town city, MA",410,14043,14453
"8536","West Springfield","Hampden County","MA","West Springfield","2001","West Springfield Town city, MA",563,14055,14618
"8537","West Springfield","Hampden County","MA","West Springfield","2002","West Springfield Town city, MA",738,13992,14730
"8538","West Springfield","Hampden County","MA","West Springfield","2003","West Springfield Town city, MA",839,13851,14690
"8539","West Springfield","Hampden County","MA","West Springfield","2004","West Springfield Town city, MA",792,13836,14628
"8540","West Springfield","Hampden County","MA","West Springfield","2005","West Springfield Town city, MA",779,13860,14639
"8541","West Springfield","Hampden County","MA","West Springfield","2006","West Springfield Town city, MA",728,13885,14613
"8542","West Springfield","Hampden County","MA","West Springfield","2007","West Springfield Town city, MA",706,13801,14507
"8543","West Springfield","Hampden County","MA","West Springfield","2008","West Springfield Town city, MA",891,13606,14497
"8544","West Springfield","Hampden County","MA","West Springfield","2009","West Springfield Town city, MA",1281,13306,14587
"8545","West Springfield","Hampden County","MA","West Springfield","2010","West Springfield Town city, MA",1359,13461,14820
"8546","West Springfield","Hampden County","MA","West Springfield","2011","West Springfield Town city, MA",1173,13327,14500
"8547","West Springfield","Hampden County","MA","West Springfield","2012","West Springfield Town city, MA",1092,13335,14427
"8548","West Stockbridge","Berkshire County","MA","West Stockbridge","1990","West Stockbridge town, MA",49,742,791
"8549","West Stockbridge","Berkshire County","MA","West Stockbridge","1991","West Stockbridge town, MA",62,724,786
"8550","West Stockbridge","Berkshire County","MA","West Stockbridge","1992","West Stockbridge town, MA",76,731,807
"8551","West Stockbridge","Berkshire County","MA","West Stockbridge","1993","West Stockbridge town, MA",41,775,816
"8552","West Stockbridge","Berkshire County","MA","West Stockbridge","1994","West Stockbridge town, MA",46,792,838
"8553","West Stockbridge","Berkshire County","MA","West Stockbridge","1995","West Stockbridge town, MA",42,792,834
"8554","West Stockbridge","Berkshire County","MA","West Stockbridge","1996","West Stockbridge town, MA",36,809,845
"8555","West Stockbridge","Berkshire County","MA","West Stockbridge","1997","West Stockbridge town, MA",26,823,849
"8556","West Stockbridge","Berkshire County","MA","West Stockbridge","1998","West Stockbridge town, MA",23,820,843
"8557","West Stockbridge","Berkshire County","MA","West Stockbridge","1999","West Stockbridge town, MA",19,817,836
"8558","West Stockbridge","Berkshire County","MA","West Stockbridge","2000","West Stockbridge town, MA",17,778,795
"8559","West Stockbridge","Berkshire County","MA","West Stockbridge","2001","West Stockbridge town, MA",17,814,831
"8560","West Stockbridge","Berkshire County","MA","West Stockbridge","2002","West Stockbridge town, MA",25,842,867
"8561","West Stockbridge","Berkshire County","MA","West Stockbridge","2003","West Stockbridge town, MA",25,848,873
"8562","West Stockbridge","Berkshire County","MA","West Stockbridge","2004","West Stockbridge town, MA",24,846,870
"8563","West Stockbridge","Berkshire County","MA","West Stockbridge","2005","West Stockbridge town, MA",27,863,890
"8564","West Stockbridge","Berkshire County","MA","West Stockbridge","2006","West Stockbridge town, MA",23,873,896
"8565","West Stockbridge","Berkshire County","MA","West Stockbridge","2007","West Stockbridge town, MA",24,855,879
"8566","West Stockbridge","Berkshire County","MA","West Stockbridge","2008","West Stockbridge town, MA",30,848,878
"8567","West Stockbridge","Berkshire County","MA","West Stockbridge","2009","West Stockbridge town, MA",53,824,877
"8568","West Stockbridge","Berkshire County","MA","West Stockbridge","2010","West Stockbridge town, MA",55,758,813
"8569","West Stockbridge","Berkshire County","MA","West Stockbridge","2011","West Stockbridge town, MA",52,763,815
"8570","West Stockbridge","Berkshire County","MA","West Stockbridge","2012","West Stockbridge town, MA",39,756,795
"8571","West Tisbury","Dukes County","MA","West Tisbury","1990","West Tisbury town, MA",12,1106,1118
"8572","West Tisbury","Dukes County","MA","West Tisbury","1991","West Tisbury town, MA",19,1130,1149
"8573","West Tisbury","Dukes County","MA","West Tisbury","1992","West Tisbury town, MA",27,1080,1107
"8574","West Tisbury","Dukes County","MA","West Tisbury","1993","West Tisbury town, MA",26,1129,1155
"8575","West Tisbury","Dukes County","MA","West Tisbury","1994","West Tisbury town, MA",24,1226,1250
"8576","West Tisbury","Dukes County","MA","West Tisbury","1995","West Tisbury town, MA",33,1402,1435
"8577","West Tisbury","Dukes County","MA","West Tisbury","1996","West Tisbury town, MA",36,1483,1519
"8578","West Tisbury","Dukes County","MA","West Tisbury","1997","West Tisbury town, MA",30,1540,1570
"8579","West Tisbury","Dukes County","MA","West Tisbury","1998","West Tisbury town, MA",27,1579,1606
"8580","West Tisbury","Dukes County","MA","West Tisbury","1999","West Tisbury town, MA",28,1618,1646
"8581","West Tisbury","Dukes County","MA","West Tisbury","2000","West Tisbury town, MA",26,1751,1777
"8582","West Tisbury","Dukes County","MA","West Tisbury","2001","West Tisbury town, MA",26,1782,1808
"8583","West Tisbury","Dukes County","MA","West Tisbury","2002","West Tisbury town, MA",39,1858,1897
"8584","West Tisbury","Dukes County","MA","West Tisbury","2003","West Tisbury town, MA",49,1937,1986
"8585","West Tisbury","Dukes County","MA","West Tisbury","2004","West Tisbury town, MA",51,1970,2021
"8586","West Tisbury","Dukes County","MA","West Tisbury","2005","West Tisbury town, MA",46,1954,2000
"8587","West Tisbury","Dukes County","MA","West Tisbury","2006","West Tisbury town, MA",48,1961,2009
"8588","West Tisbury","Dukes County","MA","West Tisbury","2007","West Tisbury town, MA",42,1975,2017
"8589","West Tisbury","Dukes County","MA","West Tisbury","2008","West Tisbury town, MA",54,1978,2032
"8590","West Tisbury","Dukes County","MA","West Tisbury","2009","West Tisbury town, MA",88,1912,2000
"8591","West Tisbury","Dukes County","MA","West Tisbury","2010","West Tisbury town, MA",107,1915,2022
"8592","West Tisbury","Dukes County","MA","West Tisbury","2011","West Tisbury town, MA",93,1930,2023
"8593","West Tisbury","Dukes County","MA","West Tisbury","2012","West Tisbury town, MA",87,1949,2036
"8594","Westborough","Worcester County","MA","Westborough","1990","Westborough town, MA",342,7721,8063
"8595","Westborough","Worcester County","MA","Westborough","1991","Westborough town, MA",509,7564,8073
"8596","Westborough","Worcester County","MA","Westborough","1992","Westborough town, MA",524,7622,8146
"8597","Westborough","Worcester County","MA","Westborough","1993","Westborough town, MA",421,8017,8438
"8598","Westborough","Worcester County","MA","Westborough","1994","Westborough town, MA",357,8282,8639
"8599","Westborough","Worcester County","MA","Westborough","1995","Westborough town, MA",306,7947,8253
"8600","Westborough","Worcester County","MA","Westborough","1996","Westborough town, MA",223,8284,8507
"8601","Westborough","Worcester County","MA","Westborough","1997","Westborough town, MA",207,8594,8801
"8602","Westborough","Worcester County","MA","Westborough","1998","Westborough town, MA",185,8802,8987
"8603","Westborough","Worcester County","MA","Westborough","1999","Westborough town, MA",229,8848,9077
"8604","Westborough","Worcester County","MA","Westborough","2000","Westborough town, MA",189,8931,9120
"8605","Westborough","Worcester County","MA","Westborough","2001","Westborough town, MA",296,8982,9278
"8606","Westborough","Worcester County","MA","Westborough","2002","Westborough town, MA",463,8968,9431
"8607","Westborough","Worcester County","MA","Westborough","2003","Westborough town, MA",489,9012,9501
"8608","Westborough","Worcester County","MA","Westborough","2004","Westborough town, MA",390,8957,9347
"8609","Westborough","Worcester County","MA","Westborough","2005","Westborough town, MA",342,8927,9269
"8610","Westborough","Worcester County","MA","Westborough","2006","Westborough town, MA",339,8785,9124
"8611","Westborough","Worcester County","MA","Westborough","2007","Westborough town, MA",315,8804,9119
"8612","Westborough","Worcester County","MA","Westborough","2008","Westborough town, MA",380,8608,8988
"8613","Westborough","Worcester County","MA","Westborough","2009","Westborough town, MA",583,8361,8944
"8614","Westborough","Worcester County","MA","Westborough","2010","Westborough town, MA",591,8335,8926
"8615","Westborough","Worcester County","MA","Westborough","2011","Westborough town, MA",520,8409,8929
"8616","Westborough","Worcester County","MA","Westborough","2012","Westborough town, MA",453,8406,8859
"8617","Westfield","Hampden County","MA","Westfield","1990","Westfield city, MA",1066,18690,19756
"8618","Westfield","Hampden County","MA","Westfield","1991","Westfield city, MA",1845,18010,19855
"8619","Westfield","Hampden County","MA","Westfield","1992","Westfield city, MA",1634,17813,19447
"8620","Westfield","Hampden County","MA","Westfield","1993","Westfield city, MA",1444,17860,19304
"8621","Westfield","Hampden County","MA","Westfield","1994","Westfield city, MA",1044,18002,19046
"8622","Westfield","Hampden County","MA","Westfield","1995","Westfield city, MA",829,17818,18647
"8623","Westfield","Hampden County","MA","Westfield","1996","Westfield city, MA",646,18037,18683
"8624","Westfield","Hampden County","MA","Westfield","1997","Westfield city, MA",662,18493,19155
"8625","Westfield","Hampden County","MA","Westfield","1998","Westfield city, MA",648,18635,19283
"8626","Westfield","Hampden County","MA","Westfield","1999","Westfield city, MA",670,18723,19393
"8627","Westfield","Hampden County","MA","Westfield","2000","Westfield city, MA",573,20409,20982
"8628","Westfield","Hampden County","MA","Westfield","2001","Westfield city, MA",707,20423,21130
"8629","Westfield","Hampden County","MA","Westfield","2002","Westfield city, MA",988,20364,21352
"8630","Westfield","Hampden County","MA","Westfield","2003","Westfield city, MA",1118,20225,21343
"8631","Westfield","Hampden County","MA","Westfield","2004","Westfield city, MA",1041,20228,21269
"8632","Westfield","Hampden County","MA","Westfield","2005","Westfield city, MA",984,20290,21274
"8633","Westfield","Hampden County","MA","Westfield","2006","Westfield city, MA",995,20395,21390
"8634","Westfield","Hampden County","MA","Westfield","2007","Westfield city, MA",988,20301,21289
"8635","Westfield","Hampden County","MA","Westfield","2008","Westfield city, MA",1150,20344,21494
"8636","Westfield","Hampden County","MA","Westfield","2009","Westfield city, MA",1744,20146,21890
"8637","Westfield","Hampden County","MA","Westfield","2010","Westfield city, MA",1788,19699,21487
"8638","Westfield","Hampden County","MA","Westfield","2011","Westfield city, MA",1631,19501,21132
"8639","Westfield","Hampden County","MA","Westfield","2012","Westfield city, MA",1520,19513,21033
"8640","Westford","Middlesex County","MA","Westford","1990","Westford town, MA",474,9386,9860
"8641","Westford","Middlesex County","MA","Westford","1991","Westford town, MA",683,9210,9893
"8642","Westford","Middlesex County","MA","Westford","1992","Westford town, MA",756,9374,10130
"8643","Westford","Middlesex County","MA","Westford","1993","Westford town, MA",602,9601,10203
"8644","Westford","Middlesex County","MA","Westford","1994","Westford town, MA",516,9941,10457
"8645","Westford","Middlesex County","MA","Westford","1995","Westford town, MA",441,9920,10361
"8646","Westford","Middlesex County","MA","Westford","1996","Westford town, MA",339,10433,10772
"8647","Westford","Middlesex County","MA","Westford","1997","Westford town, MA",272,11034,11306
"8648","Westford","Middlesex County","MA","Westford","1998","Westford town, MA",249,11511,11760
"8649","Westford","Middlesex County","MA","Westford","1999","Westford town, MA",269,12103,12372
"8650","Westford","Middlesex County","MA","Westford","2000","Westford town, MA",206,11323,11529
"8651","Westford","Middlesex County","MA","Westford","2001","Westford town, MA",364,11452,11816
"8652","Westford","Middlesex County","MA","Westford","2002","Westford town, MA",659,11307,11966
"8653","Westford","Middlesex County","MA","Westford","2003","Westford town, MA",698,11189,11887
"8654","Westford","Middlesex County","MA","Westford","2004","Westford town, MA",500,11207,11707
"8655","Westford","Middlesex County","MA","Westford","2005","Westford town, MA",448,11280,11728
"8656","Westford","Middlesex County","MA","Westford","2006","Westford town, MA",447,11292,11739
"8657","Westford","Middlesex County","MA","Westford","2007","Westford town, MA",418,11436,11854
"8658","Westford","Middlesex County","MA","Westford","2008","Westford town, MA",482,11550,12032
"8659","Westford","Middlesex County","MA","Westford","2009","Westford town, MA",843,11508,12351
"8660","Westford","Middlesex County","MA","Westford","2010","Westford town, MA",807,11239,12046
"8661","Westford","Middlesex County","MA","Westford","2011","Westford town, MA",634,11360,11994
"8662","Westford","Middlesex County","MA","Westford","2012","Westford town, MA",624,11485,12109
"8663","Westhampton","Hampshire County","MA","Westhampton","1990","Westhampton town, MA",21,764,785
"8664","Westhampton","Hampshire County","MA","Westhampton","1991","Westhampton town, MA",47,732,779
"8665","Westhampton","Hampshire County","MA","Westhampton","1992","Westhampton town, MA",47,806,853
"8666","Westhampton","Hampshire County","MA","Westhampton","1993","Westhampton town, MA",40,814,854
"8667","Westhampton","Hampshire County","MA","Westhampton","1994","Westhampton town, MA",36,874,910
"8668","Westhampton","Hampshire County","MA","Westhampton","1995","Westhampton town, MA",35,938,973
"8669","Westhampton","Hampshire County","MA","Westhampton","1996","Westhampton town, MA",25,927,952
"8670","Westhampton","Hampshire County","MA","Westhampton","1997","Westhampton town, MA",34,943,977
"8671","Westhampton","Hampshire County","MA","Westhampton","1998","Westhampton town, MA",28,982,1010
"8672","Westhampton","Hampshire County","MA","Westhampton","1999","Westhampton town, MA",26,1071,1097
"8673","Westhampton","Hampshire County","MA","Westhampton","2000","Westhampton town, MA",17,875,892
"8674","Westhampton","Hampshire County","MA","Westhampton","2001","Westhampton town, MA",22,887,909
"8675","Westhampton","Hampshire County","MA","Westhampton","2002","Westhampton town, MA",28,890,918
"8676","Westhampton","Hampshire County","MA","Westhampton","2003","Westhampton town, MA",33,894,927
"8677","Westhampton","Hampshire County","MA","Westhampton","2004","Westhampton town, MA",31,909,940
"8678","Westhampton","Hampshire County","MA","Westhampton","2005","Westhampton town, MA",27,917,944
"8679","Westhampton","Hampshire County","MA","Westhampton","2006","Westhampton town, MA",26,934,960
"8680","Westhampton","Hampshire County","MA","Westhampton","2007","Westhampton town, MA",30,936,966
"8681","Westhampton","Hampshire County","MA","Westhampton","2008","Westhampton town, MA",42,922,964
"8682","Westhampton","Hampshire County","MA","Westhampton","2009","Westhampton town, MA",65,886,951
"8683","Westhampton","Hampshire County","MA","Westhampton","2010","Westhampton town, MA",57,899,956
"8684","Westhampton","Hampshire County","MA","Westhampton","2011","Westhampton town, MA",59,889,948
"8685","Westhampton","Hampshire County","MA","Westhampton","2012","Westhampton town, MA",52,889,941
"8686","Westminster","Worcester County","MA","Westminster","1990","Westminster town, MA",306,3128,3434
"8687","Westminster","Worcester County","MA","Westminster","1991","Westminster town, MA",322,3057,3379
"8688","Westminster","Worcester County","MA","Westminster","1992","Westminster town, MA",318,3178,3496
"8689","Westminster","Worcester County","MA","Westminster","1993","Westminster town, MA",245,3255,3500
"8690","Westminster","Worcester County","MA","Westminster","1994","Westminster town, MA",235,3316,3551
"8691","Westminster","Worcester County","MA","Westminster","1995","Westminster town, MA",188,3292,3480
"8692","Westminster","Worcester County","MA","Westminster","1996","Westminster town, MA",159,3299,3458
"8693","Westminster","Worcester County","MA","Westminster","1997","Westminster town, MA",138,3382,3520
"8694","Westminster","Worcester County","MA","Westminster","1998","Westminster town, MA",121,3406,3527
"8695","Westminster","Worcester County","MA","Westminster","1999","Westminster town, MA",138,3439,3577
"8696","Westminster","Worcester County","MA","Westminster","2000","Westminster town, MA",108,3649,3757
"8697","Westminster","Worcester County","MA","Westminster","2001","Westminster town, MA",142,3638,3780
"8698","Westminster","Worcester County","MA","Westminster","2002","Westminster town, MA",233,3636,3869
"8699","Westminster","Worcester County","MA","Westminster","2003","Westminster town, MA",250,3645,3895
"8700","Westminster","Worcester County","MA","Westminster","2004","Westminster town, MA",230,3641,3871
"8701","Westminster","Worcester County","MA","Westminster","2005","Westminster town, MA",222,3635,3857
"8702","Westminster","Worcester County","MA","Westminster","2006","Westminster town, MA",218,3693,3911
"8703","Westminster","Worcester County","MA","Westminster","2007","Westminster town, MA",196,3691,3887
"8704","Westminster","Worcester County","MA","Westminster","2008","Westminster town, MA",226,3643,3869
"8705","Westminster","Worcester County","MA","Westminster","2009","Westminster town, MA",346,3476,3822
"8706","Westminster","Worcester County","MA","Westminster","2010","Westminster town, MA",347,3459,3806
"8707","Westminster","Worcester County","MA","Westminster","2011","Westminster town, MA",305,3457,3762
"8708","Westminster","Worcester County","MA","Westminster","2012","Westminster town, MA",306,3455,3761
"8709","Weston","Middlesex County","MA","Weston","1990","Weston town, MA",128,5076,5204
"8710","Weston","Middlesex County","MA","Weston","1991","Weston town, MA",164,4856,5020
"8711","Weston","Middlesex County","MA","Weston","1992","Weston town, MA",152,4861,5013
"8712","Weston","Middlesex County","MA","Weston","1993","Weston town, MA",134,4907,5041
"8713","Weston","Middlesex County","MA","Weston","1994","Weston town, MA",123,5035,5158
"8714","Weston","Middlesex County","MA","Weston","1995","Weston town, MA",115,5127,5242
"8715","Weston","Middlesex County","MA","Weston","1996","Weston town, MA",94,5240,5334
"8716","Weston","Middlesex County","MA","Weston","1997","Weston town, MA",76,5413,5489
"8717","Weston","Middlesex County","MA","Weston","1998","Weston town, MA",62,5540,5602
"8718","Weston","Middlesex County","MA","Weston","1999","Weston town, MA",62,5610,5672
"8719","Weston","Middlesex County","MA","Weston","2000","Weston town, MA",89,5320,5409
"8720","Weston","Middlesex County","MA","Weston","2001","Weston town, MA",126,5328,5454
"8721","Weston","Middlesex County","MA","Weston","2002","Weston town, MA",190,5256,5446
"8722","Weston","Middlesex County","MA","Weston","2003","Weston town, MA",208,5178,5386
"8723","Weston","Middlesex County","MA","Weston","2004","Weston town, MA",169,5170,5339
"8724","Weston","Middlesex County","MA","Weston","2005","Weston town, MA",149,5218,5367
"8725","Weston","Middlesex County","MA","Weston","2006","Weston town, MA",151,5166,5317
"8726","Weston","Middlesex County","MA","Weston","2007","Weston town, MA",148,5229,5377
"8727","Weston","Middlesex County","MA","Weston","2008","Weston town, MA",174,5240,5414
"8728","Weston","Middlesex County","MA","Weston","2009","Weston town, MA",280,5117,5397
"8729","Weston","Middlesex County","MA","Weston","2010","Weston town, MA",252,4914,5166
"8730","Weston","Middlesex County","MA","Weston","2011","Weston town, MA",216,4984,5200
"8731","Weston","Middlesex County","MA","Weston","2012","Weston town, MA",195,5038,5233
"8732","Westport","Bristol County","MA","Westport","1990","Westport town, MA",626,7021,7647
"8733","Westport","Bristol County","MA","Westport","1991","Westport town, MA",959,6764,7723
"8734","Westport","Bristol County","MA","Westport","1992","Westport town, MA",978,6889,7867
"8735","Westport","Bristol County","MA","Westport","1993","Westport town, MA",937,7036,7973
"8736","Westport","Bristol County","MA","Westport","1994","Westport town, MA",725,7104,7829
"8737","Westport","Bristol County","MA","Westport","1995","Westport town, MA",656,7112,7768
"8738","Westport","Bristol County","MA","Westport","1996","Westport town, MA",636,7141,7777
"8739","Westport","Bristol County","MA","Westport","1997","Westport town, MA",503,7293,7796
"8740","Westport","Bristol County","MA","Westport","1998","Westport town, MA",370,7428,7798
"8741","Westport","Bristol County","MA","Westport","1999","Westport town, MA",368,7546,7914
"8742","Westport","Bristol County","MA","Westport","2000","Westport town, MA",315,7511,7826
"8743","Westport","Bristol County","MA","Westport","2001","Westport town, MA",380,7503,7883
"8744","Westport","Bristol County","MA","Westport","2002","Westport town, MA",489,7602,8091
"8745","Westport","Bristol County","MA","Westport","2003","Westport town, MA",536,7654,8190
"8746","Westport","Bristol County","MA","Westport","2004","Westport town, MA",535,7717,8252
"8747","Westport","Bristol County","MA","Westport","2005","Westport town, MA",525,7946,8471
"8748","Westport","Bristol County","MA","Westport","2006","Westport town, MA",544,8065,8609
"8749","Westport","Bristol County","MA","Westport","2007","Westport town, MA",531,8085,8616
"8750","Westport","Bristol County","MA","Westport","2008","Westport town, MA",635,8112,8747
"8751","Westport","Bristol County","MA","Westport","2009","Westport town, MA",941,7795,8736
"8752","Westport","Bristol County","MA","Westport","2010","Westport town, MA",1011,7767,8778
"8753","Westport","Bristol County","MA","Westport","2011","Westport town, MA",964,7823,8787
"8754","Westport","Bristol County","MA","Westport","2012","Westport town, MA",877,7836,8713
"8755","Westwood","Norfolk County","MA","Westwood","1990","Westwood town, MA",297,6416,6713
"8756","Westwood","Norfolk County","MA","Westwood","1991","Westwood town, MA",375,6347,6722
"8757","Westwood","Norfolk County","MA","Westwood","1992","Westwood town, MA",408,6383,6791
"8758","Westwood","Norfolk County","MA","Westwood","1993","Westwood town, MA",314,6501,6815
"8759","Westwood","Norfolk County","MA","Westwood","1994","Westwood town, MA",274,6674,6948
"8760","Westwood","Norfolk County","MA","Westwood","1995","Westwood town, MA",260,6491,6751
"8761","Westwood","Norfolk County","MA","Westwood","1996","Westwood town, MA",185,6646,6831
"8762","Westwood","Norfolk County","MA","Westwood","1997","Westwood town, MA",190,6847,7037
"8763","Westwood","Norfolk County","MA","Westwood","1998","Westwood town, MA",155,6978,7133
"8764","Westwood","Norfolk County","MA","Westwood","1999","Westwood town, MA",139,7085,7224
"8765","Westwood","Norfolk County","MA","Westwood","2000","Westwood town, MA",146,6754,6900
"8766","Westwood","Norfolk County","MA","Westwood","2001","Westwood town, MA",211,6739,6950
"8767","Westwood","Norfolk County","MA","Westwood","2002","Westwood town, MA",285,6613,6898
"8768","Westwood","Norfolk County","MA","Westwood","2003","Westwood town, MA",308,6490,6798
"8769","Westwood","Norfolk County","MA","Westwood","2004","Westwood town, MA",257,6458,6715
"8770","Westwood","Norfolk County","MA","Westwood","2005","Westwood town, MA",232,6469,6701
"8771","Westwood","Norfolk County","MA","Westwood","2006","Westwood town, MA",212,6346,6558
"8772","Westwood","Norfolk County","MA","Westwood","2007","Westwood town, MA",208,6501,6709
"8773","Westwood","Norfolk County","MA","Westwood","2008","Westwood town, MA",259,6583,6842
"8774","Westwood","Norfolk County","MA","Westwood","2009","Westwood town, MA",411,6360,6771
"8775","Westwood","Norfolk County","MA","Westwood","2010","Westwood town, MA",406,6589,6995
"8776","Westwood","Norfolk County","MA","Westwood","2011","Westwood town, MA",337,6664,7001
"8777","Westwood","Norfolk County","MA","Westwood","2012","Westwood town, MA",322,6737,7059
"8778","Weymouth","Norfolk County","MA","Weymouth","1990","Weymouth Town city, MA",1931,29558,31489
"8779","Weymouth","Norfolk County","MA","Weymouth","1991","Weymouth Town city, MA",2677,28736,31413
"8780","Weymouth","Norfolk County","MA","Weymouth","1992","Weymouth Town city, MA",2675,28760,31435
"8781","Weymouth","Norfolk County","MA","Weymouth","1993","Weymouth Town city, MA",2151,28815,30966
"8782","Weymouth","Norfolk County","MA","Weymouth","1994","Weymouth Town city, MA",1780,29385,31165
"8783","Weymouth","Norfolk County","MA","Weymouth","1995","Weymouth Town city, MA",1678,29657,31335
"8784","Weymouth","Norfolk County","MA","Weymouth","1996","Weymouth Town city, MA",1433,30150,31583
"8785","Weymouth","Norfolk County","MA","Weymouth","1997","Weymouth Town city, MA",1249,30873,32122
"8786","Weymouth","Norfolk County","MA","Weymouth","1998","Weymouth Town city, MA",965,31222,32187
"8787","Weymouth","Norfolk County","MA","Weymouth","1999","Weymouth Town city, MA",916,31354,32270
"8788","Weymouth","Norfolk County","MA","Weymouth","2000","Weymouth Town city, MA",791,29322,30113
"8789","Weymouth","Norfolk County","MA","Weymouth","2001","Weymouth Town city, MA",996,29202,30198
"8790","Weymouth","Norfolk County","MA","Weymouth","2002","Weymouth Town city, MA",1477,28995,30472
"8791","Weymouth","Norfolk County","MA","Weymouth","2003","Weymouth Town city, MA",1754,28478,30232
"8792","Weymouth","Norfolk County","MA","Weymouth","2004","Weymouth Town city, MA",1568,28351,29919
"8793","Weymouth","Norfolk County","MA","Weymouth","2005","Weymouth Town city, MA",1455,28425,29880
"8794","Weymouth","Norfolk County","MA","Weymouth","2006","Weymouth Town city, MA",1460,27936,29396
"8795","Weymouth","Norfolk County","MA","Weymouth","2007","Weymouth Town city, MA",1343,28131,29474
"8796","Weymouth","Norfolk County","MA","Weymouth","2008","Weymouth Town city, MA",1604,28137,29741
"8797","Weymouth","Norfolk County","MA","Weymouth","2009","Weymouth Town city, MA",2466,27219,29685
"8798","Weymouth","Norfolk County","MA","Weymouth","2010","Weymouth Town city, MA",2614,27509,30123
"8799","Weymouth","Norfolk County","MA","Weymouth","2011","Weymouth Town city, MA",2176,27818,29994
"8800","Weymouth","Norfolk County","MA","Weymouth","2012","Weymouth Town city, MA",1918,28123,30041
"8801","Whately","Franklin County","MA","Whately","1990","Whately town, MA",30,797,827
"8802","Whately","Franklin County","MA","Whately","1991","Whately town, MA",38,814,852
"8803","Whately","Franklin County","MA","Whately","1992","Whately town, MA",35,795,830
"8804","Whately","Franklin County","MA","Whately","1993","Whately town, MA",28,795,823
"8805","Whately","Franklin County","MA","Whately","1994","Whately town, MA",15,750,765
"8806","Whately","Franklin County","MA","Whately","1995","Whately town, MA",19,844,863
"8807","Whately","Franklin County","MA","Whately","1996","Whately town, MA",16,854,870
"8808","Whately","Franklin County","MA","Whately","1997","Whately town, MA",17,876,893
"8809","Whately","Franklin County","MA","Whately","1998","Whately town, MA",11,805,816
"8810","Whately","Franklin County","MA","Whately","1999","Whately town, MA",13,825,838
"8811","Whately","Franklin County","MA","Whately","2000","Whately town, MA",15,952,967
"8812","Whately","Franklin County","MA","Whately","2001","Whately town, MA",19,955,974
"8813","Whately","Franklin County","MA","Whately","2002","Whately town, MA",25,955,980
"8814","Whately","Franklin County","MA","Whately","2003","Whately town, MA",28,940,968
"8815","Whately","Franklin County","MA","Whately","2004","Whately town, MA",32,948,980
"8816","Whately","Franklin County","MA","Whately","2005","Whately town, MA",29,951,980
"8817","Whately","Franklin County","MA","Whately","2006","Whately town, MA",28,952,980
"8818","Whately","Franklin County","MA","Whately","2007","Whately town, MA",25,942,967
"8819","Whately","Franklin County","MA","Whately","2008","Whately town, MA",35,941,976
"8820","Whately","Franklin County","MA","Whately","2009","Whately town, MA",46,900,946
"8821","Whately","Franklin County","MA","Whately","2010","Whately town, MA",40,860,900
"8822","Whately","Franklin County","MA","Whately","2011","Whately town, MA",38,853,891
"8823","Whately","Franklin County","MA","Whately","2012","Whately town, MA",34,854,888
"8824","Whitman","Plymouth County","MA","Whitman","1990","Whitman town, MA",501,6668,7169
"8825","Whitman","Plymouth County","MA","Whitman","1991","Whitman town, MA",783,6411,7194
"8826","Whitman","Plymouth County","MA","Whitman","1992","Whitman town, MA",796,6325,7121
"8827","Whitman","Plymouth County","MA","Whitman","1993","Whitman town, MA",607,6531,7138
"8828","Whitman","Plymouth County","MA","Whitman","1994","Whitman town, MA",450,6866,7316
"8829","Whitman","Plymouth County","MA","Whitman","1995","Whitman town, MA",402,6986,7388
"8830","Whitman","Plymouth County","MA","Whitman","1996","Whitman town, MA",395,7078,7473
"8831","Whitman","Plymouth County","MA","Whitman","1997","Whitman town, MA",303,7350,7653
"8832","Whitman","Plymouth County","MA","Whitman","1998","Whitman town, MA",256,7499,7755
"8833","Whitman","Plymouth County","MA","Whitman","1999","Whitman town, MA",242,7708,7950
"8834","Whitman","Plymouth County","MA","Whitman","2000","Whitman town, MA",197,7829,8026
"8835","Whitman","Plymouth County","MA","Whitman","2001","Whitman town, MA",270,7898,8168
"8836","Whitman","Plymouth County","MA","Whitman","2002","Whitman town, MA",387,7816,8203
"8837","Whitman","Plymouth County","MA","Whitman","2003","Whitman town, MA",461,7640,8101
"8838","Whitman","Plymouth County","MA","Whitman","2004","Whitman town, MA",416,7618,8034
"8839","Whitman","Plymouth County","MA","Whitman","2005","Whitman town, MA",404,7689,8093
"8840","Whitman","Plymouth County","MA","Whitman","2006","Whitman town, MA",430,7800,8230
"8841","Whitman","Plymouth County","MA","Whitman","2007","Whitman town, MA",404,7866,8270
"8842","Whitman","Plymouth County","MA","Whitman","2008","Whitman town, MA",466,7845,8311
"8843","Whitman","Plymouth County","MA","Whitman","2009","Whitman town, MA",730,7445,8175
"8844","Whitman","Plymouth County","MA","Whitman","2010","Whitman town, MA",706,7594,8300
"8845","Whitman","Plymouth County","MA","Whitman","2011","Whitman town, MA",655,7667,8322
"8846","Whitman","Plymouth County","MA","Whitman","2012","Whitman town, MA",573,7734,8307
"8847","Wilbraham","Hampden County","MA","Wilbraham","1990","Wilbraham town, MA",293,6423,6716
"8848","Wilbraham","Hampden County","MA","Wilbraham","1991","Wilbraham town, MA",399,6126,6525
"8849","Wilbraham","Hampden County","MA","Wilbraham","1992","Wilbraham town, MA",371,6155,6526
"8850","Wilbraham","Hampden County","MA","Wilbraham","1993","Wilbraham town, MA",396,6163,6559
"8851","Wilbraham","Hampden County","MA","Wilbraham","1994","Wilbraham town, MA",331,6182,6513
"8852","Wilbraham","Hampden County","MA","Wilbraham","1995","Wilbraham town, MA",280,6154,6434
"8853","Wilbraham","Hampden County","MA","Wilbraham","1996","Wilbraham town, MA",226,6237,6463
"8854","Wilbraham","Hampden County","MA","Wilbraham","1997","Wilbraham town, MA",197,6388,6585
"8855","Wilbraham","Hampden County","MA","Wilbraham","1998","Wilbraham town, MA",189,6471,6660
"8856","Wilbraham","Hampden County","MA","Wilbraham","1999","Wilbraham town, MA",155,6525,6680
"8857","Wilbraham","Hampden County","MA","Wilbraham","2000","Wilbraham town, MA",171,6543,6714
"8858","Wilbraham","Hampden County","MA","Wilbraham","2001","Wilbraham town, MA",203,6621,6824
"8859","Wilbraham","Hampden County","MA","Wilbraham","2002","Wilbraham town, MA",265,6602,6867
"8860","Wilbraham","Hampden County","MA","Wilbraham","2003","Wilbraham town, MA",313,6582,6895
"8861","Wilbraham","Hampden County","MA","Wilbraham","2004","Wilbraham town, MA",301,6616,6917
"8862","Wilbraham","Hampden County","MA","Wilbraham","2005","Wilbraham town, MA",285,6673,6958
"8863","Wilbraham","Hampden County","MA","Wilbraham","2006","Wilbraham town, MA",305,6738,7043
"8864","Wilbraham","Hampden County","MA","Wilbraham","2007","Wilbraham town, MA",275,6751,7026
"8865","Wilbraham","Hampden County","MA","Wilbraham","2008","Wilbraham town, MA",320,6661,6981
"8866","Wilbraham","Hampden County","MA","Wilbraham","2009","Wilbraham town, MA",474,6442,6916
"8867","Wilbraham","Hampden County","MA","Wilbraham","2010","Wilbraham town, MA",480,6488,6968
"8868","Wilbraham","Hampden County","MA","Wilbraham","2011","Wilbraham town, MA",437,6423,6860
"8869","Wilbraham","Hampden County","MA","Wilbraham","2012","Wilbraham town, MA",396,6427,6823
"8870","Williamsburg","Hampshire County","MA","Williamsburg","1990","Williamsburg town, MA",92,1455,1547
"8871","Williamsburg","Hampshire County","MA","Williamsburg","1991","Williamsburg town, MA",123,1404,1527
"8872","Williamsburg","Hampshire County","MA","Williamsburg","1992","Williamsburg town, MA",141,1397,1538
"8873","Williamsburg","Hampshire County","MA","Williamsburg","1993","Williamsburg town, MA",100,1410,1510
"8874","Williamsburg","Hampshire County","MA","Williamsburg","1994","Williamsburg town, MA",121,1418,1539
"8875","Williamsburg","Hampshire County","MA","Williamsburg","1995","Williamsburg town, MA",95,1449,1544
"8876","Williamsburg","Hampshire County","MA","Williamsburg","1996","Williamsburg town, MA",78,1471,1549
"8877","Williamsburg","Hampshire County","MA","Williamsburg","1997","Williamsburg town, MA",64,1500,1564
"8878","Williamsburg","Hampshire County","MA","Williamsburg","1998","Williamsburg town, MA",57,1551,1608
"8879","Williamsburg","Hampshire County","MA","Williamsburg","1999","Williamsburg town, MA",56,1557,1613
"8880","Williamsburg","Hampshire County","MA","Williamsburg","2000","Williamsburg town, MA",39,1462,1501
"8881","Williamsburg","Hampshire County","MA","Williamsburg","2001","Williamsburg town, MA",48,1454,1502
"8882","Williamsburg","Hampshire County","MA","Williamsburg","2002","Williamsburg town, MA",71,1453,1524
"8883","Williamsburg","Hampshire County","MA","Williamsburg","2003","Williamsburg town, MA",73,1443,1516
"8884","Williamsburg","Hampshire County","MA","Williamsburg","2004","Williamsburg town, MA",65,1441,1506
"8885","Williamsburg","Hampshire County","MA","Williamsburg","2005","Williamsburg town, MA",69,1444,1513
"8886","Williamsburg","Hampshire County","MA","Williamsburg","2006","Williamsburg town, MA",59,1457,1516
"8887","Williamsburg","Hampshire County","MA","Williamsburg","2007","Williamsburg town, MA",57,1462,1519
"8888","Williamsburg","Hampshire County","MA","Williamsburg","2008","Williamsburg town, MA",69,1489,1558
"8889","Williamsburg","Hampshire County","MA","Williamsburg","2009","Williamsburg town, MA",118,1421,1539
"8890","Williamsburg","Hampshire County","MA","Williamsburg","2010","Williamsburg town, MA",122,1410,1532
"8891","Williamsburg","Hampshire County","MA","Williamsburg","2011","Williamsburg town, MA",107,1392,1499
"8892","Williamsburg","Hampshire County","MA","Williamsburg","2012","Williamsburg town, MA",87,1392,1479
"8893","Williamstown","Berkshire County","MA","Williamstown","1990","Williamstown town, MA",213,3679,3892
"8894","Williamstown","Berkshire County","MA","Williamstown","1991","Williamstown town, MA",265,3532,3797
"8895","Williamstown","Berkshire County","MA","Williamstown","1992","Williamstown town, MA",245,3568,3813
"8896","Williamstown","Berkshire County","MA","Williamstown","1993","Williamstown town, MA",212,3651,3863
"8897","Williamstown","Berkshire County","MA","Williamstown","1994","Williamstown town, MA",172,3676,3848
"8898","Williamstown","Berkshire County","MA","Williamstown","1995","Williamstown town, MA",123,3600,3723
"8899","Williamstown","Berkshire County","MA","Williamstown","1996","Williamstown town, MA",111,3640,3751
"8900","Williamstown","Berkshire County","MA","Williamstown","1997","Williamstown town, MA",115,3675,3790
"8901","Williamstown","Berkshire County","MA","Williamstown","1998","Williamstown town, MA",80,3795,3875
"8902","Williamstown","Berkshire County","MA","Williamstown","1999","Williamstown town, MA",84,3831,3915
"8903","Williamstown","Berkshire County","MA","Williamstown","2000","Williamstown town, MA",102,3857,3959
"8904","Williamstown","Berkshire County","MA","Williamstown","2001","Williamstown town, MA",126,3871,3997
"8905","Williamstown","Berkshire County","MA","Williamstown","2002","Williamstown town, MA",162,3856,4018
"8906","Williamstown","Berkshire County","MA","Williamstown","2003","Williamstown town, MA",165,3816,3981
"8907","Williamstown","Berkshire County","MA","Williamstown","2004","Williamstown town, MA",170,3798,3968
"8908","Williamstown","Berkshire County","MA","Williamstown","2005","Williamstown town, MA",164,3813,3977
"8909","Williamstown","Berkshire County","MA","Williamstown","2006","Williamstown town, MA",159,3847,4006
"8910","Williamstown","Berkshire County","MA","Williamstown","2007","Williamstown town, MA",153,3863,4016
"8911","Williamstown","Berkshire County","MA","Williamstown","2008","Williamstown town, MA",168,3801,3969
"8912","Williamstown","Berkshire County","MA","Williamstown","2009","Williamstown town, MA",259,3747,4006
"8913","Williamstown","Berkshire County","MA","Williamstown","2010","Williamstown town, MA",251,3558,3809
"8914","Williamstown","Berkshire County","MA","Williamstown","2011","Williamstown town, MA",211,3558,3769
"8915","Williamstown","Berkshire County","MA","Williamstown","2012","Williamstown town, MA",194,3512,3706
"8916","Wilmington","Middlesex County","MA","Wilmington","1990","Wilmington town, MA",657,9632,10289
"8917","Wilmington","Middlesex County","MA","Wilmington","1991","Wilmington town, MA",910,9501,10411
"8918","Wilmington","Middlesex County","MA","Wilmington","1992","Wilmington town, MA",1000,9646,10646
"8919","Wilmington","Middlesex County","MA","Wilmington","1993","Wilmington town, MA",726,9888,10614
"8920","Wilmington","Middlesex County","MA","Wilmington","1994","Wilmington town, MA",642,10226,10868
"8921","Wilmington","Middlesex County","MA","Wilmington","1995","Wilmington town, MA",544,10483,11027
"8922","Wilmington","Middlesex County","MA","Wilmington","1996","Wilmington town, MA",505,10867,11372
"8923","Wilmington","Middlesex County","MA","Wilmington","1997","Wilmington town, MA",385,11315,11700
"8924","Wilmington","Middlesex County","MA","Wilmington","1998","Wilmington town, MA",338,11681,12019
"8925","Wilmington","Middlesex County","MA","Wilmington","1999","Wilmington town, MA",320,11884,12204
"8926","Wilmington","Middlesex County","MA","Wilmington","2000","Wilmington town, MA",302,11883,12185
"8927","Wilmington","Middlesex County","MA","Wilmington","2001","Wilmington town, MA",417,11890,12307
"8928","Wilmington","Middlesex County","MA","Wilmington","2002","Wilmington town, MA",611,11701,12312
"8929","Wilmington","Middlesex County","MA","Wilmington","2003","Wilmington town, MA",647,11532,12179
"8930","Wilmington","Middlesex County","MA","Wilmington","2004","Wilmington town, MA",588,11534,12122
"8931","Wilmington","Middlesex County","MA","Wilmington","2005","Wilmington town, MA",505,11604,12109
"8932","Wilmington","Middlesex County","MA","Wilmington","2006","Wilmington town, MA",502,11660,12162
"8933","Wilmington","Middlesex County","MA","Wilmington","2007","Wilmington town, MA",468,11795,12263
"8934","Wilmington","Middlesex County","MA","Wilmington","2008","Wilmington town, MA",565,11820,12385
"8935","Wilmington","Middlesex County","MA","Wilmington","2009","Wilmington town, MA",943,11536,12479
"8936","Wilmington","Middlesex County","MA","Wilmington","2010","Wilmington town, MA",912,11687,12599
"8937","Wilmington","Middlesex County","MA","Wilmington","2011","Wilmington town, MA",769,11858,12627
"8938","Wilmington","Middlesex County","MA","Wilmington","2012","Wilmington town, MA",700,11988,12688
"8939","Winchendon","Worcester County","MA","Winchendon","1990","Winchendon town, MA",352,3997,4349
"8940","Winchendon","Worcester County","MA","Winchendon","1991","Winchendon town, MA",468,3956,4424
"8941","Winchendon","Worcester County","MA","Winchendon","1992","Winchendon town, MA",411,4023,4434
"8942","Winchendon","Worcester County","MA","Winchendon","1993","Winchendon town, MA",287,4129,4416
"8943","Winchendon","Worcester County","MA","Winchendon","1994","Winchendon town, MA",322,4180,4502
"8944","Winchendon","Worcester County","MA","Winchendon","1995","Winchendon town, MA",345,4029,4374
"8945","Winchendon","Worcester County","MA","Winchendon","1996","Winchendon town, MA",256,4011,4267
"8946","Winchendon","Worcester County","MA","Winchendon","1997","Winchendon town, MA",232,4121,4353
"8947","Winchendon","Worcester County","MA","Winchendon","1998","Winchendon town, MA",180,4164,4344
"8948","Winchendon","Worcester County","MA","Winchendon","1999","Winchendon town, MA",174,4213,4387
"8949","Winchendon","Worcester County","MA","Winchendon","2000","Winchendon town, MA",145,4620,4765
"8950","Winchendon","Worcester County","MA","Winchendon","2001","Winchendon town, MA",182,4587,4769
"8951","Winchendon","Worcester County","MA","Winchendon","2002","Winchendon town, MA",320,4593,4913
"8952","Winchendon","Worcester County","MA","Winchendon","2003","Winchendon town, MA",333,4569,4902
"8953","Winchendon","Worcester County","MA","Winchendon","2004","Winchendon town, MA",300,4560,4860
"8954","Winchendon","Worcester County","MA","Winchendon","2005","Winchendon town, MA",313,4540,4853
"8955","Winchendon","Worcester County","MA","Winchendon","2006","Winchendon town, MA",300,4599,4899
"8956","Winchendon","Worcester County","MA","Winchendon","2007","Winchendon town, MA",288,4611,4899
"8957","Winchendon","Worcester County","MA","Winchendon","2008","Winchendon town, MA",352,4564,4916
"8958","Winchendon","Worcester County","MA","Winchendon","2009","Winchendon town, MA",525,4368,4893
"8959","Winchendon","Worcester County","MA","Winchendon","2010","Winchendon town, MA",556,4460,5016
"8960","Winchendon","Worcester County","MA","Winchendon","2011","Winchendon town, MA",509,4458,4967
"8961","Winchendon","Worcester County","MA","Winchendon","2012","Winchendon town, MA",456,4455,4911
"8962","Winchester","Middlesex County","MA","Winchester","1990","Winchester town, MA",396,10560,10956
"8963","Winchester","Middlesex County","MA","Winchester","1991","Winchester town, MA",568,10244,10812
"8964","Winchester","Middlesex County","MA","Winchester","1992","Winchester town, MA",569,10233,10802
"8965","Winchester","Middlesex County","MA","Winchester","1993","Winchester town, MA",456,10389,10845
"8966","Winchester","Middlesex County","MA","Winchester","1994","Winchester town, MA",390,10572,10962
"8967","Winchester","Middlesex County","MA","Winchester","1995","Winchester town, MA",337,10477,10814
"8968","Winchester","Middlesex County","MA","Winchester","1996","Winchester town, MA",263,10674,10937
"8969","Winchester","Middlesex County","MA","Winchester","1997","Winchester town, MA",273,10905,11178
"8970","Winchester","Middlesex County","MA","Winchester","1998","Winchester town, MA",206,11090,11296
"8971","Winchester","Middlesex County","MA","Winchester","1999","Winchester town, MA",203,11220,11423
"8972","Winchester","Middlesex County","MA","Winchester","2000","Winchester town, MA",223,10566,10789
"8973","Winchester","Middlesex County","MA","Winchester","2001","Winchester town, MA",316,10580,10896
"8974","Winchester","Middlesex County","MA","Winchester","2002","Winchester town, MA",468,10412,10880
"8975","Winchester","Middlesex County","MA","Winchester","2003","Winchester town, MA",473,10309,10782
"8976","Winchester","Middlesex County","MA","Winchester","2004","Winchester town, MA",413,10330,10743
"8977","Winchester","Middlesex County","MA","Winchester","2005","Winchester town, MA",351,10445,10796
"8978","Winchester","Middlesex County","MA","Winchester","2006","Winchester town, MA",358,10296,10654
"8979","Winchester","Middlesex County","MA","Winchester","2007","Winchester town, MA",339,10377,10716
"8980","Winchester","Middlesex County","MA","Winchester","2008","Winchester town, MA",395,10371,10766
"8981","Winchester","Middlesex County","MA","Winchester","2009","Winchester town, MA",641,10115,10756
"8982","Winchester","Middlesex County","MA","Winchester","2010","Winchester town, MA",590,10210,10800
"8983","Winchester","Middlesex County","MA","Winchester","2011","Winchester town, MA",542,10359,10901
"8984","Winchester","Middlesex County","MA","Winchester","2012","Winchester town, MA",479,10472,10951
"8985","Windsor","Berkshire County","MA","Windsor","1990","Windsor town, MA",16,397,413
"8986","Windsor","Berkshire County","MA","Windsor","1991","Windsor town, MA",42,390,432
"8987","Windsor","Berkshire County","MA","Windsor","1992","Windsor town, MA",25,433,458
"8988","Windsor","Berkshire County","MA","Windsor","1993","Windsor town, MA",31,459,490
"8989","Windsor","Berkshire County","MA","Windsor","1994","Windsor town, MA",24,496,520
"8990","Windsor","Berkshire County","MA","Windsor","1995","Windsor town, MA",20,464,484
"8991","Windsor","Berkshire County","MA","Windsor","1996","Windsor town, MA",14,449,463
"8992","Windsor","Berkshire County","MA","Windsor","1997","Windsor town, MA",19,452,471
"8993","Windsor","Berkshire County","MA","Windsor","1998","Windsor town, MA",14,471,485
"8994","Windsor","Berkshire County","MA","Windsor","1999","Windsor town, MA",18,509,527
"8995","Windsor","Berkshire County","MA","Windsor","2000","Windsor town, MA",14,478,492
"8996","Windsor","Berkshire County","MA","Windsor","2001","Windsor town, MA",12,476,488
"8997","Windsor","Berkshire County","MA","Windsor","2002","Windsor town, MA",20,481,501
"8998","Windsor","Berkshire County","MA","Windsor","2003","Windsor town, MA",24,478,502
"8999","Windsor","Berkshire County","MA","Windsor","2004","Windsor town, MA",22,478,500
"9000","Windsor","Berkshire County","MA","Windsor","2005","Windsor town, MA",19,488,507
"9001","Windsor","Berkshire County","MA","Windsor","2006","Windsor town, MA",18,497,515
"9002","Windsor","Berkshire County","MA","Windsor","2007","Windsor town, MA",18,499,517
"9003","Windsor","Berkshire County","MA","Windsor","2008","Windsor town, MA",23,489,512
"9004","Windsor","Berkshire County","MA","Windsor","2009","Windsor town, MA",35,489,524
"9005","Windsor","Berkshire County","MA","Windsor","2010","Windsor town, MA",40,488,528
"9006","Windsor","Berkshire County","MA","Windsor","2011","Windsor town, MA",38,492,530
"9007","Windsor","Berkshire County","MA","Windsor","2012","Windsor town, MA",37,490,527
"9008","Winthrop","Suffolk County","MA","Winthrop","1990","Winthrop Town city, MA",512,10007,10519
"9009","Winthrop","Suffolk County","MA","Winthrop","1991","Winthrop Town city, MA",836,9594,10430
"9010","Winthrop","Suffolk County","MA","Winthrop","1992","Winthrop Town city, MA",765,9547,10312
"9011","Winthrop","Suffolk County","MA","Winthrop","1993","Winthrop Town city, MA",669,9607,10276
"9012","Winthrop","Suffolk County","MA","Winthrop","1994","Winthrop Town city, MA",657,9723,10380
"9013","Winthrop","Suffolk County","MA","Winthrop","1995","Winthrop Town city, MA",539,9510,10049
"9014","Winthrop","Suffolk County","MA","Winthrop","1996","Winthrop Town city, MA",370,9619,9989
"9015","Winthrop","Suffolk County","MA","Winthrop","1997","Winthrop Town city, MA",359,9788,10147
"9016","Winthrop","Suffolk County","MA","Winthrop","1998","Winthrop Town city, MA",279,9962,10241
"9017","Winthrop","Suffolk County","MA","Winthrop","1999","Winthrop Town city, MA",298,10015,10313
"9018","Winthrop","Suffolk County","MA","Winthrop","2000","Winthrop Town city, MA",259,9877,10136
"9019","Winthrop","Suffolk County","MA","Winthrop","2001","Winthrop Town city, MA",347,9836,10183
"9020","Winthrop","Suffolk County","MA","Winthrop","2002","Winthrop Town city, MA",527,9586,10113
"9021","Winthrop","Suffolk County","MA","Winthrop","2003","Winthrop Town city, MA",599,9287,9886
"9022","Winthrop","Suffolk County","MA","Winthrop","2004","Winthrop Town city, MA",505,9069,9574
"9023","Winthrop","Suffolk County","MA","Winthrop","2005","Winthrop Town city, MA",458,8970,9428
"9024","Winthrop","Suffolk County","MA","Winthrop","2006","Winthrop Town city, MA",453,9548,10001
"9025","Winthrop","Suffolk County","MA","Winthrop","2007","Winthrop Town city, MA",430,9731,10161
"9026","Winthrop","Suffolk County","MA","Winthrop","2008","Winthrop Town city, MA",502,9656,10158
"9027","Winthrop","Suffolk County","MA","Winthrop","2009","Winthrop Town city, MA",779,9646,10425
"9028","Winthrop","Suffolk County","MA","Winthrop","2010","Winthrop Town city, MA",781,8906,9687
"9029","Winthrop","Suffolk County","MA","Winthrop","2011","Winthrop Town city, MA",662,9067,9729
"9030","Winthrop","Suffolk County","MA","Winthrop","2012","Winthrop Town city, MA",620,9166,9786
"9031","Woburn","Middlesex County","MA","Woburn","1990","Woburn city, MA",1291,20409,21700
"9032","Woburn","Middlesex County","MA","Woburn","1991","Woburn city, MA",1847,19934,21781
"9033","Woburn","Middlesex County","MA","Woburn","1992","Woburn city, MA",1854,19779,21633
"9034","Woburn","Middlesex County","MA","Woburn","1993","Woburn city, MA",1339,20059,21398
"9035","Woburn","Middlesex County","MA","Woburn","1994","Woburn city, MA",1271,20239,21510
"9036","Woburn","Middlesex County","MA","Woburn","1995","Woburn city, MA",1007,20484,21491
"9037","Woburn","Middlesex County","MA","Woburn","1996","Woburn city, MA",848,20914,21762
"9038","Woburn","Middlesex County","MA","Woburn","1997","Woburn city, MA",754,21533,22287
"9039","Woburn","Middlesex County","MA","Woburn","1998","Woburn city, MA",610,22024,22634
"9040","Woburn","Middlesex County","MA","Woburn","1999","Woburn city, MA",613,22285,22898
"9041","Woburn","Middlesex County","MA","Woburn","2000","Woburn city, MA",489,20975,21464
"9042","Woburn","Middlesex County","MA","Woburn","2001","Woburn city, MA",733,20976,21709
"9043","Woburn","Middlesex County","MA","Woburn","2002","Woburn city, MA",1117,20796,21913
"9044","Woburn","Middlesex County","MA","Woburn","2003","Woburn city, MA",1185,20410,21595
"9045","Woburn","Middlesex County","MA","Woburn","2004","Woburn city, MA",1021,20269,21290
"9046","Woburn","Middlesex County","MA","Woburn","2005","Woburn city, MA",933,20319,21252
"9047","Woburn","Middlesex County","MA","Woburn","2006","Woburn city, MA",945,20809,21754
"9048","Woburn","Middlesex County","MA","Woburn","2007","Woburn city, MA",890,20949,21839
"9049","Woburn","Middlesex County","MA","Woburn","2008","Woburn city, MA",1024,20911,21935
"9050","Woburn","Middlesex County","MA","Woburn","2009","Woburn city, MA",1716,20347,22063
"9051","Woburn","Middlesex County","MA","Woburn","2010","Woburn city, MA",1645,20195,21840
"9052","Woburn","Middlesex County","MA","Woburn","2011","Woburn city, MA",1356,20495,21851
"9053","Woburn","Middlesex County","MA","Woburn","2012","Woburn city, MA",1268,20720,21988
"9054","Worcester","Worcester County","MA","Worcester","1990","Worcester city, MA",6164,74802,80966
"9055","Worcester","Worcester County","MA","Worcester","1991","Worcester city, MA",8433,71439,79872
"9056","Worcester","Worcester County","MA","Worcester","1992","Worcester city, MA",7518,70763,78281
"9057","Worcester","Worcester County","MA","Worcester","1993","Worcester city, MA",5818,71979,77797
"9058","Worcester","Worcester County","MA","Worcester","1994","Worcester city, MA",4439,72850,77289
"9059","Worcester","Worcester County","MA","Worcester","1995","Worcester city, MA",4107,73269,77376
"9060","Worcester","Worcester County","MA","Worcester","1996","Worcester city, MA",3538,74077,77615
"9061","Worcester","Worcester County","MA","Worcester","1997","Worcester city, MA",3307,75699,79006
"9062","Worcester","Worcester County","MA","Worcester","1998","Worcester city, MA",2943,76865,79808
"9063","Worcester","Worcester County","MA","Worcester","1999","Worcester city, MA",2985,76208,79193
"9064","Worcester","Worcester County","MA","Worcester","2000","Worcester city, MA",2564,79653,82217
"9065","Worcester","Worcester County","MA","Worcester","2001","Worcester city, MA",3708,79428,83136
"9066","Worcester","Worcester County","MA","Worcester","2002","Worcester city, MA",5168,78882,84050
"9067","Worcester","Worcester County","MA","Worcester","2003","Worcester city, MA",5643,78444,84087
"9068","Worcester","Worcester County","MA","Worcester","2004","Worcester city, MA",5094,78352,83446
"9069","Worcester","Worcester County","MA","Worcester","2005","Worcester city, MA",4797,78076,82873
"9070","Worcester","Worcester County","MA","Worcester","2006","Worcester city, MA",4726,77958,82684
"9071","Worcester","Worcester County","MA","Worcester","2007","Worcester city, MA",4460,77543,82003
"9072","Worcester","Worcester County","MA","Worcester","2008","Worcester city, MA",5394,80007,85401
"9073","Worcester","Worcester County","MA","Worcester","2009","Worcester city, MA",8068,77511,85579
"9074","Worcester","Worcester County","MA","Worcester","2010","Worcester city, MA",8293,76921,85214
"9075","Worcester","Worcester County","MA","Worcester","2011","Worcester city, MA",7561,77590,85151
"9076","Worcester","Worcester County","MA","Worcester","2012","Worcester city, MA",7073,77564,84637
"9077",NA,"Worcester County","MA","Worcester County","1990","Worcester County, MA",25611,339639,365250
"9078",NA,"Worcester County","MA","Worcester County","1991","Worcester County, MA",35398,327667,363065
"9079",NA,"Worcester County","MA","Worcester County","1992","Worcester County, MA",33051,328778,361829
"9080",NA,"Worcester County","MA","Worcester County","1993","Worcester County, MA",26029,336648,362677
"9081",NA,"Worcester County","MA","Worcester County","1994","Worcester County, MA",21042,342166,363208
"9082",NA,"Worcester County","MA","Worcester County","1995","Worcester County, MA",19467,341643,361110
"9083",NA,"Worcester County","MA","Worcester County","1996","Worcester County, MA",16613,346581,363194
"9084",NA,"Worcester County","MA","Worcester County","1997","Worcester County, MA",15038,356561,371599
"9085",NA,"Worcester County","MA","Worcester County","1998","Worcester County, MA",12974,362521,375495
"9086",NA,"Worcester County","MA","Worcester County","1999","Worcester County, MA",12994,363635,376629
"9087",NA,"Worcester County","MA","Worcester County","2000","Worcester County, MA",10753,377187,387940
"9088",NA,"Worcester County","MA","Worcester County","2001","Worcester County, MA",15150,377842,392992
"9089",NA,"Worcester County","MA","Worcester County","2002","Worcester County, MA",22501,376708,399209
"9090",NA,"Worcester County","MA","Worcester County","2003","Worcester County, MA",24795,376222,401017
"9091",NA,"Worcester County","MA","Worcester County","2004","Worcester County, MA",22384,376786,399170
"9092",NA,"Worcester County","MA","Worcester County","2005","Worcester County, MA",20798,377659,398457
"9093",NA,"Worcester County","MA","Worcester County","2006","Worcester County, MA",20548,381515,402063
"9094",NA,"Worcester County","MA","Worcester County","2007","Worcester County, MA",19891,382018,401909
"9095",NA,"Worcester County","MA","Worcester County","2008","Worcester County, MA",23543,380550,404093
"9096",NA,"Worcester County","MA","Worcester County","2009","Worcester County, MA",36276,369837,406113
"9097",NA,"Worcester County","MA","Worcester County","2010","Worcester County, MA",36788,369399,406187
"9098",NA,"Worcester County","MA","Worcester County","2011","Worcester County, MA",32587,371812,404399
"9099",NA,"Worcester County","MA","Worcester County","2012","Worcester County, MA",30197,372043,402240
"9100","Worthington","Hampshire County","MA","Worthington","1990","Worthington town, MA",24,562,586
"9101","Worthington","Hampshire County","MA","Worthington","1991","Worthington town, MA",44,541,585
"9102","Worthington","Hampshire County","MA","Worthington","1992","Worthington town, MA",51,609,660
"9103","Worthington","Hampshire County","MA","Worthington","1993","Worthington town, MA",46,612,658
"9104","Worthington","Hampshire County","MA","Worthington","1994","Worthington town, MA",39,650,689
"9105","Worthington","Hampshire County","MA","Worthington","1995","Worthington town, MA",37,682,719
"9106","Worthington","Hampshire County","MA","Worthington","1996","Worthington town, MA",41,665,706
"9107","Worthington","Hampshire County","MA","Worthington","1997","Worthington town, MA",34,669,703
"9108","Worthington","Hampshire County","MA","Worthington","1998","Worthington town, MA",22,703,725
"9109","Worthington","Hampshire County","MA","Worthington","1999","Worthington town, MA",30,767,797
"9110","Worthington","Hampshire County","MA","Worthington","2000","Worthington town, MA",18,667,685
"9111","Worthington","Hampshire County","MA","Worthington","2001","Worthington town, MA",22,672,694
"9112","Worthington","Hampshire County","MA","Worthington","2002","Worthington town, MA",27,670,697
"9113","Worthington","Hampshire County","MA","Worthington","2003","Worthington town, MA",32,668,700
"9114","Worthington","Hampshire County","MA","Worthington","2004","Worthington town, MA",38,666,704
"9115","Worthington","Hampshire County","MA","Worthington","2005","Worthington town, MA",33,665,698
"9116","Worthington","Hampshire County","MA","Worthington","2006","Worthington town, MA",38,666,704
"9117","Worthington","Hampshire County","MA","Worthington","2007","Worthington town, MA",32,661,693
"9118","Worthington","Hampshire County","MA","Worthington","2008","Worthington town, MA",39,656,695
"9119","Worthington","Hampshire County","MA","Worthington","2009","Worthington town, MA",50,628,678
"9120","Worthington","Hampshire County","MA","Worthington","2010","Worthington town, MA",46,570,616
"9121","Worthington","Hampshire County","MA","Worthington","2011","Worthington town, MA",38,563,601
"9122","Worthington","Hampshire County","MA","Worthington","2012","Worthington town, MA",45,564,609
"9123","Wrentham","Norfolk County","MA","Wrentham","1990","Wrentham town, MA",252,4430,4682
"9124","Wrentham","Norfolk County","MA","Wrentham","1991","Wrentham town, MA",337,4431,4768
"9125","Wrentham","Norfolk County","MA","Wrentham","1992","Wrentham town, MA",361,4473,4834
"9126","Wrentham","Norfolk County","MA","Wrentham","1993","Wrentham town, MA",311,4609,4920
"9127","Wrentham","Norfolk County","MA","Wrentham","1994","Wrentham town, MA",236,4880,5116
"9128","Wrentham","Norfolk County","MA","Wrentham","1995","Wrentham town, MA",214,4801,5015
"9129","Wrentham","Norfolk County","MA","Wrentham","1996","Wrentham town, MA",208,4942,5150
"9130","Wrentham","Norfolk County","MA","Wrentham","1997","Wrentham town, MA",154,5104,5258
"9131","Wrentham","Norfolk County","MA","Wrentham","1998","Wrentham town, MA",145,5215,5360
"9132","Wrentham","Norfolk County","MA","Wrentham","1999","Wrentham town, MA",158,5336,5494
"9133","Wrentham","Norfolk County","MA","Wrentham","2000","Wrentham town, MA",126,5461,5587
"9134","Wrentham","Norfolk County","MA","Wrentham","2001","Wrentham town, MA",173,5551,5724
"9135","Wrentham","Norfolk County","MA","Wrentham","2002","Wrentham town, MA",261,5508,5769
"9136","Wrentham","Norfolk County","MA","Wrentham","2003","Wrentham town, MA",307,5473,5780
"9137","Wrentham","Norfolk County","MA","Wrentham","2004","Wrentham town, MA",279,5499,5778
"9138","Wrentham","Norfolk County","MA","Wrentham","2005","Wrentham town, MA",248,5559,5807
"9139","Wrentham","Norfolk County","MA","Wrentham","2006","Wrentham town, MA",255,5474,5729
"9140","Wrentham","Norfolk County","MA","Wrentham","2007","Wrentham town, MA",229,5529,5758
"9141","Wrentham","Norfolk County","MA","Wrentham","2008","Wrentham town, MA",289,5541,5830
"9142","Wrentham","Norfolk County","MA","Wrentham","2009","Wrentham town, MA",435,5364,5799
"9143","Wrentham","Norfolk County","MA","Wrentham","2010","Wrentham town, MA",443,5318,5761
"9144","Wrentham","Norfolk County","MA","Wrentham","2011","Wrentham town, MA",386,5375,5761
"9145","Wrentham","Norfolk County","MA","Wrentham","2012","Wrentham town, MA",339,5434,5773
"9146","Yarmouth","Barnstable County","MA","Yarmouth","1990","Yarmouth town, MA",676,9369,10045
"9147","Yarmouth","Barnstable County","MA","Yarmouth","1991","Yarmouth town, MA",958,9015,9973
"9148","Yarmouth","Barnstable County","MA","Yarmouth","1992","Yarmouth town, MA",1097,8891,9988
"9149","Yarmouth","Barnstable County","MA","Yarmouth","1993","Yarmouth town, MA",996,9126,10122
"9150","Yarmouth","Barnstable County","MA","Yarmouth","1994","Yarmouth town, MA",913,9250,10163
"9151","Yarmouth","Barnstable County","MA","Yarmouth","1995","Yarmouth town, MA",780,9610,10390
"9152","Yarmouth","Barnstable County","MA","Yarmouth","1996","Yarmouth town, MA",634,9812,10446
"9153","Yarmouth","Barnstable County","MA","Yarmouth","1997","Yarmouth town, MA",605,9906,10511
"9154","Yarmouth","Barnstable County","MA","Yarmouth","1998","Yarmouth town, MA",520,10041,10561
"9155","Yarmouth","Barnstable County","MA","Yarmouth","1999","Yarmouth town, MA",468,10407,10875
"9156","Yarmouth","Barnstable County","MA","Yarmouth","2000","Yarmouth town, MA",405,11246,11651
"9157","Yarmouth","Barnstable County","MA","Yarmouth","2001","Yarmouth town, MA",478,11317,11795
"9158","Yarmouth","Barnstable County","MA","Yarmouth","2002","Yarmouth town, MA",590,11489,12079
"9159","Yarmouth","Barnstable County","MA","Yarmouth","2003","Yarmouth town, MA",696,11653,12349
"9160","Yarmouth","Barnstable County","MA","Yarmouth","2004","Yarmouth town, MA",657,11714,12371
"9161","Yarmouth","Barnstable County","MA","Yarmouth","2005","Yarmouth town, MA",636,11617,12253
"9162","Yarmouth","Barnstable County","MA","Yarmouth","2006","Yarmouth town, MA",668,11602,12270
"9163","Yarmouth","Barnstable County","MA","Yarmouth","2007","Yarmouth town, MA",651,11504,12155
"9164","Yarmouth","Barnstable County","MA","Yarmouth","2008","Yarmouth town, MA",829,11378,12207
"9165","Yarmouth","Barnstable County","MA","Yarmouth","2009","Yarmouth town, MA",1186,11094,12280
"9166","Yarmouth","Barnstable County","MA","Yarmouth","2010","Yarmouth town, MA",1243,11227,12470
"9167","Yarmouth","Barnstable County","MA","Yarmouth","2011","Yarmouth town, MA",1112,11208,12320
"9168","Yarmouth","Barnstable County","MA","Yarmouth","2012","Yarmouth town, MA",1003,11396,12399
