"","Municipal","County","State","Region","Year","No.Unemployed.Avg","No.Employed.Avg","No.Labor.Avg"
"1",NA,"NA County County",NA,"NA County County",1990,906,21944,22850
"2",NA,"NA County County",NA,"NA County County",1991,1000,20738,21738
"3",NA,"NA County County",NA,"NA County County",1992,806,20825,21631
"4",NA,"NA County County",NA,"NA County County",1993,660,21315,21975
"5",NA,"NA County County",NA,"NA County County",1994,581,21644,22225
"6",NA,"NA County County",NA,"NA County County",1995,523,21789,22312
"7",NA,"NA County County",NA,"NA County County",1996,450,22109,22559
"8",NA,"NA County County",NA,"NA County County",1997,417,22601,23018
"9",NA,"NA County County",NA,"NA County County",1998,402,23320,23722
"10",NA,"NA County County",NA,"NA County County",1999,381,23500,23881
"11",NA,"NA County County",NA,"NA County County",2000,453,22884,23337
"12",NA,"NA County County",NA,"NA County County",2001,513,22960,23473
"13",NA,"NA County County",NA,"NA County County",2002,649,22971,23620
"14",NA,"NA County County",NA,"NA County County",2003,795,23247,24042
"15",NA,"NA County County",NA,"NA County County",2004,792,23358,24150
"16",NA,"NA County County",NA,"NA County County",2005,817,23300,24117
"17",NA,"NA County County",NA,"NA County County",2006,798,23563,24361
"18",NA,"NA County County",NA,"NA County County",2007,760,23736,24496
"19",NA,"NA County County",NA,"NA County County",2008,927,23582,24509
"20",NA,"NA County County",NA,"NA County County",2009,1238,23303,24541
"21",NA,"NA County County",NA,"NA County County",2010,1346,23360,24706
"22",NA,"NA County County",NA,"NA County County",2011,1196,23516,24712
"23",NA,"NA County County",NA,"NA County County",2012,1117,23727,24844
"24",NA,"NA County County",NA,"NA County County",1990,937,9205,10142
"25",NA,"NA County County",NA,"NA County County",1991,1360,8742,10102
"26",NA,"NA County County",NA,"NA County County",1992,1284,8693,9977
"27",NA,"NA County County",NA,"NA County County",1993,976,8874,9850
"28",NA,"NA County County",NA,"NA County County",1994,813,8804,9617
"29",NA,"NA County County",NA,"NA County County",1995,672,8647,9319
"30",NA,"NA County County",NA,"NA County County",1996,573,8569,9142
"31",NA,"NA County County",NA,"NA County County",1997,593,8701,9294
"32",NA,"NA County County",NA,"NA County County",1998,492,8763,9255
"33",NA,"NA County County",NA,"NA County County",1999,446,8731,9177
"34",NA,"NA County County",NA,"NA County County",2000,321,10460,10781
"35",NA,"NA County County",NA,"NA County County",2001,446,10261,10707
"36",NA,"NA County County",NA,"NA County County",2002,583,10294,10877
"37",NA,"NA County County",NA,"NA County County",2003,688,10178,10866
"38",NA,"NA County County",NA,"NA County County",2004,643,10038,10681
"39",NA,"NA County County",NA,"NA County County",2005,598,10002,10600
"40",NA,"NA County County",NA,"NA County County",2006,589,9968,10557
"41",NA,"NA County County",NA,"NA County County",2007,599,9896,10495
"42",NA,"NA County County",NA,"NA County County",2008,715,9941,10656
"43",NA,"NA County County",NA,"NA County County",2009,1120,9614,10734
"44",NA,"NA County County",NA,"NA County County",2010,1139,9427,10566
"45",NA,"NA County County",NA,"NA County County",2011,971,9410,10381
"46",NA,"NA County County",NA,"NA County County",2012,903,9441,10344
"47",NA,"NA County County",NA,"NA County County",1990,7526,98177,105703
"48",NA,"NA County County",NA,"NA County County",1991,10516,95388,105904
"49",NA,"NA County County",NA,"NA County County",1992,10853,94815,105668
"50",NA,"NA County County",NA,"NA County County",1993,9550,98352,107902
"51",NA,"NA County County",NA,"NA County County",1994,8615,100723,109338
"52",NA,"NA County County",NA,"NA County County",1995,7330,102940,110270
"53",NA,"NA County County",NA,"NA County County",1996,6373,105366,111739
"54",NA,"NA County County",NA,"NA County County",1997,6126,107632,113758
"55",NA,"NA County County",NA,"NA County County",1998,5205,109894,115099
"56",NA,"NA County County",NA,"NA County County",1999,4650,113383,118033
"57",NA,"NA County County",NA,"NA County County",2000,3988,121133,125121
"58",NA,"NA County County",NA,"NA County County",2001,4628,122595,127223
"59",NA,"NA County County",NA,"NA County County",2002,5934,125112,131046
"60",NA,"NA County County",NA,"NA County County",2003,6836,127730,134566
"61",NA,"NA County County",NA,"NA County County",2004,6592,129091,135683
"62",NA,"NA County County",NA,"NA County County",2005,6371,128771,135142
"63",NA,"NA County County",NA,"NA County County",2006,6457,129143,135600
"64",NA,"NA County County",NA,"NA County County",2007,6252,128402,134654
"65",NA,"NA County County",NA,"NA County County",2008,7717,127660,135377
"66",NA,"NA County County",NA,"NA County County",2009,11204,124237,135441
"67",NA,"NA County County",NA,"NA County County",2010,11796,123695,135491
"68",NA,"NA County County",NA,"NA County County",2011,10595,123577,134172
"69",NA,"NA County County",NA,"NA County County",2012,9645,125650,135295
"70",NA,"NA County County",NA,"NA County County",1990,77622,1383193,1460815
"71",NA,"NA County County",NA,"NA County County",1991,106130,1334082,1440212
"72",NA,"NA County County",NA,"NA County County",1992,107991,1323256,1431247
"73",NA,"NA County County",NA,"NA County County",1993,87901,1338468,1426369
"74",NA,"NA County County",NA,"NA County County",1994,75206,1359901,1435107
"75",NA,"NA County County",NA,"NA County County",1995,67337,1384396,1451733
"76",NA,"NA County County",NA,"NA County County",1996,55671,1411124,1466795
"77",NA,"NA County County",NA,"NA County County",1997,50450,1442867,1493317
"78",NA,"NA County County",NA,"NA County County",1998,41372,1465073,1506445
"79",NA,"NA County County",NA,"NA County County",1999,40765,1479464,1520229
"80",NA,"NA County County",NA,"NA County County",2000,36669,1467251,1503920
"81",NA,"NA County County",NA,"NA County County",2001,51299,1465870,1517169
"82",NA,"NA County County",NA,"NA County County",2002,74993,1438923,1513916
"83",NA,"NA County County",NA,"NA County County",2003,81151,1412958,1494109
"84",NA,"NA County County",NA,"NA County County",2004,70241,1406190,1476431
"85",NA,"NA County County",NA,"NA County County",2005,64003,1413553,1477556
"86",NA,"NA County County",NA,"NA County County",2006,63500,1433097,1496597
"87",NA,"NA County County",NA,"NA County County",2007,59509,1451617,1511126
"88",NA,"NA County County",NA,"NA County County",2008,71612,1460175,1531787
"89",NA,"NA County County",NA,"NA County County",2009,109995,1421519,1531514
"90",NA,"NA County County",NA,"NA County County",2010,110343,1424563,1534906
"91",NA,"NA County County",NA,"NA County County",2011,95180,1443769,1538949
"92",NA,"NA County County",NA,"NA County County",2012,86859,1459579,1546438
"93",NA,"NA County County",NA,"NA County County",1990,137570,2212947,2350517
"94",NA,"NA County County",NA,"NA County County",1991,186312,2133160,2319472
"95",NA,"NA County County",NA,"NA County County",1992,191622,2119559,2311181
"96",NA,"NA County County",NA,"NA County County",1993,157199,2147283,2304482
"97",NA,"NA County County",NA,"NA County County",1994,132675,2185249,2317924
"98",NA,"NA County County",NA,"NA County County",1995,116263,2223571,2339834
"99",NA,"NA County County",NA,"NA County County",1996,97804,2273234,2371038
"100",NA,"NA County County",NA,"NA County County",1997,88674,2332775,2421449
"101",NA,"NA County County",NA,"NA County County",1998,74741,2374683,2449424
"102",NA,"NA County County",NA,"NA County County",1999,74114,2415208,2489322
"103",NA,"NA County County",NA,"NA County County",2000,63073,2398503,2461576
"104",NA,"NA County County",NA,"NA County County",2001,89508,2401266,2490774
"105",NA,"NA County County",NA,"NA County County",2002,131516,2362303,2493819
"106",NA,"NA County County",NA,"NA County County",2003,140199,2327684,2467883
"107",NA,"NA County County",NA,"NA County County",2004,122039,2323266,2445305
"108",NA,"NA County County",NA,"NA County County",2005,111080,2340282,2451362
"109",NA,"NA County County",NA,"NA County County",2006,109357,2369185,2478542
"110",NA,"NA County County",NA,"NA County County",2007,103296,2394508,2497804
"111",NA,"NA County County",NA,"NA County County",2008,123525,2402597,2526122
"112",NA,"NA County County",NA,"NA County County",2009,191132,2338517,2529649
"113",NA,"NA County County",NA,"NA County County",2010,191585,2343974,2535559
"114",NA,"NA County County",NA,"NA County County",2011,167089,2371219,2538308
"115",NA,"NA County County",NA,"NA County County",2012,155041,2395537,2550578
"116",NA,"NA County County",NA,"NA County County",1990,169482,2662698,2832180
"117",NA,"NA County County",NA,"NA County County",1991,229633,2565113,2794746
"118",NA,"NA County County",NA,"NA County County",1992,232555,2552531,2785086
"119",NA,"NA County County",NA,"NA County County",1993,189356,2589582,2778938
"120",NA,"NA County County",NA,"NA County County",1994,158890,2633914,2792804
"121",NA,"NA County County",NA,"NA County County",1995,140102,2677357,2817459
"122",NA,"NA County County",NA,"NA County County",1996,118695,2733530,2852225
"123",NA,"NA County County",NA,"NA County County",1997,107627,2805429,2913056
"124",NA,"NA County County",NA,"NA County County",1998,91008,2855530,2946538
"125",NA,"NA County County",NA,"NA County County",1999,89871,2898956,2988827
"126",NA,"NA County County",NA,"NA County County",2000,77009,2899702,2976711
"127",NA,"NA County County",NA,"NA County County",2001,108673,2904697,3013370
"128",NA,"NA County County",NA,"NA County County",2002,159145,2865234,3024379
"129",NA,"NA County County",NA,"NA County County",2003,170616,2831883,3002499
"130",NA,"NA County County",NA,"NA County County",2004,149360,2830463,2979823
"131",NA,"NA County County",NA,"NA County County",2005,136925,2849548,2986473
"132",NA,"NA County County",NA,"NA County County",2006,134816,2884309,3019125
"133",NA,"NA County County",NA,"NA County County",2007,128263,2912019,3040282
"134",NA,"NA County County",NA,"NA County County",2008,152819,2918342,3071161
"135",NA,"NA County County",NA,"NA County County",2009,236333,2840706,3077039
"136",NA,"NA County County",NA,"NA County County",2010,237692,2845407,3083099
"137",NA,"NA County County",NA,"NA County County",2011,208064,2875698,3083762
"138",NA,"NA County County",NA,"NA County County",2012,193884,2900493,3094377
"139",NA,"NA County County",NA,"NA County County",1990,9261,105913,115174
"140",NA,"NA County County",NA,"NA County County",1991,13136,100939,114075
"141",NA,"NA County County",NA,"NA County County",1992,12752,99337,112089
"142",NA,"NA County County",NA,"NA County County",1993,9958,102778,112736
"143",NA,"NA County County",NA,"NA County County",1994,8245,108487,116732
"144",NA,"NA County County",NA,"NA County County",1995,7297,111799,119096
"145",NA,"NA County County",NA,"NA County County",1996,6653,112806,119459
"146",NA,"NA County County",NA,"NA County County",1997,5866,116575,122441
"147",NA,"NA County County",NA,"NA County County",1998,4666,117853,122519
"148",NA,"NA County County",NA,"NA County County",1999,4499,119924,124423
"149",NA,"NA County County",NA,"NA County County",2000,3517,119720,123237
"150",NA,"NA County County",NA,"NA County County",2001,4682,119483,124165
"151",NA,"NA County County",NA,"NA County County",2002,6594,118595,125189
"152",NA,"NA County County",NA,"NA County County",2003,7498,116514,124012
"153",NA,"NA County County",NA,"NA County County",2004,7043,116526,123569
"154",NA,"NA County County",NA,"NA County County",2005,6545,116934,123479
"155",NA,"NA County County",NA,"NA County County",2006,6592,118348,124940
"156",NA,"NA County County",NA,"NA County County",2007,6388,119127,125515
"157",NA,"NA County County",NA,"NA County County",2008,7621,118751,126372
"158",NA,"NA County County",NA,"NA County County",2009,11586,115827,127413
"159",NA,"NA County County",NA,"NA County County",2010,12219,116020,128239
"160",NA,"NA County County",NA,"NA County County",2011,10823,117048,127871
"161",NA,"NA County County",NA,"NA County County",2012,9752,118085,127837
"162",NA,"NA County County","MA","NA County County",1990,69,907,976
"163",NA,"NA County County","MA","NA County County",1991,84,884,968
"164",NA,"NA County County","MA","NA County County",1992,97,881,978
"165",NA,"NA County County","MA","NA County County",1993,90,879,969
"166",NA,"NA County County","MA","NA County County",1994,77,885,962
"167",NA,"NA County County","MA","NA County County",1995,57,927,984
"168",NA,"NA County County","MA","NA County County",1996,54,929,983
"169",NA,"NA County County","MA","NA County County",1997,54,948,1002
"170",NA,"NA County County","MA","NA County County",1998,47,963,1010
"171",NA,"NA County County","MA","NA County County",1999,44,980,1024
"172",NA,"NA County County","MA","NA County County",2000,34,1106,1140
"173",NA,"NA County County","MA","NA County County",2001,36,1113,1149
"174",NA,"NA County County","MA","NA County County",2002,53,1126,1179
"175",NA,"NA County County","MA","NA County County",2003,64,1129,1193
"176",NA,"NA County County","MA","NA County County",2004,55,1115,1170
"177",NA,"NA County County","MA","NA County County",2005,49,1108,1157
"178",NA,"NA County County","MA","NA County County",2006,47,1109,1156
"179",NA,"NA County County","MA","NA County County",2007,55,1092,1147
"180",NA,"NA County County","MA","NA County County",2008,54,1081,1135
"181",NA,"NA County County","MA","NA County County",2009,83,1054,1137
"182",NA,"NA County County","MA","NA County County",2010,82,1030,1112
"183",NA,"NA County County","MA","NA County County",2011,74,1034,1108
"184",NA,"NA County County","MA","NA County County",2012,69,1036,1105
"185",NA,"NA County County",NA,"NA County County",1990,7320,126251,133571
"186",NA,"NA County County",NA,"NA County County",1991,9843,122331,132174
"187",NA,"NA County County",NA,"NA County County",1992,9975,121582,131557
"188",NA,"NA County County",NA,"NA County County",1993,7807,123705,131512
"189",NA,"NA County County",NA,"NA County County",1994,6720,126494,133214
"190",NA,"NA County County",NA,"NA County County",1995,6074,127713,133787
"191",NA,"NA County County",NA,"NA County County",1996,4847,130712,135559
"192",NA,"NA County County",NA,"NA County County",1997,4318,134593,138911
"193",NA,"NA County County",NA,"NA County County",1998,3539,137559,141098
"194",NA,"NA County County",NA,"NA County County",1999,3716,139680,143396
"195",NA,"NA County County",NA,"NA County County",2000,3159,139373,142532
"196",NA,"NA County County",NA,"NA County County",2001,4510,140650,145160
"197",NA,"NA County County",NA,"NA County County",2002,7103,137990,145093
"198",NA,"NA County County",NA,"NA County County",2003,7409,135776,143185
"199",NA,"NA County County",NA,"NA County County",2004,6163,136645,142808
"200",NA,"NA County County",NA,"NA County County",2005,5549,138549,144098
"201",NA,"NA County County",NA,"NA County County",2006,5543,139974,145517
"202",NA,"NA County County",NA,"NA County County",2007,5208,141797,147005
"203",NA,"NA County County",NA,"NA County County",2008,6294,143161,149455
"204",NA,"NA County County",NA,"NA County County",2009,9853,138950,148803
"205",NA,"NA County County",NA,"NA County County",2010,9689,138980,148669
"206",NA,"NA County County",NA,"NA County County",2011,8216,140107,148323
"207",NA,"NA County County",NA,"NA County County",2012,7648,141387,149035
"208",NA,"NA County County","MA","NA County County",1990,715,12843,13558
"209",NA,"NA County County","MA","NA County County",1991,1047,12422,13469
"210",NA,"NA County County","MA","NA County County",1992,1136,12371,13507
"211",NA,"NA County County","MA","NA County County",1993,945,12758,13703
"212",NA,"NA County County","MA","NA County County",1994,819,12789,13608
"213",NA,"NA County County","MA","NA County County",1995,731,13278,14009
"214",NA,"NA County County","MA","NA County County",1996,578,13549,14127
"215",NA,"NA County County","MA","NA County County",1997,525,13792,14317
"216",NA,"NA County County","MA","NA County County",1998,416,13762,14178
"217",NA,"NA County County","MA","NA County County",1999,392,13733,14125
"218",NA,"NA County County","MA","NA County County",2000,362,15094,15456
"219",NA,"NA County County","MA","NA County County",2001,417,15617,16034
"220",NA,"NA County County","MA","NA County County",2002,572,16065,16637
"221",NA,"NA County County","MA","NA County County",2003,664,16082,16746
"222",NA,"NA County County","MA","NA County County",2004,618,16003,16621
"223",NA,"NA County County","MA","NA County County",2005,566,16349,16915
"224",NA,"NA County County","MA","NA County County",2006,606,16481,17087
"225",NA,"NA County County","MA","NA County County",2007,593,16128,16721
"226",NA,"NA County County","MA","NA County County",2008,726,16100,16826
"227",NA,"NA County County","MA","NA County County",2009,1054,15604,16658
"228",NA,"NA County County","MA","NA County County",2010,1078,15639,16717
"229",NA,"NA County County","MA","NA County County",2011,918,15727,16645
"230",NA,"NA County County","MA","NA County County",2012,843,15597,16440
"231",NA,"NA County County",NA,"NA County County",1990,1081,20464,21545
"232",NA,"NA County County",NA,"NA County County",1991,1711,20292,22003
"233",NA,"NA County County",NA,"NA County County",1992,1737,19690,21427
"234",NA,"NA County County",NA,"NA County County",1993,1342,19685,21027
"235",NA,"NA County County",NA,"NA County County",1994,1124,20299,21423
"236",NA,"NA County County",NA,"NA County County",1995,1103,20724,21827
"237",NA,"NA County County",NA,"NA County County",1996,903,20795,21698
"238",NA,"NA County County",NA,"NA County County",1997,878,21231,22109
"239",NA,"NA County County",NA,"NA County County",1998,769,21585,22354
"240",NA,"NA County County",NA,"NA County County",1999,703,21956,22659
"241",NA,"NA County County",NA,"NA County County",2000,580,21662,22242
"242",NA,"NA County County",NA,"NA County County",2001,726,21577,22303
"243",NA,"NA County County",NA,"NA County County",2002,964,21852,22816
"244",NA,"NA County County",NA,"NA County County",2003,1066,21891,22957
"245",NA,"NA County County",NA,"NA County County",2004,1007,21532,22539
"246",NA,"NA County County",NA,"NA County County",2005,1021,21485,22506
"247",NA,"NA County County",NA,"NA County County",2006,1028,21539,22567
"248",NA,"NA County County",NA,"NA County County",2007,976,21187,22163
"249",NA,"NA County County",NA,"NA County County",2008,1174,20960,22134
"250",NA,"NA County County",NA,"NA County County",2009,1774,20334,22108
"251",NA,"NA County County",NA,"NA County County",2010,1800,20430,22230
"252",NA,"NA County County",NA,"NA County County",2011,1535,20461,21996
"253",NA,"NA County County",NA,"NA County County",2012,1431,20517,21948
"254",NA,"NA County County",NA,"NA County County",1990,7077,95707,102784
"255",NA,"NA County County",NA,"NA County County",1991,9207,94018,103225
"256",NA,"NA County County",NA,"NA County County",1992,9571,95315,104886
"257",NA,"NA County County",NA,"NA County County",1993,8404,97859,106263
"258",NA,"NA County County",NA,"NA County County",1994,6863,100387,107250
"259",NA,"NA County County",NA,"NA County County",1995,5768,101152,106920
"260",NA,"NA County County",NA,"NA County County",1996,5163,104898,110061
"261",NA,"NA County County",NA,"NA County County",1997,4985,107697,112682
"262",NA,"NA County County",NA,"NA County County",1998,4417,111568,115985
"263",NA,"NA County County",NA,"NA County County",1999,4264,117063,121327
"264",NA,"NA County County",NA,"NA County County",2000,3288,117462,120750
"265",NA,"NA County County",NA,"NA County County",2001,4782,117411,122193
"266",NA,"NA County County",NA,"NA County County",2002,7067,114905,121972
"267",NA,"NA County County",NA,"NA County County",2003,7015,112648,119663
"268",NA,"NA County County",NA,"NA County County",2004,6256,112332,118588
"269",NA,"NA County County",NA,"NA County County",2005,5615,113604,119219
"270",NA,"NA County County",NA,"NA County County",2006,5360,115277,120637
"271",NA,"NA County County",NA,"NA County County",2007,5191,116075,121266
"272",NA,"NA County County",NA,"NA County County",2008,6334,115628,121962
"273",NA,"NA County County",NA,"NA County County",2009,9702,113225,122927
"274",NA,"NA County County",NA,"NA County County",2010,9559,114572,124131
"275",NA,"NA County County",NA,"NA County County",2011,8487,115962,124449
"276",NA,"NA County County",NA,"NA County County",2012,8232,117486,125718
"277",NA,"NA County County",NA,"NA County County",1990,3979,57550,61529
"278",NA,"NA County County",NA,"NA County County",1991,5501,56717,62218
"279",NA,"NA County County",NA,"NA County County",1992,5370,57536,62906
"280",NA,"NA County County",NA,"NA County County",1993,4779,59041,63820
"281",NA,"NA County County",NA,"NA County County",1994,4162,60762,64924
"282",NA,"NA County County",NA,"NA County County",1995,3492,60956,64448
"283",NA,"NA County County",NA,"NA County County",1996,2937,63185,66122
"284",NA,"NA County County",NA,"NA County County",1997,2980,64538,67518
"285",NA,"NA County County",NA,"NA County County",1998,2523,67213,69736
"286",NA,"NA County County",NA,"NA County County",1999,2438,68898,71336
"287",NA,"NA County County",NA,"NA County County",2000,1780,70309,72089
"288",NA,"NA County County",NA,"NA County County",2001,2720,69978,72698
"289",NA,"NA County County",NA,"NA County County",2002,4090,68087,72177
"290",NA,"NA County County",NA,"NA County County",2003,4186,66911,71097
"291",NA,"NA County County",NA,"NA County County",2004,3669,66452,70121
"292",NA,"NA County County",NA,"NA County County",2005,3369,66985,70354
"293",NA,"NA County County",NA,"NA County County",2006,3258,67737,70995
"294",NA,"NA County County",NA,"NA County County",2007,3079,68002,71081
"295",NA,"NA County County",NA,"NA County County",2008,3789,68052,71841
"296",NA,"NA County County",NA,"NA County County",2009,5984,66523,72507
"297",NA,"NA County County",NA,"NA County County",2010,6018,66749,72767
"298",NA,"NA County County",NA,"NA County County",2011,5188,67604,72792
"299",NA,"NA County County",NA,"NA County County",2012,4721,68492,73213
"300",NA,"NA County County",NA,"NA County County",1990,6139,57718,63857
"301",NA,"NA County County",NA,"NA County County",1991,7724,55604,63328
"302",NA,"NA County County",NA,"NA County County",1992,7969,55364,63333
"303",NA,"NA County County",NA,"NA County County",1993,7598,55614,63212
"304",NA,"NA County County",NA,"NA County County",1994,6495,56085,62580
"305",NA,"NA County County",NA,"NA County County",1995,5466,59073,64539
"306",NA,"NA County County",NA,"NA County County",1996,5184,60696,65880
"307",NA,"NA County County",NA,"NA County County",1997,4698,61507,66205
"308",NA,"NA County County",NA,"NA County County",1998,4473,62618,67091
"309",NA,"NA County County",NA,"NA County County",1999,4294,66051,70345
"310",NA,"NA County County",NA,"NA County County",2000,2988,64454,67442
"311",NA,"NA County County",NA,"NA County County",2001,4530,64649,69179
"312",NA,"NA County County",NA,"NA County County",2002,6639,63918,70557
"313",NA,"NA County County",NA,"NA County County",2003,6664,63674,70338
"314",NA,"NA County County",NA,"NA County County",2004,5943,63895,69838
"315",NA,"NA County County",NA,"NA County County",2005,5295,64245,69540
"316",NA,"NA County County",NA,"NA County County",2006,4996,64768,69764
"317",NA,"NA County County",NA,"NA County County",2007,4744,65285,70029
"318",NA,"NA County County",NA,"NA County County",2008,5652,64951,70603
"319",NA,"NA County County",NA,"NA County County",2009,8640,63132,71772
"320",NA,"NA County County",NA,"NA County County",2010,8905,64116,73021
"321",NA,"NA County County",NA,"NA County County",2011,8473,65353,73826
"322",NA,"NA County County",NA,"NA County County",2012,8160,66251,74411
"323",NA,"NA County County",NA,"NA County County",1990,4831,43173,48004
"324",NA,"NA County County",NA,"NA County County",1991,6305,41772,48077
"325",NA,"NA County County",NA,"NA County County",1992,6187,41354,47541
"326",NA,"NA County County",NA,"NA County County",1993,5773,41372,47145
"327",NA,"NA County County",NA,"NA County County",1994,5174,41433,46607
"328",NA,"NA County County",NA,"NA County County",1995,4380,44176,48556
"329",NA,"NA County County",NA,"NA County County",1996,4122,45222,49344
"330",NA,"NA County County",NA,"NA County County",1997,3788,45722,49510
"331",NA,"NA County County",NA,"NA County County",1998,3560,46502,50062
"332",NA,"NA County County",NA,"NA County County",1999,3479,47642,51121
"333",NA,"NA County County",NA,"NA County County",2000,2315,48532,50847
"334",NA,"NA County County",NA,"NA County County",2001,3629,48550,52179
"335",NA,"NA County County",NA,"NA County County",2002,5391,47851,53242
"336",NA,"NA County County",NA,"NA County County",2003,5442,47741,53183
"337",NA,"NA County County",NA,"NA County County",2004,4827,47714,52541
"338",NA,"NA County County",NA,"NA County County",2005,4323,47830,52153
"339",NA,"NA County County",NA,"NA County County",2006,4143,48046,52189
"340",NA,"NA County County",NA,"NA County County",2007,3864,48276,52140
"341",NA,"NA County County",NA,"NA County County",2008,4688,48069,52757
"342",NA,"NA County County",NA,"NA County County",2009,7219,46760,53979
"343",NA,"NA County County",NA,"NA County County",2010,7517,48568,56085
"344",NA,"NA County County",NA,"NA County County",2011,7198,49524,56722
"345",NA,"NA County County",NA,"NA County County",2012,6737,50204,56941
"346",NA,"NA County County",NA,"NA County County",1990,5923,65491,71414
"347",NA,"NA County County",NA,"NA County County",1991,7656,63184,70840
"348",NA,"NA County County",NA,"NA County County",1992,6729,63812,70541
"349",NA,"NA County County",NA,"NA County County",1993,5277,64688,69965
"350",NA,"NA County County",NA,"NA County County",1994,4838,64819,69657
"351",NA,"NA County County",NA,"NA County County",1995,4512,66003,70515
"352",NA,"NA County County",NA,"NA County County",1996,4010,65950,69960
"353",NA,"NA County County",NA,"NA County County",1997,3601,67580,71181
"354",NA,"NA County County",NA,"NA County County",1998,2889,67510,70399
"355",NA,"NA County County",NA,"NA County County",1999,2977,67559,70536
"356",NA,"NA County County",NA,"NA County County",2000,2313,70426,72739
"357",NA,"NA County County",NA,"NA County County",2001,3222,69703,72925
"358",NA,"NA County County",NA,"NA County County",2002,4789,69316,74105
"359",NA,"NA County County",NA,"NA County County",2003,5208,68871,74079
"360",NA,"NA County County",NA,"NA County County",2004,4791,68529,73320
"361",NA,"NA County County",NA,"NA County County",2005,4626,67974,72600
"362",NA,"NA County County",NA,"NA County County",2006,4425,68560,72985
"363",NA,"NA County County",NA,"NA County County",2007,4168,68441,72609
"364",NA,"NA County County",NA,"NA County County",2008,4949,67727,72676
"365",NA,"NA County County",NA,"NA County County",2009,7634,65728,73362
"366",NA,"NA County County",NA,"NA County County",2010,7823,65240,73063
"367",NA,"NA County County",NA,"NA County County",2011,7121,65212,72333
"368",NA,"NA County County",NA,"NA County County",2012,6495,65165,71660
"369",NA,"NA County County",NA,"NA County County",1990,10664,138800,149464
"370",NA,"NA County County",NA,"NA County County",1991,14583,133433,148016
"371",NA,"NA County County",NA,"NA County County",1992,15674,132468,148142
"372",NA,"NA County County",NA,"NA County County",1993,12810,132403,145213
"373",NA,"NA County County",NA,"NA County County",1994,10181,133382,143563
"374",NA,"NA County County",NA,"NA County County",1995,8346,135976,144322
"375",NA,"NA County County",NA,"NA County County",1996,6523,140914,147437
"376",NA,"NA County County",NA,"NA County County",1997,6167,146928,153095
"377",NA,"NA County County",NA,"NA County County",1998,5421,150855,156276
"378",NA,"NA County County",NA,"NA County County",1999,5553,155548,161101
"379",NA,"NA County County",NA,"NA County County",2000,4012,147079,151091
"380",NA,"NA County County",NA,"NA County County",2001,6323,147843,154166
"381",NA,"NA County County",NA,"NA County County",2002,9874,145211,155085
"382",NA,"NA County County",NA,"NA County County",2003,10300,143064,153364
"383",NA,"NA County County",NA,"NA County County",2004,8652,142438,151090
"384",NA,"NA County County",NA,"NA County County",2005,7765,143367,151132
"385",NA,"NA County County",NA,"NA County County",2006,7352,144703,152055
"386",NA,"NA County County",NA,"NA County County",2007,7049,145909,152958
"387",NA,"NA County County",NA,"NA County County",2008,8419,145866,154285
"388",NA,"NA County County",NA,"NA County County",2009,13542,141736,155278
"389",NA,"NA County County",NA,"NA County County",2010,13336,142187,155523
"390",NA,"NA County County",NA,"NA County County",2011,11672,143658,155330
"391",NA,"NA County County",NA,"NA County County",2012,10965,145242,156207
"392",NA,"NA County County",NA,"NA County County",1990,10062,133377,143439
"393",NA,"NA County County",NA,"NA County County",1991,13936,128318,142254
"394",NA,"NA County County",NA,"NA County County",1992,14907,127379,142286
"395",NA,"NA County County",NA,"NA County County",1993,12118,127268,139386
"396",NA,"NA County County",NA,"NA County County",1994,9715,128164,137879
"397",NA,"NA County County",NA,"NA County County",1995,7947,130464,138411
"398",NA,"NA County County",NA,"NA County County",1996,6191,135141,141332
"399",NA,"NA County County",NA,"NA County County",1997,5866,140815,146681
"400",NA,"NA County County",NA,"NA County County",1998,5114,144491,149605
"401",NA,"NA County County",NA,"NA County County",1999,5233,149044,154277
"402",NA,"NA County County",NA,"NA County County",2000,3780,140988,144768
"403",NA,"NA County County",NA,"NA County County",2001,6012,141534,147546
"404",NA,"NA County County",NA,"NA County County",2002,9369,138843,148212
"405",NA,"NA County County",NA,"NA County County",2003,9820,136686,146506
"406",NA,"NA County County",NA,"NA County County",2004,8250,135919,144169
"407",NA,"NA County County",NA,"NA County County",2005,7387,136708,144095
"408",NA,"NA County County",NA,"NA County County",2006,7008,137996,145004
"409",NA,"NA County County",NA,"NA County County",2007,6699,139157,145856
"410",NA,"NA County County",NA,"NA County County",2008,8044,139091,147135
"411",NA,"NA County County",NA,"NA County County",2009,12942,135039,147981
"412",NA,"NA County County",NA,"NA County County",2010,12760,135340,148100
"413",NA,"NA County County",NA,"NA County County",2011,11139,136771,147910
"414",NA,"NA County County",NA,"NA County County",2012,10420,138280,148700
"415",NA,"NA County County",NA,"NA County County",1990,600,9780,10380
"416",NA,"NA County County",NA,"NA County County",1991,832,9463,10295
"417",NA,"NA County County",NA,"NA County County",1992,787,9588,10375
"418",NA,"NA County County",NA,"NA County County",1993,685,9745,10430
"419",NA,"NA County County",NA,"NA County County",1994,578,10046,10624
"420",NA,"NA County County",NA,"NA County County",1995,515,9855,10370
"421",NA,"NA County County",NA,"NA County County",1996,426,10212,10638
"422",NA,"NA County County",NA,"NA County County",1997,370,10648,11018
"423",NA,"NA County County",NA,"NA County County",1998,329,10978,11307
"424",NA,"NA County County",NA,"NA County County",1999,350,11270,11620
"425",NA,"NA County County",NA,"NA County County",2000,265,11108,11373
"426",NA,"NA County County",NA,"NA County County",2001,395,11088,11483
"427",NA,"NA County County",NA,"NA County County",2002,640,10832,11472
"428",NA,"NA County County",NA,"NA County County",2003,657,11030,11687
"429",NA,"NA County County",NA,"NA County County",2004,569,11129,11698
"430",NA,"NA County County",NA,"NA County County",2005,493,11237,11730
"431",NA,"NA County County",NA,"NA County County",2006,474,11261,11735
"432",NA,"NA County County",NA,"NA County County",2007,449,11298,11747
"433",NA,"NA County County",NA,"NA County County",2008,524,11252,11776
"434",NA,"NA County County",NA,"NA County County",2009,859,10969,11828
"435",NA,"NA County County",NA,"NA County County",2010,895,10745,11640
"436",NA,"NA County County",NA,"NA County County",2011,732,10780,11512
"437",NA,"NA County County",NA,"NA County County",2012,673,10872,11545
"438",NA,"NA County County",NA,"NA County County",1990,8533,74145,82678
"439",NA,"NA County County",NA,"NA County County",1991,11465,71289,82754
"440",NA,"NA County County",NA,"NA County County",1992,10755,70722,81477
"441",NA,"NA County County",NA,"NA County County",1993,9278,72251,81529
"442",NA,"NA County County",NA,"NA County County",1994,8848,73207,82055
"443",NA,"NA County County",NA,"NA County County",1995,8259,72809,81068
"444",NA,"NA County County",NA,"NA County County",1996,7283,72235,79518
"445",NA,"NA County County",NA,"NA County County",1997,6323,74011,80334
"446",NA,"NA County County",NA,"NA County County",1998,5410,74525,79935
"447",NA,"NA County County",NA,"NA County County",1999,4916,75134,80050
"448",NA,"NA County County",NA,"NA County County",2000,3653,78925,82578
"449",NA,"NA County County",NA,"NA County County",2001,4435,78032,82467
"450",NA,"NA County County",NA,"NA County County",2002,5791,78673,84464
"451",NA,"NA County County",NA,"NA County County",2003,6442,77159,83601
"452",NA,"NA County County",NA,"NA County County",2004,5867,77694,83561
"453",NA,"NA County County",NA,"NA County County",2005,5723,78621,84344
"454",NA,"NA County County",NA,"NA County County",2006,5584,79778,85362
"455",NA,"NA County County",NA,"NA County County",2007,5454,79402,84856
"456",NA,"NA County County",NA,"NA County County",2008,6660,78413,85073
"457",NA,"NA County County",NA,"NA County County",2009,9808,76418,86226
"458",NA,"NA County County",NA,"NA County County",2010,10320,76251,86571
"459",NA,"NA County County",NA,"NA County County",2011,9322,77064,86386
"460",NA,"NA County County",NA,"NA County County",2012,8923,77972,86895
"461",NA,"NA County County",NA,"NA County County",1990,1738,16904,18642
"462",NA,"NA County County",NA,"NA County County",1991,2399,16210,18609
"463",NA,"NA County County",NA,"NA County County",1992,2146,15869,18015
"464",NA,"NA County County",NA,"NA County County",1993,1687,16293,17980
"465",NA,"NA County County",NA,"NA County County",1994,1414,16216,17630
"466",NA,"NA County County",NA,"NA County County",1995,1102,15982,17084
"467",NA,"NA County County",NA,"NA County County",1996,1023,16173,17196
"468",NA,"NA County County",NA,"NA County County",1997,921,16270,17191
"469",NA,"NA County County",NA,"NA County County",1998,719,16421,17140
"470",NA,"NA County County",NA,"NA County County",1999,702,16505,17207
"471",NA,"NA County County",NA,"NA County County",2000,587,16761,17348
"472",NA,"NA County County",NA,"NA County County",2001,749,16808,17557
"473",NA,"NA County County",NA,"NA County County",2002,987,16704,17691
"474",NA,"NA County County",NA,"NA County County",2003,1099,16477,17576
"475",NA,"NA County County",NA,"NA County County",2004,1019,16335,17354
"476",NA,"NA County County",NA,"NA County County",2005,926,16357,17283
"477",NA,"NA County County",NA,"NA County County",2006,926,16458,17384
"478",NA,"NA County County",NA,"NA County County",2007,968,16442,17410
"479",NA,"NA County County",NA,"NA County County",2008,1073,16471,17544
"480",NA,"NA County County",NA,"NA County County",2009,1592,16182,17774
"481",NA,"NA County County",NA,"NA County County",2010,1617,15954,17571
"482",NA,"NA County County",NA,"NA County County",2011,1446,15937,17383
"483",NA,"NA County County",NA,"NA County County",2012,1296,15727,17023
"484",NA,"NA County County",NA,"NA County County",1990,1715,16486,18201
"485",NA,"NA County County",NA,"NA County County",1991,2378,15786,18164
"486",NA,"NA County County",NA,"NA County County",1992,2112,15450,17562
"487",NA,"NA County County",NA,"NA County County",1993,1652,15869,17521
"488",NA,"NA County County",NA,"NA County County",1994,1397,15790,17187
"489",NA,"NA County County",NA,"NA County County",1995,1082,15547,16629
"490",NA,"NA County County",NA,"NA County County",1996,992,15730,16722
"491",NA,"NA County County",NA,"NA County County",1997,901,15830,16731
"492",NA,"NA County County",NA,"NA County County",1998,706,15973,16679
"493",NA,"NA County County",NA,"NA County County",1999,683,16054,16737
"494",NA,"NA County County",NA,"NA County County",2000,573,16347,16920
"495",NA,"NA County County",NA,"NA County County",2001,728,16390,17118
"496",NA,"NA County County",NA,"NA County County",2002,966,16282,17248
"497",NA,"NA County County",NA,"NA County County",2003,1068,16060,17128
"498",NA,"NA County County",NA,"NA County County",2004,994,15918,16912
"499",NA,"NA County County",NA,"NA County County",2005,901,15937,16838
"500",NA,"NA County County",NA,"NA County County",2006,899,16030,16929
"501",NA,"NA County County",NA,"NA County County",2007,938,16016,16954
"502",NA,"NA County County",NA,"NA County County",2008,1043,16046,17089
"503",NA,"NA County County",NA,"NA County County",2009,1545,15763,17308
"504",NA,"NA County County",NA,"NA County County",2010,1576,15519,17095
"505",NA,"NA County County",NA,"NA County County",2011,1415,15503,16918
"506",NA,"NA County County",NA,"NA County County",2012,1258,15300,16558
"507",NA,"NA County County",NA,"NA County County",1990,7613,113904,121517
"508",NA,"NA County County",NA,"NA County County",1991,10375,110059,120434
"509",NA,"NA County County",NA,"NA County County",1992,10895,108719,119614
"510",NA,"NA County County",NA,"NA County County",1993,8018,109681,117699
"511",NA,"NA County County",NA,"NA County County",1994,6915,111149,118064
"512",NA,"NA County County",NA,"NA County County",1995,6013,112802,118815
"513",NA,"NA County County",NA,"NA County County",1996,5049,115027,120076
"514",NA,"NA County County",NA,"NA County County",1997,4690,118302,122992
"515",NA,"NA County County",NA,"NA County County",1998,4123,120431,124554
"516",NA,"NA County County",NA,"NA County County",1999,4007,121500,125507
"517",NA,"NA County County",NA,"NA County County",2000,3310,122413,125723
"518",NA,"NA County County",NA,"NA County County",2001,4700,123088,127788
"519",NA,"NA County County",NA,"NA County County",2002,6870,122402,129272
"520",NA,"NA County County",NA,"NA County County",2003,7773,121068,128841
"521",NA,"NA County County",NA,"NA County County",2004,7006,120301,127307
"522",NA,"NA County County",NA,"NA County County",2005,6416,120747,127163
"523",NA,"NA County County",NA,"NA County County",2006,6300,121636,127936
"524",NA,"NA County County",NA,"NA County County",2007,5783,121596,127379
"525",NA,"NA County County",NA,"NA County County",2008,6873,121738,128611
"526",NA,"NA County County",NA,"NA County County",2009,10629,118984,129613
"527",NA,"NA County County",NA,"NA County County",2010,10503,119486,129989
"528",NA,"NA County County",NA,"NA County County",2011,9157,120863,130020
"529",NA,"NA County County",NA,"NA County County",2012,8752,121793,130545
"530",NA,"NA County County",NA,"NA County County",1990,2531,35681,38212
"531",NA,"NA County County",NA,"NA County County",1991,4157,33980,38137
"532",NA,"NA County County",NA,"NA County County",1992,4081,33496,37577
"533",NA,"NA County County",NA,"NA County County",1993,3226,33559,36785
"534",NA,"NA County County",NA,"NA County County",1994,2950,33312,36262
"535",NA,"NA County County",NA,"NA County County",1995,2374,33141,35515
"536",NA,"NA County County",NA,"NA County County",1996,1886,33505,35391
"537",NA,"NA County County",NA,"NA County County",1997,1854,33742,35596
"538",NA,"NA County County",NA,"NA County County",1998,1512,33822,35334
"539",NA,"NA County County",NA,"NA County County",1999,1469,34103,35572
"540",NA,"NA County County",NA,"NA County County",2000,1135,36673,37808
"541",NA,"NA County County",NA,"NA County County",2001,1350,36606,37956
"542",NA,"NA County County",NA,"NA County County",2002,1776,37071,38847
"543",NA,"NA County County",NA,"NA County County",2003,1968,36838,38806
"544",NA,"NA County County",NA,"NA County County",2004,1809,36808,38617
"545",NA,"NA County County",NA,"NA County County",2005,1696,37223,38919
"546",NA,"NA County County",NA,"NA County County",2006,1672,37806,39478
"547",NA,"NA County County",NA,"NA County County",2007,1687,37596,39283
"548",NA,"NA County County",NA,"NA County County",2008,2003,37169,39172
"549",NA,"NA County County",NA,"NA County County",2009,3066,36081,39147
"550",NA,"NA County County",NA,"NA County County",2010,3230,35778,39008
"551",NA,"NA County County",NA,"NA County County",2011,2893,36108,39001
"552",NA,"NA County County",NA,"NA County County",2012,2722,35945,38667
"553",NA,"NA County County",NA,"NA County County",1990,4269,52585,56854
"554",NA,"NA County County",NA,"NA County County",1991,6556,50190,56746
"555",NA,"NA County County",NA,"NA County County",1992,6227,49365,55592
"556",NA,"NA County County",NA,"NA County County",1993,4913,49852,54765
"557",NA,"NA County County",NA,"NA County County",1994,4364,49528,53892
"558",NA,"NA County County",NA,"NA County County",1995,3476,49123,52599
"559",NA,"NA County County",NA,"NA County County",1996,2908,49678,52586
"560",NA,"NA County County",NA,"NA County County",1997,2775,50012,52787
"561",NA,"NA County County",NA,"NA County County",1998,2231,50243,52474
"562",NA,"NA County County",NA,"NA County County",1999,2171,50608,52779
"563",NA,"NA County County",NA,"NA County County",2000,1722,53434,55156
"564",NA,"NA County County",NA,"NA County County",2001,2099,53414,55513
"565",NA,"NA County County",NA,"NA County County",2002,2763,53775,56538
"566",NA,"NA County County",NA,"NA County County",2003,3067,53315,56382
"567",NA,"NA County County",NA,"NA County County",2004,2828,53143,55971
"568",NA,"NA County County",NA,"NA County County",2005,2622,53580,56202
"569",NA,"NA County County",NA,"NA County County",2006,2598,54264,56862
"570",NA,"NA County County",NA,"NA County County",2007,2654,54038,56692
"571",NA,"NA County County",NA,"NA County County",2008,3076,53639,56715
"572",NA,"NA County County",NA,"NA County County",2009,4658,52263,56921
"573",NA,"NA County County",NA,"NA County County",2010,4846,51732,56578
"574",NA,"NA County County",NA,"NA County County",2011,4339,52045,56384
"575",NA,"NA County County",NA,"NA County County",2012,4018,51672,55690
"576",NA,"NA County County",NA,"NA County County",1990,12535,126860,139395
"577",NA,"NA County County",NA,"NA County County",1991,17836,121902,139738
"578",NA,"NA County County",NA,"NA County County",1992,17029,122471,139500
"579",NA,"NA County County",NA,"NA County County",1993,15046,124830,139876
"580",NA,"NA County County",NA,"NA County County",1994,12059,126829,138888
"581",NA,"NA County County",NA,"NA County County",1995,11125,128164,139289
"582",NA,"NA County County",NA,"NA County County",1996,10067,129123,139190
"583",NA,"NA County County",NA,"NA County County",1997,8708,131879,140587
"584",NA,"NA County County",NA,"NA County County",1998,6453,133789,140242
"585",NA,"NA County County",NA,"NA County County",1999,6103,135188,141291
"586",NA,"NA County County",NA,"NA County County",2000,5489,137552,143041
"587",NA,"NA County County",NA,"NA County County",2001,7009,137025,144034
"588",NA,"NA County County",NA,"NA County County",2002,9181,138368,147549
"589",NA,"NA County County",NA,"NA County County",2003,9542,139566,149108
"590",NA,"NA County County",NA,"NA County County",2004,9288,139876,149164
"591",NA,"NA County County",NA,"NA County County",2005,8914,140601,149515
"592",NA,"NA County County",NA,"NA County County",2006,9203,141879,151082
"593",NA,"NA County County",NA,"NA County County",2007,8966,141889,150855
"594",NA,"NA County County",NA,"NA County County",2008,10913,139475,150388
"595",NA,"NA County County",NA,"NA County County",2009,17232,134250,151482
"596",NA,"NA County County",NA,"NA County County",2010,17194,133117,150311
"597",NA,"NA County County",NA,"NA County County",2011,16028,134181,150209
"598",NA,"NA County County",NA,"NA County County",2012,14867,134394,149261
"599",NA,"NA County County",NA,"NA County County",1990,20293,317603,337896
"600",NA,"NA County County",NA,"NA County County",1991,29812,307508,337320
"601",NA,"NA County County",NA,"NA County County",1992,29638,305588,335226
"602",NA,"NA County County",NA,"NA County County",1993,26701,304261,330962
"603",NA,"NA County County",NA,"NA County County",1994,23474,304756,328230
"604",NA,"NA County County",NA,"NA County County",1995,19752,303366,323118
"605",NA,"NA County County",NA,"NA County County",1996,15872,306171,322043
"606",NA,"NA County County",NA,"NA County County",1997,14762,312005,326767
"607",NA,"NA County County",NA,"NA County County",1998,12721,313108,325829
"608",NA,"NA County County",NA,"NA County County",1999,11792,315066,326858
"609",NA,"NA County County",NA,"NA County County",2000,9916,325430,335346
"610",NA,"NA County County",NA,"NA County County",2001,12658,326721,339379
"611",NA,"NA County County",NA,"NA County County",2002,17640,325844,343484
"612",NA,"NA County County",NA,"NA County County",2003,20568,323712,344280
"613",NA,"NA County County",NA,"NA County County",2004,19363,324271,343634
"614",NA,"NA County County",NA,"NA County County",2005,18310,325593,343903
"615",NA,"NA County County",NA,"NA County County",2006,18350,327858,346208
"616",NA,"NA County County",NA,"NA County County",2007,17583,327423,345006
"617",NA,"NA County County",NA,"NA County County",2008,20562,326653,347215
"618",NA,"NA County County",NA,"NA County County",2009,30205,317825,348030
"619",NA,"NA County County",NA,"NA County County",2010,32031,316078,348109
"620",NA,"NA County County",NA,"NA County County",2011,29066,312390,341456
"621",NA,"NA County County",NA,"NA County County",2012,26806,312100,338906
"622",NA,"NA County County",NA,"NA County County",1990,18331,269615,287946
"623",NA,"NA County County",NA,"NA County County",1991,26596,259938,286534
"624",NA,"NA County County",NA,"NA County County",1992,25849,258987,284836
"625",NA,"NA County County",NA,"NA County County",1993,23377,258290,281667
"626",NA,"NA County County",NA,"NA County County",1994,20567,259251,279818
"627",NA,"NA County County",NA,"NA County County",1995,17170,259609,276779
"628",NA,"NA County County",NA,"NA County County",1996,13617,262606,276223
"629",NA,"NA County County",NA,"NA County County",1997,12571,268412,280983
"630",NA,"NA County County",NA,"NA County County",1998,11324,269584,280908
"631",NA,"NA County County",NA,"NA County County",1999,10649,271157,281806
"632",NA,"NA County County",NA,"NA County County",2000,8906,280715,289621
"633",NA,"NA County County",NA,"NA County County",2001,11290,281361,292651
"634",NA,"NA County County",NA,"NA County County",2002,15546,280573,296119
"635",NA,"NA County County",NA,"NA County County",2003,17928,278565,296493
"636",NA,"NA County County",NA,"NA County County",2004,16978,278918,295896
"637",NA,"NA County County",NA,"NA County County",2005,16005,279804,295809
"638",NA,"NA County County",NA,"NA County County",2006,16149,281319,297468
"639",NA,"NA County County",NA,"NA County County",2007,15317,280579,295896
"640",NA,"NA County County",NA,"NA County County",2008,17817,279734,297551
"641",NA,"NA County County",NA,"NA County County",2009,26116,271535,297651
"642",NA,"NA County County",NA,"NA County County",2010,27383,269339,296722
"643",NA,"NA County County",NA,"NA County County",2011,24753,266510,291263
"644",NA,"NA County County",NA,"NA County County",2012,22815,266670,289485
"645",NA,"NA County County",NA,"NA County County",1990,22280,360011,382291
"646",NA,"NA County County",NA,"NA County County",1991,32523,348538,381061
"647",NA,"NA County County",NA,"NA County County",1992,32181,346103,378284
"648",NA,"NA County County",NA,"NA County County",1993,28703,345261,373964
"649",NA,"NA County County",NA,"NA County County",1994,25179,346699,371878
"650",NA,"NA County County",NA,"NA County County",1995,21378,345879,367257
"651",NA,"NA County County",NA,"NA County County",1996,17225,349074,366299
"652",NA,"NA County County",NA,"NA County County",1997,16056,355837,371893
"653",NA,"NA County County",NA,"NA County County",1998,13892,358013,371905
"654",NA,"NA County County",NA,"NA County County",1999,12876,360522,373398
"655",NA,"NA County County",NA,"NA County County",2000,10948,369976,380924
"656",NA,"NA County County",NA,"NA County County",2001,13897,371258,385155
"657",NA,"NA County County",NA,"NA County County",2002,19252,370667,389919
"658",NA,"NA County County",NA,"NA County County",2003,22430,368849,391279
"659",NA,"NA County County",NA,"NA County County",2004,21161,369160,390321
"660",NA,"NA County County",NA,"NA County County",2005,20148,370377,390525
"661",NA,"NA County County",NA,"NA County County",2006,20176,372959,393135
"662",NA,"NA County County",NA,"NA County County",2007,19319,372345,391664
"663",NA,"NA County County",NA,"NA County County",2008,22662,371195,393857
"664",NA,"NA County County",NA,"NA County County",2009,33216,361462,394678
"665",NA,"NA County County",NA,"NA County County",2010,35178,359869,395047
"666",NA,"NA County County",NA,"NA County County",2011,31797,356367,388164
"667",NA,"NA County County",NA,"NA County County",2012,29353,356344,385697
"668",NA,"NA County County",NA,"NA County County",1990,3787,46315,50102
"669",NA,"NA County County",NA,"NA County County",1991,4972,45312,50284
"670",NA,"NA County County",NA,"NA County County",1992,5114,45634,50748
"671",NA,"NA County County",NA,"NA County County",1993,4084,46910,50994
"672",NA,"NA County County",NA,"NA County County",1994,3648,48663,52311
"673",NA,"NA County County",NA,"NA County County",1995,3238,48679,51917
"674",NA,"NA County County",NA,"NA County County",1996,2809,49713,52522
"675",NA,"NA County County",NA,"NA County County",1997,2526,51305,53831
"676",NA,"NA County County",NA,"NA County County",1998,1936,52388,54324
"677",NA,"NA County County",NA,"NA County County",1999,1861,53374,55235
"678",NA,"NA County County",NA,"NA County County",2000,1586,57329,58915
"679",NA,"NA County County",NA,"NA County County",2001,2140,57663,59803
"680",NA,"NA County County",NA,"NA County County",2002,3019,57879,60898
"681",NA,"NA County County",NA,"NA County County",2003,3392,58077,61469
"682",NA,"NA County County",NA,"NA County County",2004,3217,58234,61451
"683",NA,"NA County County",NA,"NA County County",2005,3025,59266,62291
"684",NA,"NA County County",NA,"NA County County",2006,3130,60077,63207
"685",NA,"NA County County",NA,"NA County County",2007,3001,60432,63433
"686",NA,"NA County County",NA,"NA County County",2008,3720,60212,63932
"687",NA,"NA County County",NA,"NA County County",2009,5647,58153,63800
"688",NA,"NA County County",NA,"NA County County",2010,5691,57801,63492
"689",NA,"NA County County",NA,"NA County County",2011,4975,58422,63397
"690",NA,"NA County County",NA,"NA County County",2012,4497,58247,62744
"691",NA,"NA County County","MA","NA County County",1990,382,7060,7442
"692",NA,"NA County County","MA","NA County County",1991,561,7205,7766
"693",NA,"NA County County","MA","NA County County",1992,595,6842,7437
"694",NA,"NA County County","MA","NA County County",1993,580,7097,7677
"695",NA,"NA County County","MA","NA County County",1994,564,7684,8248
"696",NA,"NA County County","MA","NA County County",1995,495,8128,8623
"697",NA,"NA County County","MA","NA County County",1996,485,8493,8978
"698",NA,"NA County County","MA","NA County County",1997,467,8726,9193
"699",NA,"NA County County","MA","NA County County",1998,381,8918,9299
"700",NA,"NA County County","MA","NA County County",1999,370,9075,9445
"701",NA,"NA County County","MA","NA County County",2000,279,9759,10038
"702",NA,"NA County County","MA","NA County County",2001,296,9820,10116
"703",NA,"NA County County","MA","NA County County",2002,406,10193,10599
"704",NA,"NA County County","MA","NA County County",2003,468,10573,11041
"705",NA,"NA County County","MA","NA County County",2004,449,10652,11101
"706",NA,"NA County County","MA","NA County County",2005,429,10509,10938
"707",NA,"NA County County","MA","NA County County",2006,428,10604,11032
"708",NA,"NA County County","MA","NA County County",2007,391,10718,11109
"709",NA,"NA County County","MA","NA County County",2008,465,10724,11189
"710",NA,"NA County County","MA","NA County County",2009,725,10571,11296
"711",NA,"NA County County","MA","NA County County",2010,873,10641,11514
"712",NA,"NA County County","MA","NA County County",2011,840,10723,11563
"713",NA,"NA County County","MA","NA County County",2012,803,10830,11633
"714",NA,"NA County County",NA,"NA County County",1990,17470,243503,260973
"715",NA,"NA County County",NA,"NA County County",1991,24700,235193,259893
"716",NA,"NA County County",NA,"NA County County",1992,23435,236100,259535
"717",NA,"NA County County",NA,"NA County County",1993,18382,242383,260765
"718",NA,"NA County County",NA,"NA County County",1994,14251,247044,261295
"719",NA,"NA County County",NA,"NA County County",1995,13145,245578,258723
"720",NA,"NA County County",NA,"NA County County",1996,11288,249807,261095
"721",NA,"NA County County",NA,"NA County County",1997,10206,256426,266632
"722",NA,"NA County County",NA,"NA County County",1998,8952,262026,270978
"723",NA,"NA County County",NA,"NA County County",1999,8798,262408,271206
"724",NA,"NA County County",NA,"NA County County",2000,7499,272178,279677
"725",NA,"NA County County",NA,"NA County County",2001,10520,273235,283755
"726",NA,"NA County County",NA,"NA County County",2002,15470,272646,288116
"727",NA,"NA County County",NA,"NA County County",2003,17406,272836,290242
"728",NA,"NA County County",NA,"NA County County",2004,15716,273601,289317
"729",NA,"NA County County",NA,"NA County County",2005,14548,274465,289013
"730",NA,"NA County County",NA,"NA County County",2006,14428,277641,292069
"731",NA,"NA County County",NA,"NA County County",2007,14152,278201,292353
"732",NA,"NA County County",NA,"NA County County",2008,16764,277224,293988
"733",NA,"NA County County",NA,"NA County County",2009,25695,269631,295326
"734",NA,"NA County County",NA,"NA County County",2010,26208,269465,295673
"735",NA,"NA County County",NA,"NA County County",2011,23136,271632,294768
"736",NA,"NA County County",NA,"NA County County",2012,21597,271396,292993
"737",NA,"NA County County",NA,"NA County County",1990,16519,231807,248326
"738",NA,"NA County County",NA,"NA County County",1991,23579,223510,247089
"739",NA,"NA County County",NA,"NA County County",1992,22267,224204,246471
"740",NA,"NA County County",NA,"NA County County",1993,17451,230579,248030
"741",NA,"NA County County",NA,"NA County County",1994,13487,235036,248523
"742",NA,"NA County County",NA,"NA County County",1995,12397,233229,245626
"743",NA,"NA County County",NA,"NA County County",1996,10509,237379,247888
"744",NA,"NA County County",NA,"NA County County",1997,9472,244206,253678
"745",NA,"NA County County",NA,"NA County County",1998,8457,249548,258005
"746",NA,"NA County County",NA,"NA County County",1999,8445,249710,258155
"747",NA,"NA County County",NA,"NA County County",2000,7186,258708,265894
"748",NA,"NA County County",NA,"NA County County",2001,10117,259722,269839
"749",NA,"NA County County",NA,"NA County County",2002,14883,259115,273998
"750",NA,"NA County County",NA,"NA County County",2003,16599,259211,275810
"751",NA,"NA County County",NA,"NA County County",2004,15002,259779,274781
"752",NA,"NA County County",NA,"NA County County",2005,13834,260504,274338
"753",NA,"NA County County",NA,"NA County County",2006,13721,263415,277136
"754",NA,"NA County County",NA,"NA County County",2007,13399,263873,277272
"755",NA,"NA County County",NA,"NA County County",2008,15842,262838,278680
"756",NA,"NA County County",NA,"NA County County",2009,24356,255449,279805
"757",NA,"NA County County",NA,"NA County County",2010,24638,255291,279929
"758",NA,"NA County County",NA,"NA County County",2011,21786,257534,279320
"759",NA,"NA County County",NA,"NA County County",2012,20328,257448,277776
"760",NA,"NA County County","MA","NA County County",1976,267633,2458306,2725939
"761",NA,"NA County County","MA","NA County County",1977,218418,2541441,2759859
"762",NA,"NA County County","MA","NA County County",1978,173402,2635115,2808517
"763",NA,"NA County County","MA","NA County County",1979,156341,2706845,2863186
"764",NA,"NA County County","MA","NA County County",1980,164064,2721430,2885494
"765",NA,"NA County County","MA","NA County County",1981,189276,2749062,2938338
"766",NA,"NA County County","MA","NA County County",1982,236372,2729293,2965665
"767",NA,"NA County County","MA","NA County County",1983,208954,2763148,2972102
"768",NA,"NA County County","MA","NA County County",1984,145657,2886782,3032439
"769",NA,"NA County County","MA","NA County County",1985,124753,2924626,3049379
"770",NA,"NA County County","MA","NA County County",1986,122686,2957321,3080007
"771",NA,"NA County County","MA","NA County County",1987,104458,3009900,3114358
"772",NA,"NA County County","MA","NA County County",1988,104345,3051355,3155700
"773",NA,"NA County County","MA","NA County County",1989,132422,3057019,3189441
"774",NA,"NA County County","MA","NA County County",1990,203975,3022393,3226368
"775",NA,"NA County County","MA","NA County County",1991,282590,2916293,3198883
"776",NA,"NA County County","MA","NA County County",1992,281022,2899718,3180740
"777",NA,"NA County County","MA","NA County County",1993,232339,2940565,3172904
"778",NA,"NA County County","MA","NA County County",1994,198690,2989123,3187813
"779",NA,"NA County County","MA","NA County County",1995,175528,3029360,3204888
"780",NA,"NA County County","MA","NA County County",1996,147721,3083332,3231053
"781",NA,"NA County County","MA","NA County County",1997,134564,3158851,3293415
"782",NA,"NA County County","MA","NA County County",1998,112674,3208988,3321662
"783",NA,"NA County County","MA","NA County County",1999,109563,3245761,3355324
"784",NA,"NA County County","MA","NA County County",2000,92292,3273281,3365573
"785",NA,"NA County County","MA","NA County County",2001,125993,3275343,3401336
"786",NA,"NA County County","MA","NA County County",2002,181003,3243409,3424412
"787",NA,"NA County County","MA","NA County County",2003,197648,3209062,3406710
"788",NA,"NA County County","MA","NA County County",2004,176839,3203810,3380649
"789",NA,"NA County County","MA","NA County County",2005,163579,3219717,3383296
"790",NA,"NA County County","MA","NA County County",2006,162495,3255504,3417999
"791",NA,"NA County County","MA","NA County County",2007,154422,3276532,3430954
"792",NA,"NA County County","MA","NA County County",2008,185177,3277934,3463111
"793",NA,"NA County County","MA","NA County County",2009,283193,3187538,3470731
"794",NA,"NA County County","MA","NA County County",2010,287549,3187622,3475171
"795",NA,"NA County County","MA","NA County County",2011,253592,3216160,3469752
"796",NA,"NA County County","MA","NA County County",2012,233684,3241762,3475446
"797","Abington","Plymouth County County","MA","Abington",1990,553,7229,7782
"798","Abington","Plymouth County County","MA","Abington",1991,818,6938,7756
"799","Abington","Plymouth County County","MA","Abington",1992,754,6935,7689
"800","Abington","Plymouth County County","MA","Abington",1993,589,7164,7753
"801","Abington","Plymouth County County","MA","Abington",1994,510,7690,8200
"802","Abington","Plymouth County County","MA","Abington",1995,458,7774,8232
"803","Abington","Plymouth County County","MA","Abington",1996,415,7868,8283
"804","Abington","Plymouth County County","MA","Abington",1997,371,8110,8481
"805","Abington","Plymouth County County","MA","Abington",1998,309,8163,8472
"806","Abington","Plymouth County County","MA","Abington",1999,265,8271,8536
"807","Abington","Plymouth County County","MA","Abington",2000,209,8207,8416
"808","Abington","Plymouth County County","MA","Abington",2001,269,8279,8548
"809","Abington","Plymouth County County","MA","Abington",2002,383,8283,8666
"810","Abington","Plymouth County County","MA","Abington",2003,464,8515,8979
"811","Abington","Plymouth County County","MA","Abington",2004,465,8602,9067
"812","Abington","Plymouth County County","MA","Abington",2005,441,8676,9117
"813","Abington","Plymouth County County","MA","Abington",2006,436,8803,9239
"814","Abington","Plymouth County County","MA","Abington",2007,430,8917,9347
"815","Abington","Plymouth County County","MA","Abington",2008,513,9030,9543
"816","Abington","Plymouth County County","MA","Abington",2009,821,8778,9599
"817","Abington","Plymouth County County","MA","Abington",2010,811,8349,9160
"818","Abington","Plymouth County County","MA","Abington",2011,708,8427,9135
"819","Abington","Plymouth County County","MA","Abington",2012,642,8502,9144
"820","Acton","Middlesex County County","MA","Acton",1990,322,10147,10469
"821","Acton","Middlesex County County","MA","Acton",1991,461,9727,10188
"822","Acton","Middlesex County County","MA","Acton",1992,523,9800,10323
"823","Acton","Middlesex County County","MA","Acton",1993,481,10056,10537
"824","Acton","Middlesex County County","MA","Acton",1994,389,10238,10627
"825","Acton","Middlesex County County","MA","Acton",1995,347,10469,10816
"826","Acton","Middlesex County County","MA","Acton",1996,230,10782,11012
"827","Acton","Middlesex County County","MA","Acton",1997,230,11118,11348
"828","Acton","Middlesex County County","MA","Acton",1998,193,11350,11543
"829","Acton","Middlesex County County","MA","Acton",1999,229,11531,11760
"830","Acton","Middlesex County County","MA","Acton",2000,185,11454,11639
"831","Acton","Middlesex County County","MA","Acton",2001,348,11559,11907
"832","Acton","Middlesex County County","MA","Acton",2002,590,11388,11978
"833","Acton","Middlesex County County","MA","Acton",2003,573,11213,11786
"834","Acton","Middlesex County County","MA","Acton",2004,435,11166,11601
"835","Acton","Middlesex County County","MA","Acton",2005,394,11231,11625
"836","Acton","Middlesex County County","MA","Acton",2006,388,11112,11500
"837","Acton","Middlesex County County","MA","Acton",2007,350,11255,11605
"838","Acton","Middlesex County County","MA","Acton",2008,414,11306,11720
"839","Acton","Middlesex County County","MA","Acton",2009,688,11066,11754
"840","Acton","Middlesex County County","MA","Acton",2010,683,11598,12281
"841","Acton","Middlesex County County","MA","Acton",2011,576,11769,12345
"842","Acton","Middlesex County County","MA","Acton",2012,535,11898,12433
"843","Acushnet","Bristol County County","MA","Acushnet",1990,426,4859,5285
"844","Acushnet","Bristol County County","MA","Acushnet",1991,654,4761,5415
"845","Acushnet","Bristol County County","MA","Acushnet",1992,571,4855,5426
"846","Acushnet","Bristol County County","MA","Acushnet",1993,523,4975,5498
"847","Acushnet","Bristol County County","MA","Acushnet",1994,492,5053,5545
"848","Acushnet","Bristol County County","MA","Acushnet",1995,470,4877,5347
"849","Acushnet","Bristol County County","MA","Acushnet",1996,395,4876,5271
"850","Acushnet","Bristol County County","MA","Acushnet",1997,347,5033,5380
"851","Acushnet","Bristol County County","MA","Acushnet",1998,285,5268,5553
"852","Acushnet","Bristol County County","MA","Acushnet",1999,241,5390,5631
"853","Acushnet","Bristol County County","MA","Acushnet",2000,189,5444,5633
"854","Acushnet","Bristol County County","MA","Acushnet",2001,234,5426,5660
"855","Acushnet","Bristol County County","MA","Acushnet",2002,325,5514,5839
"856","Acushnet","Bristol County County","MA","Acushnet",2003,374,5433,5807
"857","Acushnet","Bristol County County","MA","Acushnet",2004,321,5473,5794
"858","Acushnet","Bristol County County","MA","Acushnet",2005,341,5543,5884
"859","Acushnet","Bristol County County","MA","Acushnet",2006,343,5625,5968
"860","Acushnet","Bristol County County","MA","Acushnet",2007,322,5600,5922
"861","Acushnet","Bristol County County","MA","Acushnet",2008,373,5414,5787
"862","Acushnet","Bristol County County","MA","Acushnet",2009,579,5265,5844
"863","Acushnet","Bristol County County","MA","Acushnet",2010,617,5159,5776
"864","Acushnet","Bristol County County","MA","Acushnet",2011,533,5212,5745
"865","Acushnet","Bristol County County","MA","Acushnet",2012,471,5274,5745
"866","Adams","Berkshire County County","MA","Adams",1990,430,4158,4588
"867","Adams","Berkshire County County","MA","Adams",1991,761,3941,4702
"868","Adams","Berkshire County County","MA","Adams",1992,623,3853,4476
"869","Adams","Berkshire County County","MA","Adams",1993,543,3852,4395
"870","Adams","Berkshire County County","MA","Adams",1994,469,3763,4232
"871","Adams","Berkshire County County","MA","Adams",1995,335,3753,4088
"872","Adams","Berkshire County County","MA","Adams",1996,323,3799,4122
"873","Adams","Berkshire County County","MA","Adams",1997,295,3813,4108
"874","Adams","Berkshire County County","MA","Adams",1998,239,3807,4046
"875","Adams","Berkshire County County","MA","Adams",1999,232,3809,4041
"876","Adams","Berkshire County County","MA","Adams",2000,178,4259,4437
"877","Adams","Berkshire County County","MA","Adams",2001,233,4264,4497
"878","Adams","Berkshire County County","MA","Adams",2002,306,4227,4533
"879","Adams","Berkshire County County","MA","Adams",2003,351,4166,4517
"880","Adams","Berkshire County County","MA","Adams",2004,297,4125,4422
"881","Adams","Berkshire County County","MA","Adams",2005,269,4135,4404
"882","Adams","Berkshire County County","MA","Adams",2006,267,4155,4422
"883","Adams","Berkshire County County","MA","Adams",2007,284,4135,4419
"884","Adams","Berkshire County County","MA","Adams",2008,310,4181,4491
"885","Adams","Berkshire County County","MA","Adams",2009,462,4074,4536
"886","Adams","Berkshire County County","MA","Adams",2010,455,4114,4569
"887","Adams","Berkshire County County","MA","Adams",2011,411,4107,4518
"888","Adams","Berkshire County County","MA","Adams",2012,394,4053,4447
"889","Agawam","Hampden County County","MA","Agawam",1990,744,14394,15138
"890","Agawam","Hampden County County","MA","Agawam",1991,1145,13969,15114
"891","Agawam","Hampden County County","MA","Agawam",1992,1260,13941,15201
"892","Agawam","Hampden County County","MA","Agawam",1993,1116,13913,15029
"893","Agawam","Hampden County County","MA","Agawam",1994,984,14016,15000
"894","Agawam","Hampden County County","MA","Agawam",1995,781,13670,14451
"895","Agawam","Hampden County County","MA","Agawam",1996,617,13845,14462
"896","Agawam","Hampden County County","MA","Agawam",1997,582,14190,14772
"897","Agawam","Hampden County County","MA","Agawam",1998,490,14242,14732
"898","Agawam","Hampden County County","MA","Agawam",1999,446,14323,14769
"899","Agawam","Hampden County County","MA","Agawam",2000,416,15295,15711
"900","Agawam","Hampden County County","MA","Agawam",2001,513,15357,15870
"901","Agawam","Hampden County County","MA","Agawam",2002,752,15309,16061
"902","Agawam","Hampden County County","MA","Agawam",2003,875,15187,16062
"903","Agawam","Hampden County County","MA","Agawam",2004,786,15228,16014
"904","Agawam","Hampden County County","MA","Agawam",2005,737,15279,16016
"905","Agawam","Hampden County County","MA","Agawam",2006,748,15335,16083
"906","Agawam","Hampden County County","MA","Agawam",2007,696,15283,15979
"907","Agawam","Hampden County County","MA","Agawam",2008,826,15017,15843
"908","Agawam","Hampden County County","MA","Agawam",2009,1241,14533,15774
"909","Agawam","Hampden County County","MA","Agawam",2010,1282,14546,15828
"910","Agawam","Hampden County County","MA","Agawam",2011,1080,14400,15480
"911","Agawam","Hampden County County","MA","Agawam",2012,990,14409,15399
"912","Alford","Berkshire County County","MA","Alford",1990,6,199,205
"913","Alford","Berkshire County County","MA","Alford",1991,7,192,199
"914","Alford","Berkshire County County","MA","Alford",1992,6,188,194
"915","Alford","Berkshire County County","MA","Alford",1993,8,193,201
"916","Alford","Berkshire County County","MA","Alford",1994,5,192,197
"917","Alford","Berkshire County County","MA","Alford",1995,3,214,217
"918","Alford","Berkshire County County","MA","Alford",1996,4,219,223
"919","Alford","Berkshire County County","MA","Alford",1997,6,223,229
"920","Alford","Berkshire County County","MA","Alford",1998,5,220,225
"921","Alford","Berkshire County County","MA","Alford",1999,5,217,222
"922","Alford","Berkshire County County","MA","Alford",2000,4,211,215
"923","Alford","Berkshire County County","MA","Alford",2001,5,218,223
"924","Alford","Berkshire County County","MA","Alford",2002,7,223,230
"925","Alford","Berkshire County County","MA","Alford",2003,11,224,235
"926","Alford","Berkshire County County","MA","Alford",2004,7,221,228
"927","Alford","Berkshire County County","MA","Alford",2005,10,229,239
"928","Alford","Berkshire County County","MA","Alford",2006,10,231,241
"929","Alford","Berkshire County County","MA","Alford",2007,8,226,234
"930","Alford","Berkshire County County","MA","Alford",2008,8,225,233
"931","Alford","Berkshire County County","MA","Alford",2009,8,219,227
"932","Alford","Berkshire County County","MA","Alford",2010,13,277,290
"933","Alford","Berkshire County County","MA","Alford",2011,12,278,290
"934","Alford","Berkshire County County","MA","Alford",2012,9,276,285
"935","Amesbury","Essex County County","MA","Amesbury",1990,563,7391,7954
"936","Amesbury","Essex County County","MA","Amesbury",1991,674,7107,7781
"937","Amesbury","Essex County County","MA","Amesbury",1992,655,7097,7752
"938","Amesbury","Essex County County","MA","Amesbury",1993,601,7382,7983
"939","Amesbury","Essex County County","MA","Amesbury",1994,442,7712,8154
"940","Amesbury","Essex County County","MA","Amesbury",1995,383,7623,8006
"941","Amesbury","Essex County County","MA","Amesbury",1996,353,7818,8171
"942","Amesbury","Essex County County","MA","Amesbury",1997,338,8054,8392
"943","Amesbury","Essex County County","MA","Amesbury",1998,286,8220,8506
"944","Amesbury","Essex County County","MA","Amesbury",1999,274,8339,8613
"945","Amesbury","Essex County County","MA","Amesbury",2000,208,8882,9090
"946","Amesbury","Essex County County","MA","Amesbury",2001,323,8828,9151
"947","Amesbury","Essex County County","MA","Amesbury",2002,471,8566,9037
"948","Amesbury","Essex County County","MA","Amesbury",2003,505,8372,8877
"949","Amesbury","Essex County County","MA","Amesbury",2004,438,8279,8717
"950","Amesbury","Essex County County","MA","Amesbury",2005,388,8300,8688
"951","Amesbury","Essex County County","MA","Amesbury",2006,407,8325,8732
"952","Amesbury","Essex County County","MA","Amesbury",2007,373,8280,8653
"953","Amesbury","Essex County County","MA","Amesbury",2008,452,8236,8688
"954","Amesbury","Essex County County","MA","Amesbury",2009,691,8025,8716
"955","Amesbury","Essex County County","MA","Amesbury",2010,706,8016,8722
"956","Amesbury","Essex County County","MA","Amesbury",2011,597,8119,8716
"957","Amesbury","Essex County County","MA","Amesbury",2012,535,8226,8761
"958","Amherst","Hampshire County County","MA","Amherst",1990,752,17229,17981
"959","Amherst","Hampshire County County","MA","Amherst",1991,744,16166,16910
"960","Amherst","Hampshire County County","MA","Amherst",1992,546,16309,16855
"961","Amherst","Hampshire County County","MA","Amherst",1993,455,16674,17129
"962","Amherst","Hampshire County County","MA","Amherst",1994,402,16869,17271
"963","Amherst","Hampshire County County","MA","Amherst",1995,382,16921,17303
"964","Amherst","Hampshire County County","MA","Amherst",1996,324,17187,17511
"965","Amherst","Hampshire County County","MA","Amherst",1997,301,17564,17865
"966","Amherst","Hampshire County County","MA","Amherst",1998,298,18224,18522
"967","Amherst","Hampshire County County","MA","Amherst",1999,279,18309,18588
"968","Amherst","Hampshire County County","MA","Amherst",2000,354,17926,18280
"969","Amherst","Hampshire County County","MA","Amherst",2001,401,17871,18272
"970","Amherst","Hampshire County County","MA","Amherst",2002,498,17884,18382
"971","Amherst","Hampshire County County","MA","Amherst",2003,614,18094,18708
"972","Amherst","Hampshire County County","MA","Amherst",2004,618,18153,18771
"973","Amherst","Hampshire County County","MA","Amherst",2005,639,18087,18726
"974","Amherst","Hampshire County County","MA","Amherst",2006,617,18307,18924
"975","Amherst","Hampshire County County","MA","Amherst",2007,590,18514,19104
"976","Amherst","Hampshire County County","MA","Amherst",2008,745,18538,19283
"977","Amherst","Hampshire County County","MA","Amherst",2009,984,18287,19271
"978","Amherst","Hampshire County County","MA","Amherst",2010,1077,18640,19717
"979","Amherst","Hampshire County County","MA","Amherst",2011,955,18751,19706
"980","Amherst","Hampshire County County","MA","Amherst",2012,896,18919,19815
"981","Andover","Essex County County","MA","Andover",1990,685,14522,15207
"982","Andover","Essex County County","MA","Andover",1991,997,14413,15410
"983","Andover","Essex County County","MA","Andover",1992,997,14787,15784
"984","Andover","Essex County County","MA","Andover",1993,823,15162,15985
"985","Andover","Essex County County","MA","Andover",1994,807,15630,16437
"986","Andover","Essex County County","MA","Andover",1995,612,15600,16212
"987","Andover","Essex County County","MA","Andover",1996,527,16036,16563
"988","Andover","Essex County County","MA","Andover",1997,520,16204,16724
"989","Andover","Essex County County","MA","Andover",1998,414,16681,17095
"990","Andover","Essex County County","MA","Andover",1999,437,17038,17475
"991","Andover","Essex County County","MA","Andover",2000,337,16032,16369
"992","Andover","Essex County County","MA","Andover",2001,521,16138,16659
"993","Andover","Essex County County","MA","Andover",2002,862,15949,16811
"994","Andover","Essex County County","MA","Andover",2003,865,15755,16620
"995","Andover","Essex County County","MA","Andover",2004,740,15825,16565
"996","Andover","Essex County County","MA","Andover",2005,672,16088,16760
"997","Andover","Essex County County","MA","Andover",2006,691,16039,16730
"998","Andover","Essex County County","MA","Andover",2007,692,16100,16792
"999","Andover","Essex County County","MA","Andover",2008,697,16144,16841
"1000","Andover","Essex County County","MA","Andover",2009,1119,15655,16774
"1001","Andover","Essex County County","MA","Andover",2010,1066,15657,16723
"1002","Andover","Essex County County","MA","Andover",2011,952,15845,16797
"1003","Andover","Essex County County","MA","Andover",2012,834,16018,16852
"1004","Aquinnah","Dukes County County","MA","Aquinnah",1990,8,83,91
"1005","Aquinnah","Dukes County County","MA","Aquinnah",1991,21,81,102
"1006","Aquinnah","Dukes County County","MA","Aquinnah",1992,16,76,92
"1007","Aquinnah","Dukes County County","MA","Aquinnah",1993,18,84,102
"1008","Aquinnah","Dukes County County","MA","Aquinnah",1994,12,94,106
"1009","Aquinnah","Dukes County County","MA","Aquinnah",1995,11,98,109
"1010","Aquinnah","Dukes County County","MA","Aquinnah",1996,14,103,117
"1011","Aquinnah","Dukes County County","MA","Aquinnah",1997,17,107,124
"1012","Aquinnah","Dukes County County","MA","Aquinnah",1998,9,102,111
"1013","Aquinnah","Dukes County County","MA","Aquinnah",1999,8,105,113
"1014","Aquinnah","Dukes County County","MA","Aquinnah",2000,5,225,230
"1015","Aquinnah","Dukes County County","MA","Aquinnah",2001,6,225,231
"1016","Aquinnah","Dukes County County","MA","Aquinnah",2002,10,235,245
"1017","Aquinnah","Dukes County County","MA","Aquinnah",2003,17,242,259
"1018","Aquinnah","Dukes County County","MA","Aquinnah",2004,14,245,259
"1019","Aquinnah","Dukes County County","MA","Aquinnah",2005,13,240,253
"1020","Aquinnah","Dukes County County","MA","Aquinnah",2006,12,242,254
"1021","Aquinnah","Dukes County County","MA","Aquinnah",2007,10,246,256
"1022","Aquinnah","Dukes County County","MA","Aquinnah",2008,13,248,261
"1023","Aquinnah","Dukes County County","MA","Aquinnah",2009,12,246,258
"1024","Aquinnah","Dukes County County","MA","Aquinnah",2010,12,202,214
"1025","Aquinnah","Dukes County County","MA","Aquinnah",2011,17,203,220
"1026","Aquinnah","Dukes County County","MA","Aquinnah",2012,9,205,214
"1027","Arlington","Middlesex County County","MA","Arlington",1990,989,25245,26234
"1028","Arlington","Middlesex County County","MA","Arlington",1991,1316,24087,25403
"1029","Arlington","Middlesex County County","MA","Arlington",1992,1413,23857,25270
"1030","Arlington","Middlesex County County","MA","Arlington",1993,1220,23929,25149
"1031","Arlington","Middlesex County County","MA","Arlington",1994,981,24239,25220
"1032","Arlington","Middlesex County County","MA","Arlington",1995,885,24496,25381
"1033","Arlington","Middlesex County County","MA","Arlington",1996,671,24895,25566
"1034","Arlington","Middlesex County County","MA","Arlington",1997,621,25406,26027
"1035","Arlington","Middlesex County County","MA","Arlington",1998,504,25672,26176
"1036","Arlington","Middlesex County County","MA","Arlington",1999,499,25752,26251
"1037","Arlington","Middlesex County County","MA","Arlington",2000,508,24778,25286
"1038","Arlington","Middlesex County County","MA","Arlington",2001,762,24594,25356
"1039","Arlington","Middlesex County County","MA","Arlington",2002,1181,23996,25177
"1040","Arlington","Middlesex County County","MA","Arlington",2003,1193,23524,24717
"1041","Arlington","Middlesex County County","MA","Arlington",2004,930,23393,24323
"1042","Arlington","Middlesex County County","MA","Arlington",2005,850,23457,24307
"1043","Arlington","Middlesex County County","MA","Arlington",2006,791,23094,23885
"1044","Arlington","Middlesex County County","MA","Arlington",2007,756,23264,24020
"1045","Arlington","Middlesex County County","MA","Arlington",2008,901,23244,24145
"1046","Arlington","Middlesex County County","MA","Arlington",2009,1462,22652,24114
"1047","Arlington","Middlesex County County","MA","Arlington",2010,1420,23613,25033
"1048","Arlington","Middlesex County County","MA","Arlington",2011,1173,23961,25134
"1049","Arlington","Middlesex County County","MA","Arlington",2012,1067,24224,25291
"1050","Ashburnham","Worcester County County","MA","Ashburnham",1990,255,2705,2960
"1051","Ashburnham","Worcester County County","MA","Ashburnham",1991,316,2699,3015
"1052","Ashburnham","Worcester County County","MA","Ashburnham",1992,256,2731,2987
"1053","Ashburnham","Worcester County County","MA","Ashburnham",1993,211,2863,3074
"1054","Ashburnham","Worcester County County","MA","Ashburnham",1994,188,2860,3048
"1055","Ashburnham","Worcester County County","MA","Ashburnham",1995,177,2694,2871
"1056","Ashburnham","Worcester County County","MA","Ashburnham",1996,164,2701,2865
"1057","Ashburnham","Worcester County County","MA","Ashburnham",1997,152,2768,2920
"1058","Ashburnham","Worcester County County","MA","Ashburnham",1998,105,2775,2880
"1059","Ashburnham","Worcester County County","MA","Ashburnham",1999,110,2790,2900
"1060","Ashburnham","Worcester County County","MA","Ashburnham",2000,82,2940,3022
"1061","Ashburnham","Worcester County County","MA","Ashburnham",2001,126,2934,3060
"1062","Ashburnham","Worcester County County","MA","Ashburnham",2002,183,2931,3114
"1063","Ashburnham","Worcester County County","MA","Ashburnham",2003,200,2947,3147
"1064","Ashburnham","Worcester County County","MA","Ashburnham",2004,198,2952,3150
"1065","Ashburnham","Worcester County County","MA","Ashburnham",2005,179,2959,3138
"1066","Ashburnham","Worcester County County","MA","Ashburnham",2006,180,2993,3173
"1067","Ashburnham","Worcester County County","MA","Ashburnham",2007,172,2987,3159
"1068","Ashburnham","Worcester County County","MA","Ashburnham",2008,195,2954,3149
"1069","Ashburnham","Worcester County County","MA","Ashburnham",2009,291,2830,3121
"1070","Ashburnham","Worcester County County","MA","Ashburnham",2010,305,2899,3204
"1071","Ashburnham","Worcester County County","MA","Ashburnham",2011,279,2898,3177
"1072","Ashburnham","Worcester County County","MA","Ashburnham",2012,239,2896,3135
"1073","Ashby","Middlesex County County","MA","Ashby",1990,103,1425,1528
"1074","Ashby","Middlesex County County","MA","Ashby",1991,156,1415,1571
"1075","Ashby","Middlesex County County","MA","Ashby",1992,124,1458,1582
"1076","Ashby","Middlesex County County","MA","Ashby",1993,76,1507,1583
"1077","Ashby","Middlesex County County","MA","Ashby",1994,82,1557,1639
"1078","Ashby","Middlesex County County","MA","Ashby",1995,75,1502,1577
"1079","Ashby","Middlesex County County","MA","Ashby",1996,84,1516,1600
"1080","Ashby","Middlesex County County","MA","Ashby",1997,70,1558,1628
"1081","Ashby","Middlesex County County","MA","Ashby",1998,55,1564,1619
"1082","Ashby","Middlesex County County","MA","Ashby",1999,65,1571,1636
"1083","Ashby","Middlesex County County","MA","Ashby",2000,41,1552,1593
"1084","Ashby","Middlesex County County","MA","Ashby",2001,56,1537,1593
"1085","Ashby","Middlesex County County","MA","Ashby",2002,88,1521,1609
"1086","Ashby","Middlesex County County","MA","Ashby",2003,99,1513,1612
"1087","Ashby","Middlesex County County","MA","Ashby",2004,96,1509,1605
"1088","Ashby","Middlesex County County","MA","Ashby",2005,85,1494,1579
"1089","Ashby","Middlesex County County","MA","Ashby",2006,88,1514,1602
"1090","Ashby","Middlesex County County","MA","Ashby",2007,81,1522,1603
"1091","Ashby","Middlesex County County","MA","Ashby",2008,94,1492,1586
"1092","Ashby","Middlesex County County","MA","Ashby",2009,156,1502,1658
"1093","Ashby","Middlesex County County","MA","Ashby",2010,154,1511,1665
"1094","Ashby","Middlesex County County","MA","Ashby",2011,135,1520,1655
"1095","Ashby","Middlesex County County","MA","Ashby",2012,135,1519,1654
"1096","Ashfield","Franklin County County","MA","Ashfield",1990,52,963,1015
"1097","Ashfield","Franklin County County","MA","Ashfield",1991,72,955,1027
"1098","Ashfield","Franklin County County","MA","Ashfield",1992,58,911,969
"1099","Ashfield","Franklin County County","MA","Ashfield",1993,47,938,985
"1100","Ashfield","Franklin County County","MA","Ashfield",1994,43,965,1008
"1101","Ashfield","Franklin County County","MA","Ashfield",1995,34,979,1013
"1102","Ashfield","Franklin County County","MA","Ashfield",1996,39,984,1023
"1103","Ashfield","Franklin County County","MA","Ashfield",1997,34,1004,1038
"1104","Ashfield","Franklin County County","MA","Ashfield",1998,25,1024,1049
"1105","Ashfield","Franklin County County","MA","Ashfield",1999,23,1042,1065
"1106","Ashfield","Franklin County County","MA","Ashfield",2000,22,1080,1102
"1107","Ashfield","Franklin County County","MA","Ashfield",2001,26,1080,1106
"1108","Ashfield","Franklin County County","MA","Ashfield",2002,37,1079,1116
"1109","Ashfield","Franklin County County","MA","Ashfield",2003,43,1070,1113
"1110","Ashfield","Franklin County County","MA","Ashfield",2004,40,1072,1112
"1111","Ashfield","Franklin County County","MA","Ashfield",2005,35,1079,1114
"1112","Ashfield","Franklin County County","MA","Ashfield",2006,42,1084,1126
"1113","Ashfield","Franklin County County","MA","Ashfield",2007,41,1083,1124
"1114","Ashfield","Franklin County County","MA","Ashfield",2008,43,1077,1120
"1115","Ashfield","Franklin County County","MA","Ashfield",2009,61,1029,1090
"1116","Ashfield","Franklin County County","MA","Ashfield",2010,65,983,1048
"1117","Ashfield","Franklin County County","MA","Ashfield",2011,49,975,1024
"1118","Ashfield","Franklin County County","MA","Ashfield",2012,47,976,1023
"1119","Ashland","Middlesex County County","MA","Ashland",1990,399,7188,7587
"1120","Ashland","Middlesex County County","MA","Ashland",1991,572,7011,7583
"1121","Ashland","Middlesex County County","MA","Ashland",1992,575,7029,7604
"1122","Ashland","Middlesex County County","MA","Ashland",1993,468,7232,7700
"1123","Ashland","Middlesex County County","MA","Ashland",1994,385,7505,7890
"1124","Ashland","Middlesex County County","MA","Ashland",1995,324,7477,7801
"1125","Ashland","Middlesex County County","MA","Ashland",1996,280,7734,8014
"1126","Ashland","Middlesex County County","MA","Ashland",1997,240,8051,8291
"1127","Ashland","Middlesex County County","MA","Ashland",1998,204,8371,8575
"1128","Ashland","Middlesex County County","MA","Ashland",1999,215,8630,8845
"1129","Ashland","Middlesex County County","MA","Ashland",2000,193,8659,8852
"1130","Ashland","Middlesex County County","MA","Ashland",2001,281,8864,9145
"1131","Ashland","Middlesex County County","MA","Ashland",2002,454,8763,9217
"1132","Ashland","Middlesex County County","MA","Ashland",2003,455,8659,9114
"1133","Ashland","Middlesex County County","MA","Ashland",2004,382,8762,9144
"1134","Ashland","Middlesex County County","MA","Ashland",2005,343,8914,9257
"1135","Ashland","Middlesex County County","MA","Ashland",2006,341,9039,9380
"1136","Ashland","Middlesex County County","MA","Ashland",2007,325,9218,9543
"1137","Ashland","Middlesex County County","MA","Ashland",2008,396,9309,9705
"1138","Ashland","Middlesex County County","MA","Ashland",2009,638,8638,9276
"1139","Ashland","Middlesex County County","MA","Ashland",2010,587,9223,9810
"1140","Ashland","Middlesex County County","MA","Ashland",2011,491,9315,9806
"1141","Ashland","Middlesex County County","MA","Ashland",2012,471,9400,9871
"1142","Athol","Worcester County County","MA","Athol",1990,531,4734,5265
"1143","Athol","Worcester County County","MA","Athol",1991,765,4475,5240
"1144","Athol","Worcester County County","MA","Athol",1992,723,4441,5164
"1145","Athol","Worcester County County","MA","Athol",1993,542,4610,5152
"1146","Athol","Worcester County County","MA","Athol",1994,445,4544,4989
"1147","Athol","Worcester County County","MA","Athol",1995,372,4331,4703
"1148","Athol","Worcester County County","MA","Athol",1996,326,4271,4597
"1149","Athol","Worcester County County","MA","Athol",1997,328,4345,4673
"1150","Athol","Worcester County County","MA","Athol",1998,265,4387,4652
"1151","Athol","Worcester County County","MA","Athol",1999,251,4368,4619
"1152","Athol","Worcester County County","MA","Athol",2000,170,5239,5409
"1153","Athol","Worcester County County","MA","Athol",2001,248,5150,5398
"1154","Athol","Worcester County County","MA","Athol",2002,331,5165,5496
"1155","Athol","Worcester County County","MA","Athol",2003,391,5125,5516
"1156","Athol","Worcester County County","MA","Athol",2004,360,5061,5421
"1157","Athol","Worcester County County","MA","Athol",2005,326,5022,5348
"1158","Athol","Worcester County County","MA","Athol",2006,327,4982,5309
"1159","Athol","Worcester County County","MA","Athol",2007,349,4931,5280
"1160","Athol","Worcester County County","MA","Athol",2008,386,4973,5359
"1161","Athol","Worcester County County","MA","Athol",2009,605,4880,5485
"1162","Athol","Worcester County County","MA","Athol",2010,614,4720,5334
"1163","Athol","Worcester County County","MA","Athol",2011,528,4711,5239
"1164","Athol","Worcester County County","MA","Athol",2012,478,4727,5205
"1165","Attleboro","Bristol County County","MA","Attleboro",1990,1656,19919,21575
"1166","Attleboro","Bristol County County","MA","Attleboro",1991,2485,19164,21649
"1167","Attleboro","Bristol County County","MA","Attleboro",1992,2365,19259,21624
"1168","Attleboro","Bristol County County","MA","Attleboro",1993,1788,19685,21473
"1169","Attleboro","Bristol County County","MA","Attleboro",1994,1616,20056,21672
"1170","Attleboro","Bristol County County","MA","Attleboro",1995,1509,20279,21788
"1171","Attleboro","Bristol County County","MA","Attleboro",1996,1255,20441,21696
"1172","Attleboro","Bristol County County","MA","Attleboro",1997,1146,20910,22056
"1173","Attleboro","Bristol County County","MA","Attleboro",1998,868,21292,22160
"1174","Attleboro","Bristol County County","MA","Attleboro",1999,781,21560,22341
"1175","Attleboro","Bristol County County","MA","Attleboro",2000,773,22870,23643
"1176","Attleboro","Bristol County County","MA","Attleboro",2001,1099,22824,23923
"1177","Attleboro","Bristol County County","MA","Attleboro",2002,1468,23113,24581
"1178","Attleboro","Bristol County County","MA","Attleboro",2003,1454,23339,24793
"1179","Attleboro","Bristol County County","MA","Attleboro",2004,1406,23394,24800
"1180","Attleboro","Bristol County County","MA","Attleboro",2005,1328,23491,24819
"1181","Attleboro","Bristol County County","MA","Attleboro",2006,1290,23682,24972
"1182","Attleboro","Bristol County County","MA","Attleboro",2007,1220,23649,24869
"1183","Attleboro","Bristol County County","MA","Attleboro",2008,1588,23145,24733
"1184","Attleboro","Bristol County County","MA","Attleboro",2009,2605,22453,25058
"1185","Attleboro","Bristol County County","MA","Attleboro",2010,2515,22387,24902
"1186","Attleboro","Bristol County County","MA","Attleboro",2011,2309,22551,24860
"1187","Attleboro","Bristol County County","MA","Attleboro",2012,2220,22586,24806
"1188","Auburn","Worcester County County","MA","Auburn",1990,591,7929,8520
"1189","Auburn","Worcester County County","MA","Auburn",1991,737,7718,8455
"1190","Auburn","Worcester County County","MA","Auburn",1992,655,7696,8351
"1191","Auburn","Worcester County County","MA","Auburn",1993,497,7848,8345
"1192","Auburn","Worcester County County","MA","Auburn",1994,395,8017,8412
"1193","Auburn","Worcester County County","MA","Auburn",1995,359,7879,8238
"1194","Auburn","Worcester County County","MA","Auburn",1996,294,7986,8280
"1195","Auburn","Worcester County County","MA","Auburn",1997,262,8258,8520
"1196","Auburn","Worcester County County","MA","Auburn",1998,227,8558,8785
"1197","Auburn","Worcester County County","MA","Auburn",1999,220,8628,8848
"1198","Auburn","Worcester County County","MA","Auburn",2000,220,8484,8704
"1199","Auburn","Worcester County County","MA","Auburn",2001,260,8497,8757
"1200","Auburn","Worcester County County","MA","Auburn",2002,429,8459,8888
"1201","Auburn","Worcester County County","MA","Auburn",2003,481,8443,8924
"1202","Auburn","Worcester County County","MA","Auburn",2004,413,8427,8840
"1203","Auburn","Worcester County County","MA","Auburn",2005,381,8411,8792
"1204","Auburn","Worcester County County","MA","Auburn",2006,363,8454,8817
"1205","Auburn","Worcester County County","MA","Auburn",2007,384,8456,8840
"1206","Auburn","Worcester County County","MA","Auburn",2008,428,8289,8717
"1207","Auburn","Worcester County County","MA","Auburn",2009,698,8058,8756
"1208","Auburn","Worcester County County","MA","Auburn",2010,713,7947,8660
"1209","Auburn","Worcester County County","MA","Auburn",2011,602,8017,8619
"1210","Auburn","Worcester County County","MA","Auburn",2012,593,8015,8608
"1211","Avon","Norfolk County County","MA","Avon",1990,187,2344,2531
"1212","Avon","Norfolk County County","MA","Avon",1991,311,2247,2558
"1213","Avon","Norfolk County County","MA","Avon",1992,280,2220,2500
"1214","Avon","Norfolk County County","MA","Avon",1993,202,2271,2473
"1215","Avon","Norfolk County County","MA","Avon",1994,194,2343,2537
"1216","Avon","Norfolk County County","MA","Avon",1995,163,2425,2588
"1217","Avon","Norfolk County County","MA","Avon",1996,154,2433,2587
"1218","Avon","Norfolk County County","MA","Avon",1997,126,2491,2617
"1219","Avon","Norfolk County County","MA","Avon",1998,98,2497,2595
"1220","Avon","Norfolk County County","MA","Avon",1999,88,2509,2597
"1221","Avon","Norfolk County County","MA","Avon",2000,68,2302,2370
"1222","Avon","Norfolk County County","MA","Avon",2001,82,2281,2363
"1223","Avon","Norfolk County County","MA","Avon",2002,126,2232,2358
"1224","Avon","Norfolk County County","MA","Avon",2003,146,2165,2311
"1225","Avon","Norfolk County County","MA","Avon",2004,134,2148,2282
"1226","Avon","Norfolk County County","MA","Avon",2005,126,2133,2259
"1227","Avon","Norfolk County County","MA","Avon",2006,124,2154,2278
"1228","Avon","Norfolk County County","MA","Avon",2007,118,2172,2290
"1229","Avon","Norfolk County County","MA","Avon",2008,139,2155,2294
"1230","Avon","Norfolk County County","MA","Avon",2009,229,2119,2348
"1231","Avon","Norfolk County County","MA","Avon",2010,212,2107,2319
"1232","Avon","Norfolk County County","MA","Avon",2011,180,2131,2311
"1233","Avon","Norfolk County County","MA","Avon",2012,162,2149,2311
"1234","Ayer","Middlesex County County","MA","Ayer",1990,241,3325,3566
"1235","Ayer","Middlesex County County","MA","Ayer",1991,338,3249,3587
"1236","Ayer","Middlesex County County","MA","Ayer",1992,325,3243,3568
"1237","Ayer","Middlesex County County","MA","Ayer",1993,300,3295,3595
"1238","Ayer","Middlesex County County","MA","Ayer",1994,273,3367,3640
"1239","Ayer","Middlesex County County","MA","Ayer",1995,227,3480,3707
"1240","Ayer","Middlesex County County","MA","Ayer",1996,174,3587,3761
"1241","Ayer","Middlesex County County","MA","Ayer",1997,133,3706,3839
"1242","Ayer","Middlesex County County","MA","Ayer",1998,126,3761,3887
"1243","Ayer","Middlesex County County","MA","Ayer",1999,133,3856,3989
"1244","Ayer","Middlesex County County","MA","Ayer",2000,99,4090,4189
"1245","Ayer","Middlesex County County","MA","Ayer",2001,163,4083,4246
"1246","Ayer","Middlesex County County","MA","Ayer",2002,237,3993,4230
"1247","Ayer","Middlesex County County","MA","Ayer",2003,260,3913,4173
"1248","Ayer","Middlesex County County","MA","Ayer",2004,216,3895,4111
"1249","Ayer","Middlesex County County","MA","Ayer",2005,213,3945,4158
"1250","Ayer","Middlesex County County","MA","Ayer",2006,190,4018,4208
"1251","Ayer","Middlesex County County","MA","Ayer",2007,188,4140,4328
"1252","Ayer","Middlesex County County","MA","Ayer",2008,227,4174,4401
"1253","Ayer","Middlesex County County","MA","Ayer",2009,349,4091,4440
"1254","Ayer","Middlesex County County","MA","Ayer",2010,352,3926,4278
"1255","Ayer","Middlesex County County","MA","Ayer",2011,312,3982,4294
"1256","Ayer","Middlesex County County","MA","Ayer",2012,277,4026,4303
"1257","Barnstable","Barnstable County County","MA","Barnstable",1990,2023,20340,22363
"1258","Barnstable","Barnstable County County","MA","Barnstable",1991,2390,19553,21943
"1259","Barnstable","Barnstable County County","MA","Barnstable",1992,2268,19351,21619
"1260","Barnstable","Barnstable County County","MA","Barnstable",1993,1965,19866,21831
"1261","Barnstable","Barnstable County County","MA","Barnstable",1994,1761,20265,22026
"1262","Barnstable","Barnstable County County","MA","Barnstable",1995,1378,20986,22364
"1263","Barnstable","Barnstable County County","MA","Barnstable",1996,1255,21461,22716
"1264","Barnstable","Barnstable County County","MA","Barnstable",1997,1164,21887,23051
"1265","Barnstable","Barnstable County County","MA","Barnstable",1998,942,22396,23338
"1266","Barnstable","Barnstable County County","MA","Barnstable",1999,857,23212,24069
"1267","Barnstable","Barnstable County County","MA","Barnstable",2000,762,24628,25390
"1268","Barnstable","Barnstable County County","MA","Barnstable",2001,873,24817,25690
"1269","Barnstable","Barnstable County County","MA","Barnstable",2002,1115,25248,26363
"1270","Barnstable","Barnstable County County","MA","Barnstable",2003,1265,25677,26942
"1271","Barnstable","Barnstable County County","MA","Barnstable",2004,1217,25854,27071
"1272","Barnstable","Barnstable County County","MA","Barnstable",2005,1204,25626,26830
"1273","Barnstable","Barnstable County County","MA","Barnstable",2006,1190,25631,26821
"1274","Barnstable","Barnstable County County","MA","Barnstable",2007,1125,25430,26555
"1275","Barnstable","Barnstable County County","MA","Barnstable",2008,1370,25098,26468
"1276","Barnstable","Barnstable County County","MA","Barnstable",2009,2070,24449,26519
"1277","Barnstable","Barnstable County County","MA","Barnstable",2010,2126,24215,26341
"1278","Barnstable","Barnstable County County","MA","Barnstable",2011,1907,24174,26081
"1279","Barnstable","Barnstable County County","MA","Barnstable",2012,1748,24579,26327
"1280",NA,"Barnstable County County","MA","Barnstable County County",1990,7220,90285,97505
"1281",NA,"Barnstable County County","MA","Barnstable County County",1991,10034,87680,97714
"1282",NA,"Barnstable County County","MA","Barnstable County County",1992,10512,87131,97643
"1283",NA,"Barnstable County County","MA","Barnstable County County",1993,9481,90495,99976
"1284",NA,"Barnstable County County","MA","Barnstable County County",1994,8667,92498,101165
"1285",NA,"Barnstable County County","MA","Barnstable County County",1995,7378,95070,102448
"1286",NA,"Barnstable County County","MA","Barnstable County County",1996,6432,97295,103727
"1287",NA,"Barnstable County County","MA","Barnstable County County",1997,6220,99207,105427
"1288",NA,"Barnstable County County","MA","Barnstable County County",1998,5347,101312,106659
"1289",NA,"Barnstable County County","MA","Barnstable County County",1999,4754,104664,109418
"1290",NA,"Barnstable County County","MA","Barnstable County County",2000,3919,109564,113483
"1291",NA,"Barnstable County County","MA","Barnstable County County",2001,4454,110854,115308
"1292",NA,"Barnstable County County","MA","Barnstable County County",2002,5592,113093,118685
"1293",NA,"Barnstable County County","MA","Barnstable County County",2003,6414,115428,121842
"1294",NA,"Barnstable County County","MA","Barnstable County County",2004,6199,116532,122731
"1295",NA,"Barnstable County County","MA","Barnstable County County",2005,6005,116107,122112
"1296",NA,"Barnstable County County","MA","Barnstable County County",2006,6079,116354,122433
"1297",NA,"Barnstable County County","MA","Barnstable County County",2007,5822,115658,121480
"1298",NA,"Barnstable County County","MA","Barnstable County County",2008,7114,114928,122042
"1299",NA,"Barnstable County County","MA","Barnstable County County",2009,10284,111792,122076
"1300",NA,"Barnstable County County","MA","Barnstable County County",2010,10896,110726,121622
"1301",NA,"Barnstable County County","MA","Barnstable County County",2011,9843,110543,120386
"1302",NA,"Barnstable County County","MA","Barnstable County County",2012,8953,112398,121351
"1303","Barre","Worcester County County","MA","Barre",1990,197,2137,2334
"1304","Barre","Worcester County County","MA","Barre",1991,267,2086,2353
"1305","Barre","Worcester County County","MA","Barre",1992,277,2121,2398
"1306","Barre","Worcester County County","MA","Barre",1993,213,2202,2415
"1307","Barre","Worcester County County","MA","Barre",1994,164,2229,2393
"1308","Barre","Worcester County County","MA","Barre",1995,129,2203,2332
"1309","Barre","Worcester County County","MA","Barre",1996,100,2251,2351
"1310","Barre","Worcester County County","MA","Barre",1997,117,2325,2442
"1311","Barre","Worcester County County","MA","Barre",1998,107,2389,2496
"1312","Barre","Worcester County County","MA","Barre",1999,90,2388,2478
"1313","Barre","Worcester County County","MA","Barre",2000,81,2566,2647
"1314","Barre","Worcester County County","MA","Barre",2001,109,2588,2697
"1315","Barre","Worcester County County","MA","Barre",2002,160,2585,2745
"1316","Barre","Worcester County County","MA","Barre",2003,174,2587,2761
"1317","Barre","Worcester County County","MA","Barre",2004,171,2587,2758
"1318","Barre","Worcester County County","MA","Barre",2005,152,2590,2742
"1319","Barre","Worcester County County","MA","Barre",2006,150,2694,2844
"1320","Barre","Worcester County County","MA","Barre",2007,154,2708,2862
"1321","Barre","Worcester County County","MA","Barre",2008,184,2649,2833
"1322","Barre","Worcester County County","MA","Barre",2009,271,2578,2849
"1323","Barre","Worcester County County","MA","Barre",2010,279,2487,2766
"1324","Barre","Worcester County County","MA","Barre",2011,240,2509,2749
"1325","Barre","Worcester County County","MA","Barre",2012,227,2508,2735
"1326","Becket","Berkshire County County","MA","Becket",1990,43,715,758
"1327","Becket","Berkshire County County","MA","Becket",1991,73,696,769
"1328","Becket","Berkshire County County","MA","Becket",1992,60,764,824
"1329","Becket","Berkshire County County","MA","Becket",1993,45,784,829
"1330","Becket","Berkshire County County","MA","Becket",1994,47,863,910
"1331","Becket","Berkshire County County","MA","Becket",1995,47,848,895
"1332","Becket","Berkshire County County","MA","Becket",1996,35,825,860
"1333","Becket","Berkshire County County","MA","Becket",1997,50,832,882
"1334","Becket","Berkshire County County","MA","Becket",1998,36,878,914
"1335","Becket","Berkshire County County","MA","Becket",1999,27,949,976
"1336","Becket","Berkshire County County","MA","Becket",2000,22,907,929
"1337","Becket","Berkshire County County","MA","Becket",2001,25,906,931
"1338","Becket","Berkshire County County","MA","Becket",2002,30,923,953
"1339","Becket","Berkshire County County","MA","Becket",2003,41,928,969
"1340","Becket","Berkshire County County","MA","Becket",2004,38,937,975
"1341","Becket","Berkshire County County","MA","Becket",2005,41,959,1000
"1342","Becket","Berkshire County County","MA","Becket",2006,46,988,1034
"1343","Becket","Berkshire County County","MA","Becket",2007,49,990,1039
"1344","Becket","Berkshire County County","MA","Becket",2008,61,985,1046
"1345","Becket","Berkshire County County","MA","Becket",2009,96,958,1054
"1346","Becket","Berkshire County County","MA","Becket",2010,94,912,1006
"1347","Becket","Berkshire County County","MA","Becket",2011,78,920,998
"1348","Becket","Berkshire County County","MA","Becket",2012,74,915,989
"1349","Bedford","Middlesex County County","MA","Bedford",1990,302,6643,6945
"1350","Bedford","Middlesex County County","MA","Bedford",1991,397,6555,6952
"1351","Bedford","Middlesex County County","MA","Bedford",1992,428,6401,6829
"1352","Bedford","Middlesex County County","MA","Bedford",1993,345,6290,6635
"1353","Bedford","Middlesex County County","MA","Bedford",1994,284,6405,6689
"1354","Bedford","Middlesex County County","MA","Bedford",1995,246,6834,7080
"1355","Bedford","Middlesex County County","MA","Bedford",1996,214,7043,7257
"1356","Bedford","Middlesex County County","MA","Bedford",1997,162,7270,7432
"1357","Bedford","Middlesex County County","MA","Bedford",1998,146,7328,7474
"1358","Bedford","Middlesex County County","MA","Bedford",1999,145,7412,7557
"1359","Bedford","Middlesex County County","MA","Bedford",2000,158,6548,6706
"1360","Bedford","Middlesex County County","MA","Bedford",2001,237,6532,6769
"1361","Bedford","Middlesex County County","MA","Bedford",2002,351,6366,6717
"1362","Bedford","Middlesex County County","MA","Bedford",2003,358,6274,6632
"1363","Bedford","Middlesex County County","MA","Bedford",2004,274,6258,6532
"1364","Bedford","Middlesex County County","MA","Bedford",2005,241,6300,6541
"1365","Bedford","Middlesex County County","MA","Bedford",2006,257,6403,6660
"1366","Bedford","Middlesex County County","MA","Bedford",2007,221,6571,6792
"1367","Bedford","Middlesex County County","MA","Bedford",2008,287,6809,7096
"1368","Bedford","Middlesex County County","MA","Bedford",2009,446,6663,7109
"1369","Bedford","Middlesex County County","MA","Bedford",2010,417,6522,6939
"1370","Bedford","Middlesex County County","MA","Bedford",2011,398,6616,7014
"1371","Bedford","Middlesex County County","MA","Bedford",2012,350,6689,7039
"1372","Belchertown","Hampshire County County","MA","Belchertown",1990,298,5711,6009
"1373","Belchertown","Hampshire County County","MA","Belchertown",1991,425,5647,6072
"1374","Belchertown","Hampshire County County","MA","Belchertown",1992,460,5706,6166
"1375","Belchertown","Hampshire County County","MA","Belchertown",1993,406,5777,6183
"1376","Belchertown","Hampshire County County","MA","Belchertown",1994,338,6029,6367
"1377","Belchertown","Hampshire County County","MA","Belchertown",1995,262,5987,6249
"1378","Belchertown","Hampshire County County","MA","Belchertown",1996,215,6162,6377
"1379","Belchertown","Hampshire County County","MA","Belchertown",1997,204,6362,6566
"1380","Belchertown","Hampshire County County","MA","Belchertown",1998,197,6486,6683
"1381","Belchertown","Hampshire County County","MA","Belchertown",1999,180,6621,6801
"1382","Belchertown","Hampshire County County","MA","Belchertown",2000,161,7468,7629
"1383","Belchertown","Hampshire County County","MA","Belchertown",2001,202,7563,7765
"1384","Belchertown","Hampshire County County","MA","Belchertown",2002,286,7630,7916
"1385","Belchertown","Hampshire County County","MA","Belchertown",2003,349,7670,8019
"1386","Belchertown","Hampshire County County","MA","Belchertown",2004,371,7777,8148
"1387","Belchertown","Hampshire County County","MA","Belchertown",2005,422,7881,8303
"1388","Belchertown","Hampshire County County","MA","Belchertown",2006,380,8018,8398
"1389","Belchertown","Hampshire County County","MA","Belchertown",2007,326,7965,8291
"1390","Belchertown","Hampshire County County","MA","Belchertown",2008,358,8041,8399
"1391","Belchertown","Hampshire County County","MA","Belchertown",2009,514,7696,8210
"1392","Belchertown","Hampshire County County","MA","Belchertown",2010,574,7920,8494
"1393","Belchertown","Hampshire County County","MA","Belchertown",2011,474,7820,8294
"1394","Belchertown","Hampshire County County","MA","Belchertown",2012,458,7825,8283
"1395","Bellingham","Norfolk County County","MA","Bellingham",1990,668,8212,8880
"1396","Bellingham","Norfolk County County","MA","Bellingham",1991,860,7973,8833
"1397","Bellingham","Norfolk County County","MA","Bellingham",1992,794,7931,8725
"1398","Bellingham","Norfolk County County","MA","Bellingham",1993,649,8069,8718
"1399","Bellingham","Norfolk County County","MA","Bellingham",1994,552,8235,8787
"1400","Bellingham","Norfolk County County","MA","Bellingham",1995,504,8419,8923
"1401","Bellingham","Norfolk County County","MA","Bellingham",1996,419,8616,9035
"1402","Bellingham","Norfolk County County","MA","Bellingham",1997,387,8883,9270
"1403","Bellingham","Norfolk County County","MA","Bellingham",1998,288,9086,9374
"1404","Bellingham","Norfolk County County","MA","Bellingham",1999,296,9246,9542
"1405","Bellingham","Norfolk County County","MA","Bellingham",2000,262,8926,9188
"1406","Bellingham","Norfolk County County","MA","Bellingham",2001,373,8896,9269
"1407","Bellingham","Norfolk County County","MA","Bellingham",2002,508,8933,9441
"1408","Bellingham","Norfolk County County","MA","Bellingham",2003,546,9034,9580
"1409","Bellingham","Norfolk County County","MA","Bellingham",2004,478,9103,9581
"1410","Bellingham","Norfolk County County","MA","Bellingham",2005,436,9174,9610
"1411","Bellingham","Norfolk County County","MA","Bellingham",2006,473,9335,9808
"1412","Bellingham","Norfolk County County","MA","Bellingham",2007,449,9365,9814
"1413","Bellingham","Norfolk County County","MA","Bellingham",2008,563,9222,9785
"1414","Bellingham","Norfolk County County","MA","Bellingham",2009,943,8767,9710
"1415","Bellingham","Norfolk County County","MA","Bellingham",2010,991,9002,9993
"1416","Bellingham","Norfolk County County","MA","Bellingham",2011,895,9121,10016
"1417","Bellingham","Norfolk County County","MA","Bellingham",2012,815,9135,9950
"1418","Belmont","Middlesex County County","MA","Belmont",1990,437,13097,13534
"1419","Belmont","Middlesex County County","MA","Belmont",1991,599,12484,13083
"1420","Belmont","Middlesex County County","MA","Belmont",1992,589,12347,12936
"1421","Belmont","Middlesex County County","MA","Belmont",1993,549,12524,13073
"1422","Belmont","Middlesex County County","MA","Belmont",1994,481,12652,13133
"1423","Belmont","Middlesex County County","MA","Belmont",1995,396,12631,13027
"1424","Belmont","Middlesex County County","MA","Belmont",1996,327,12827,13154
"1425","Belmont","Middlesex County County","MA","Belmont",1997,271,13084,13355
"1426","Belmont","Middlesex County County","MA","Belmont",1998,208,13166,13374
"1427","Belmont","Middlesex County County","MA","Belmont",1999,226,13214,13440
"1428","Belmont","Middlesex County County","MA","Belmont",2000,246,13124,13370
"1429","Belmont","Middlesex County County","MA","Belmont",2001,400,13022,13422
"1430","Belmont","Middlesex County County","MA","Belmont",2002,552,12713,13265
"1431","Belmont","Middlesex County County","MA","Belmont",2003,590,12436,13026
"1432","Belmont","Middlesex County County","MA","Belmont",2004,447,12335,12782
"1433","Belmont","Middlesex County County","MA","Belmont",2005,409,12342,12751
"1434","Belmont","Middlesex County County","MA","Belmont",2006,401,12147,12548
"1435","Belmont","Middlesex County County","MA","Belmont",2007,367,12237,12604
"1436","Belmont","Middlesex County County","MA","Belmont",2008,450,12248,12698
"1437","Belmont","Middlesex County County","MA","Belmont",2009,730,11955,12685
"1438","Belmont","Middlesex County County","MA","Belmont",2010,740,12649,13389
"1439","Belmont","Middlesex County County","MA","Belmont",2011,628,12836,13464
"1440","Belmont","Middlesex County County","MA","Belmont",2012,599,12977,13576
"1441","Berkley","Bristol County County","MA","Berkley",1990,174,2226,2400
"1442","Berkley","Bristol County County","MA","Berkley",1991,251,2268,2519
"1443","Berkley","Bristol County County","MA","Berkley",1992,248,2384,2632
"1444","Berkley","Bristol County County","MA","Berkley",1993,201,2568,2769
"1445","Berkley","Bristol County County","MA","Berkley",1994,189,2779,2968
"1446","Berkley","Bristol County County","MA","Berkley",1995,165,2627,2792
"1447","Berkley","Bristol County County","MA","Berkley",1996,143,2727,2870
"1448","Berkley","Bristol County County","MA","Berkley",1997,138,2833,2971
"1449","Berkley","Bristol County County","MA","Berkley",1998,104,2918,3022
"1450","Berkley","Bristol County County","MA","Berkley",1999,93,2984,3077
"1451","Berkley","Bristol County County","MA","Berkley",2000,76,3263,3339
"1452","Berkley","Bristol County County","MA","Berkley",2001,100,3319,3419
"1453","Berkley","Bristol County County","MA","Berkley",2002,138,3415,3553
"1454","Berkley","Bristol County County","MA","Berkley",2003,174,3466,3640
"1455","Berkley","Bristol County County","MA","Berkley",2004,159,3480,3639
"1456","Berkley","Bristol County County","MA","Berkley",2005,157,3557,3714
"1457","Berkley","Bristol County County","MA","Berkley",2006,161,3610,3771
"1458","Berkley","Bristol County County","MA","Berkley",2007,152,3665,3817
"1459","Berkley","Bristol County County","MA","Berkley",2008,200,3676,3876
"1460","Berkley","Bristol County County","MA","Berkley",2009,305,3569,3874
"1461","Berkley","Bristol County County","MA","Berkley",2010,307,3494,3801
"1462","Berkley","Bristol County County","MA","Berkley",2011,269,3530,3799
"1463","Berkley","Bristol County County","MA","Berkley",2012,253,3519,3772
"1464",NA,"Berkshire County County","MA","Berkshire County County",1990,4959,64944,69903
"1465",NA,"Berkshire County County","MA","Berkshire County County",1991,7579,62120,69699
"1466",NA,"Berkshire County County","MA","Berkshire County County",1992,7319,61249,68568
"1467",NA,"Berkshire County County","MA","Berkshire County County",1993,5818,62126,67944
"1468",NA,"Berkshire County County","MA","Berkshire County County",1994,5162,61842,67004
"1469",NA,"Berkshire County County","MA","Berkshire County County",1995,4186,61898,66084
"1470",NA,"Berkshire County County","MA","Berkshire County County",1996,3454,62717,66171
"1471",NA,"Berkshire County County","MA","Berkshire County County",1997,3278,63296,66574
"1472",NA,"Berkshire County County","MA","Berkshire County County",1998,2632,63487,66119
"1473",NA,"Berkshire County County","MA","Berkshire County County",1999,2541,63818,66359
"1474",NA,"Berkshire County County","MA","Berkshire County County",2000,2068,68092,70160
"1475",NA,"Berkshire County County","MA","Berkshire County County",2001,2492,68590,71082
"1476",NA,"Berkshire County County","MA","Berkshire County County",2002,3311,69395,72706
"1477",NA,"Berkshire County County","MA","Berkshire County County",2003,3696,68958,72654
"1478",NA,"Berkshire County County","MA","Berkshire County County",2004,3420,68705,72125
"1479",NA,"Berkshire County County","MA","Berkshire County County",2005,3161,69485,72646
"1480",NA,"Berkshire County County","MA","Berkshire County County",2006,3175,70292,73467
"1481",NA,"Berkshire County County","MA","Berkshire County County",2007,3212,69717,72929
"1482",NA,"Berkshire County County","MA","Berkshire County County",2008,3767,69288,73055
"1483",NA,"Berkshire County County","MA","Berkshire County County",2009,5667,67425,73092
"1484",NA,"Berkshire County County","MA","Berkshire County County",2010,5881,66909,72790
"1485",NA,"Berkshire County County","MA","Berkshire County County",2011,5223,67309,72532
"1486",NA,"Berkshire County County","MA","Berkshire County County",2012,4817,66814,71631
"1487","Berlin","Worcester County County","MA","Berlin",1990,83,1286,1369
"1488","Berlin","Worcester County County","MA","Berlin",1991,105,1239,1344
"1489","Berlin","Worcester County County","MA","Berlin",1992,114,1250,1364
"1490","Berlin","Worcester County County","MA","Berlin",1993,95,1277,1372
"1491","Berlin","Worcester County County","MA","Berlin",1994,79,1301,1380
"1492","Berlin","Worcester County County","MA","Berlin",1995,83,1286,1369
"1493","Berlin","Worcester County County","MA","Berlin",1996,57,1316,1373
"1494","Berlin","Worcester County County","MA","Berlin",1997,57,1361,1418
"1495","Berlin","Worcester County County","MA","Berlin",1998,38,1397,1435
"1496","Berlin","Worcester County County","MA","Berlin",1999,46,1432,1478
"1497","Berlin","Worcester County County","MA","Berlin",2000,37,1304,1341
"1498","Berlin","Worcester County County","MA","Berlin",2001,52,1331,1383
"1499","Berlin","Worcester County County","MA","Berlin",2002,93,1364,1457
"1500","Berlin","Worcester County County","MA","Berlin",2003,89,1389,1478
"1501","Berlin","Worcester County County","MA","Berlin",2004,66,1405,1471
"1502","Berlin","Worcester County County","MA","Berlin",2005,71,1433,1504
"1503","Berlin","Worcester County County","MA","Berlin",2006,65,1457,1522
"1504","Berlin","Worcester County County","MA","Berlin",2007,67,1464,1531
"1505","Berlin","Worcester County County","MA","Berlin",2008,72,1562,1634
"1506","Berlin","Worcester County County","MA","Berlin",2009,122,1537,1659
"1507","Berlin","Worcester County County","MA","Berlin",2010,126,1481,1607
"1508","Berlin","Worcester County County","MA","Berlin",2011,100,1485,1585
"1509","Berlin","Worcester County County","MA","Berlin",2012,89,1499,1588
"1510","Bernardston","Franklin County County","MA","Bernardston",1990,63,1028,1091
"1511","Bernardston","Franklin County County","MA","Bernardston",1991,97,1028,1125
"1512","Bernardston","Franklin County County","MA","Bernardston",1992,78,989,1067
"1513","Bernardston","Franklin County County","MA","Bernardston",1993,68,960,1028
"1514","Bernardston","Franklin County County","MA","Bernardston",1994,70,1002,1072
"1515","Bernardston","Franklin County County","MA","Bernardston",1995,54,1050,1104
"1516","Bernardston","Franklin County County","MA","Bernardston",1996,40,1059,1099
"1517","Bernardston","Franklin County County","MA","Bernardston",1997,47,1088,1135
"1518","Bernardston","Franklin County County","MA","Bernardston",1998,38,1107,1145
"1519","Bernardston","Franklin County County","MA","Bernardston",1999,41,1132,1173
"1520","Bernardston","Franklin County County","MA","Bernardston",2000,32,1164,1196
"1521","Bernardston","Franklin County County","MA","Bernardston",2001,42,1163,1205
"1522","Bernardston","Franklin County County","MA","Bernardston",2002,52,1182,1234
"1523","Bernardston","Franklin County County","MA","Bernardston",2003,58,1190,1248
"1524","Bernardston","Franklin County County","MA","Bernardston",2004,57,1180,1237
"1525","Bernardston","Franklin County County","MA","Bernardston",2005,55,1191,1246
"1526","Bernardston","Franklin County County","MA","Bernardston",2006,54,1196,1250
"1527","Bernardston","Franklin County County","MA","Bernardston",2007,44,1183,1227
"1528","Bernardston","Franklin County County","MA","Bernardston",2008,54,1168,1222
"1529","Bernardston","Franklin County County","MA","Bernardston",2009,90,1136,1226
"1530","Bernardston","Franklin County County","MA","Bernardston",2010,99,1103,1202
"1531","Bernardston","Franklin County County","MA","Bernardston",2011,85,1104,1189
"1532","Bernardston","Franklin County County","MA","Bernardston",2012,69,1107,1176
"1533","Beverly","Essex County County","MA","Beverly",1990,1087,20193,21280
"1534","Beverly","Essex County County","MA","Beverly",1991,1474,19583,21057
"1535","Beverly","Essex County County","MA","Beverly",1992,1614,19470,21084
"1536","Beverly","Essex County County","MA","Beverly",1993,1166,19728,20894
"1537","Beverly","Essex County County","MA","Beverly",1994,991,20064,21055
"1538","Beverly","Essex County County","MA","Beverly",1995,817,20120,20937
"1539","Beverly","Essex County County","MA","Beverly",1996,731,20508,21239
"1540","Beverly","Essex County County","MA","Beverly",1997,655,21100,21755
"1541","Beverly","Essex County County","MA","Beverly",1998,575,21486,22061
"1542","Beverly","Essex County County","MA","Beverly",1999,556,21675,22231
"1543","Beverly","Essex County County","MA","Beverly",2000,476,21310,21786
"1544","Beverly","Essex County County","MA","Beverly",2001,687,21346,22033
"1545","Beverly","Essex County County","MA","Beverly",2002,1023,21041,22064
"1546","Beverly","Essex County County","MA","Beverly",2003,1096,20726,21822
"1547","Beverly","Essex County County","MA","Beverly",2004,1057,20629,21686
"1548","Beverly","Essex County County","MA","Beverly",2005,931,20710,21641
"1549","Beverly","Essex County County","MA","Beverly",2006,886,20412,21298
"1550","Beverly","Essex County County","MA","Beverly",2007,836,20416,21252
"1551","Beverly","Essex County County","MA","Beverly",2008,1019,20356,21375
"1552","Beverly","Essex County County","MA","Beverly",2009,1584,19583,21167
"1553","Beverly","Essex County County","MA","Beverly",2010,1590,19871,21461
"1554","Beverly","Essex County County","MA","Beverly",2011,1380,20105,21485
"1555","Beverly","Essex County County","MA","Beverly",2012,1255,20325,21580
"1556","Billerica","Middlesex County County","MA","Billerica",1990,1435,21287,22722
"1557","Billerica","Middlesex County County","MA","Billerica",1991,1977,20558,22535
"1558","Billerica","Middlesex County County","MA","Billerica",1992,2178,20514,22692
"1559","Billerica","Middlesex County County","MA","Billerica",1993,1831,20663,22494
"1560","Billerica","Middlesex County County","MA","Billerica",1994,1467,20820,22287
"1561","Billerica","Middlesex County County","MA","Billerica",1995,1208,20807,22015
"1562","Billerica","Middlesex County County","MA","Billerica",1996,1036,21577,22613
"1563","Billerica","Middlesex County County","MA","Billerica",1997,889,22518,23407
"1564","Billerica","Middlesex County County","MA","Billerica",1998,744,23221,23965
"1565","Billerica","Middlesex County County","MA","Billerica",1999,781,23977,24758
"1566","Billerica","Middlesex County County","MA","Billerica",2000,557,21528,22085
"1567","Billerica","Middlesex County County","MA","Billerica",2001,816,21620,22436
"1568","Billerica","Middlesex County County","MA","Billerica",2002,1331,21307,22638
"1569","Billerica","Middlesex County County","MA","Billerica",2003,1406,20993,22399
"1570","Billerica","Middlesex County County","MA","Billerica",2004,1201,21142,22343
"1571","Billerica","Middlesex County County","MA","Billerica",2005,1026,21299,22325
"1572","Billerica","Middlesex County County","MA","Billerica",2006,1000,22039,23039
"1573","Billerica","Middlesex County County","MA","Billerica",2007,979,22373,23352
"1574","Billerica","Middlesex County County","MA","Billerica",2008,1129,22211,23340
"1575","Billerica","Middlesex County County","MA","Billerica",2009,1827,20546,22373
"1576","Billerica","Middlesex County County","MA","Billerica",2010,1811,20893,22704
"1577","Billerica","Middlesex County County","MA","Billerica",2011,1520,21114,22634
"1578","Billerica","Middlesex County County","MA","Billerica",2012,1427,21347,22774
"1579","Blackstone","Worcester County County","MA","Blackstone",1990,400,4115,4515
"1580","Blackstone","Worcester County County","MA","Blackstone",1991,530,4034,4564
"1581","Blackstone","Worcester County County","MA","Blackstone",1992,554,4003,4557
"1582","Blackstone","Worcester County County","MA","Blackstone",1993,391,4087,4478
"1583","Blackstone","Worcester County County","MA","Blackstone",1994,325,4213,4538
"1584","Blackstone","Worcester County County","MA","Blackstone",1995,311,4145,4456
"1585","Blackstone","Worcester County County","MA","Blackstone",1996,296,4222,4518
"1586","Blackstone","Worcester County County","MA","Blackstone",1997,242,4345,4587
"1587","Blackstone","Worcester County County","MA","Blackstone",1998,182,4434,4616
"1588","Blackstone","Worcester County County","MA","Blackstone",1999,179,4508,4687
"1589","Blackstone","Worcester County County","MA","Blackstone",2000,158,4914,5072
"1590","Blackstone","Worcester County County","MA","Blackstone",2001,218,4913,5131
"1591","Blackstone","Worcester County County","MA","Blackstone",2002,304,4955,5259
"1592","Blackstone","Worcester County County","MA","Blackstone",2003,300,4994,5294
"1593","Blackstone","Worcester County County","MA","Blackstone",2004,275,5003,5278
"1594","Blackstone","Worcester County County","MA","Blackstone",2005,267,5035,5302
"1595","Blackstone","Worcester County County","MA","Blackstone",2006,294,5074,5368
"1596","Blackstone","Worcester County County","MA","Blackstone",2007,272,5093,5365
"1597","Blackstone","Worcester County County","MA","Blackstone",2008,357,5005,5362
"1598","Blackstone","Worcester County County","MA","Blackstone",2009,582,5152,5734
"1599","Blackstone","Worcester County County","MA","Blackstone",2010,562,4760,5322
"1600","Blackstone","Worcester County County","MA","Blackstone",2011,518,4805,5323
"1601","Blackstone","Worcester County County","MA","Blackstone",2012,491,4812,5303
"1602","Blandford","Hampden County County","MA","Blandford",1990,32,611,643
"1603","Blandford","Hampden County County","MA","Blandford",1991,60,573,633
"1604","Blandford","Hampden County County","MA","Blandford",1992,61,628,689
"1605","Blandford","Hampden County County","MA","Blandford",1993,50,642,692
"1606","Blandford","Hampden County County","MA","Blandford",1994,46,694,740
"1607","Blandford","Hampden County County","MA","Blandford",1995,41,689,730
"1608","Blandford","Hampden County County","MA","Blandford",1996,29,665,694
"1609","Blandford","Hampden County County","MA","Blandford",1997,27,667,694
"1610","Blandford","Hampden County County","MA","Blandford",1998,23,694,717
"1611","Blandford","Hampden County County","MA","Blandford",1999,28,749,777
"1612","Blandford","Hampden County County","MA","Blandford",2000,21,691,712
"1613","Blandford","Hampden County County","MA","Blandford",2001,25,696,721
"1614","Blandford","Hampden County County","MA","Blandford",2002,33,698,731
"1615","Blandford","Hampden County County","MA","Blandford",2003,39,695,734
"1616","Blandford","Hampden County County","MA","Blandford",2004,44,705,749
"1617","Blandford","Hampden County County","MA","Blandford",2005,35,709,744
"1618","Blandford","Hampden County County","MA","Blandford",2006,32,719,751
"1619","Blandford","Hampden County County","MA","Blandford",2007,31,723,754
"1620","Blandford","Hampden County County","MA","Blandford",2008,29,711,740
"1621","Blandford","Hampden County County","MA","Blandford",2009,50,693,743
"1622","Blandford","Hampden County County","MA","Blandford",2010,55,661,716
"1623","Blandford","Hampden County County","MA","Blandford",2011,49,654,703
"1624","Blandford","Hampden County County","MA","Blandford",2012,37,655,692
"1625","Bolton","Worcester County County","MA","Bolton",1990,94,1710,1804
"1626","Bolton","Worcester County County","MA","Bolton",1991,125,1703,1828
"1627","Bolton","Worcester County County","MA","Bolton",1992,111,1715,1826
"1628","Bolton","Worcester County County","MA","Bolton",1993,102,1782,1884
"1629","Bolton","Worcester County County","MA","Bolton",1994,91,1904,1995
"1630","Bolton","Worcester County County","MA","Bolton",1995,76,1742,1818
"1631","Bolton","Worcester County County","MA","Bolton",1996,56,1784,1840
"1632","Bolton","Worcester County County","MA","Bolton",1997,56,1843,1899
"1633","Bolton","Worcester County County","MA","Bolton",1998,52,1889,1941
"1634","Bolton","Worcester County County","MA","Bolton",1999,63,1929,1992
"1635","Bolton","Worcester County County","MA","Bolton",2000,46,2374,2420
"1636","Bolton","Worcester County County","MA","Bolton",2001,82,2398,2480
"1637","Bolton","Worcester County County","MA","Bolton",2002,137,2383,2520
"1638","Bolton","Worcester County County","MA","Bolton",2003,122,2389,2511
"1639","Bolton","Worcester County County","MA","Bolton",2004,113,2411,2524
"1640","Bolton","Worcester County County","MA","Bolton",2005,94,2462,2556
"1641","Bolton","Worcester County County","MA","Bolton",2006,104,2478,2582
"1642","Bolton","Worcester County County","MA","Bolton",2007,94,2525,2619
"1643","Bolton","Worcester County County","MA","Bolton",2008,103,2512,2615
"1644","Bolton","Worcester County County","MA","Bolton",2009,166,2436,2602
"1645","Bolton","Worcester County County","MA","Bolton",2010,181,2633,2814
"1646","Bolton","Worcester County County","MA","Bolton",2011,153,2654,2807
"1647","Bolton","Worcester County County","MA","Bolton",2012,120,2683,2803
"1648","Boston","Suffolk County County","MA","Boston",1990,18133,286374,304507
"1649","Boston","Suffolk County County","MA","Boston",1991,24891,271660,296551
"1650","Boston","Suffolk County County","MA","Boston",1992,23992,265307,289299
"1651","Boston","Suffolk County County","MA","Boston",1993,19986,267080,287066
"1652","Boston","Suffolk County County","MA","Boston",1994,17195,268809,286004
"1653","Boston","Suffolk County County","MA","Boston",1995,15934,277847,293781
"1654","Boston","Suffolk County County","MA","Boston",1996,13888,281244,295132
"1655","Boston","Suffolk County County","MA","Boston",1997,12719,286537,299256
"1656","Boston","Suffolk County County","MA","Boston",1998,10464,289584,300048
"1657","Boston","Suffolk County County","MA","Boston",1999,10216,291680,301896
"1658","Boston","Suffolk County County","MA","Boston",2000,9216,295008,304224
"1659","Boston","Suffolk County County","MA","Boston",2001,12640,294165,306805
"1660","Boston","Suffolk County County","MA","Boston",2002,17871,286918,304789
"1661","Boston","Suffolk County County","MA","Boston",2003,19058,278948,298006
"1662","Boston","Suffolk County County","MA","Boston",2004,16410,274159,290569
"1663","Boston","Suffolk County County","MA","Boston",2005,14951,272483,287434
"1664","Boston","Suffolk County County","MA","Boston",2006,15135,295598,310733
"1665","Boston","Suffolk County County","MA","Boston",2007,13853,302153,316006
"1666","Boston","Suffolk County County","MA","Boston",2008,16609,307404,324013
"1667","Boston","Suffolk County County","MA","Boston",2009,24660,300082,324742
"1668","Boston","Suffolk County County","MA","Boston",2010,25106,291571,316677
"1669","Boston","Suffolk County County","MA","Boston",2011,22101,296374,318475
"1670","Boston","Suffolk County County","MA","Boston",2012,20626,299620,320246
"1671","Bourne","Barnstable County County","MA","Bourne",1990,579,7454,8033
"1672","Bourne","Barnstable County County","MA","Bourne",1991,839,7306,8145
"1673","Bourne","Barnstable County County","MA","Bourne",1992,858,7289,8147
"1674","Bourne","Barnstable County County","MA","Bourne",1993,694,7679,8373
"1675","Bourne","Barnstable County County","MA","Bourne",1994,664,7801,8465
"1676","Bourne","Barnstable County County","MA","Bourne",1995,564,8001,8565
"1677","Bourne","Barnstable County County","MA","Bourne",1996,474,8185,8659
"1678","Bourne","Barnstable County County","MA","Bourne",1997,429,8446,8875
"1679","Bourne","Barnstable County County","MA","Bourne",1998,420,8580,9000
"1680","Bourne","Barnstable County County","MA","Bourne",1999,368,8696,9064
"1681","Bourne","Barnstable County County","MA","Bourne",2000,301,9263,9564
"1682","Bourne","Barnstable County County","MA","Bourne",2001,348,9392,9740
"1683","Bourne","Barnstable County County","MA","Bourne",2002,484,9600,10084
"1684","Bourne","Barnstable County County","MA","Bourne",2003,563,9827,10390
"1685","Bourne","Barnstable County County","MA","Bourne",2004,547,9967,10514
"1686","Bourne","Barnstable County County","MA","Bourne",2005,522,9943,10465
"1687","Bourne","Barnstable County County","MA","Bourne",2006,519,9971,10490
"1688","Bourne","Barnstable County County","MA","Bourne",2007,514,9923,10437
"1689","Bourne","Barnstable County County","MA","Bourne",2008,641,10103,10744
"1690","Bourne","Barnstable County County","MA","Bourne",2009,924,9821,10745
"1691","Bourne","Barnstable County County","MA","Bourne",2010,1011,10148,11159
"1692","Bourne","Barnstable County County","MA","Bourne",2011,911,10132,11043
"1693","Bourne","Barnstable County County","MA","Bourne",2012,837,10302,11139
"1694","Boxborough","Middlesex County County","MA","Boxborough",1990,81,1998,2079
"1695","Boxborough","Middlesex County County","MA","Boxborough",1991,104,1959,2063
"1696","Boxborough","Middlesex County County","MA","Boxborough",1992,124,2088,2212
"1697","Boxborough","Middlesex County County","MA","Boxborough",1993,104,2223,2327
"1698","Boxborough","Middlesex County County","MA","Boxborough",1994,106,2450,2556
"1699","Boxborough","Middlesex County County","MA","Boxborough",1995,94,2300,2394
"1700","Boxborough","Middlesex County County","MA","Boxborough",1996,66,2382,2448
"1701","Boxborough","Middlesex County County","MA","Boxborough",1997,58,2482,2540
"1702","Boxborough","Middlesex County County","MA","Boxborough",1998,52,2515,2567
"1703","Boxborough","Middlesex County County","MA","Boxborough",1999,47,2579,2626
"1704","Boxborough","Middlesex County County","MA","Boxborough",2000,47,2829,2876
"1705","Boxborough","Middlesex County County","MA","Boxborough",2001,87,2838,2925
"1706","Boxborough","Middlesex County County","MA","Boxborough",2002,152,2791,2943
"1707","Boxborough","Middlesex County County","MA","Boxborough",2003,148,2794,2942
"1708","Boxborough","Middlesex County County","MA","Boxborough",2004,112,2817,2929
"1709","Boxborough","Middlesex County County","MA","Boxborough",2005,107,2857,2964
"1710","Boxborough","Middlesex County County","MA","Boxborough",2006,99,2831,2930
"1711","Boxborough","Middlesex County County","MA","Boxborough",2007,93,2860,2953
"1712","Boxborough","Middlesex County County","MA","Boxborough",2008,105,2859,2964
"1713","Boxborough","Middlesex County County","MA","Boxborough",2009,180,2789,2969
"1714","Boxborough","Middlesex County County","MA","Boxborough",2010,183,2731,2914
"1715","Boxborough","Middlesex County County","MA","Boxborough",2011,158,2772,2930
"1716","Boxborough","Middlesex County County","MA","Boxborough",2012,147,2802,2949
"1717","Boxford","Essex County County","MA","Boxford",1990,120,3311,3431
"1718","Boxford","Essex County County","MA","Boxford",1991,170,3305,3475
"1719","Boxford","Essex County County","MA","Boxford",1992,156,3400,3556
"1720","Boxford","Essex County County","MA","Boxford",1993,162,3548,3710
"1721","Boxford","Essex County County","MA","Boxford",1994,149,3767,3916
"1722","Boxford","Essex County County","MA","Boxford",1995,136,4504,4640
"1723","Boxford","Essex County County","MA","Boxford",1996,101,4711,4812
"1724","Boxford","Essex County County","MA","Boxford",1997,96,4856,4952
"1725","Boxford","Essex County County","MA","Boxford",1998,84,5027,5111
"1726","Boxford","Essex County County","MA","Boxford",1999,94,5209,5303
"1727","Boxford","Essex County County","MA","Boxford",2000,77,4025,4102
"1728","Boxford","Essex County County","MA","Boxford",2001,117,4086,4203
"1729","Boxford","Essex County County","MA","Boxford",2002,175,4051,4226
"1730","Boxford","Essex County County","MA","Boxford",2003,182,4006,4188
"1731","Boxford","Essex County County","MA","Boxford",2004,164,3999,4163
"1732","Boxford","Essex County County","MA","Boxford",2005,142,4022,4164
"1733","Boxford","Essex County County","MA","Boxford",2006,146,3955,4101
"1734","Boxford","Essex County County","MA","Boxford",2007,142,3985,4127
"1735","Boxford","Essex County County","MA","Boxford",2008,160,3988,4148
"1736","Boxford","Essex County County","MA","Boxford",2009,241,3876,4117
"1737","Boxford","Essex County County","MA","Boxford",2010,250,3796,4046
"1738","Boxford","Essex County County","MA","Boxford",2011,221,3841,4062
"1739","Boxford","Essex County County","MA","Boxford",2012,191,3883,4074
"1740","Boylston","Worcester County County","MA","Boylston",1990,127,1828,1955
"1741","Boylston","Worcester County County","MA","Boylston",1991,203,1778,1981
"1742","Boylston","Worcester County County","MA","Boylston",1992,173,1782,1955
"1743","Boylston","Worcester County County","MA","Boylston",1993,137,1823,1960
"1744","Boylston","Worcester County County","MA","Boylston",1994,121,1835,1956
"1745","Boylston","Worcester County County","MA","Boylston",1995,102,1932,2034
"1746","Boylston","Worcester County County","MA","Boylston",1996,81,1978,2059
"1747","Boylston","Worcester County County","MA","Boylston",1997,77,2043,2120
"1748","Boylston","Worcester County County","MA","Boylston",1998,70,2096,2166
"1749","Boylston","Worcester County County","MA","Boylston",1999,73,2105,2178
"1750","Boylston","Worcester County County","MA","Boylston",2000,48,2147,2195
"1751","Boylston","Worcester County County","MA","Boylston",2001,70,2155,2225
"1752","Boylston","Worcester County County","MA","Boylston",2002,115,2147,2262
"1753","Boylston","Worcester County County","MA","Boylston",2003,129,2154,2283
"1754","Boylston","Worcester County County","MA","Boylston",2004,113,2159,2272
"1755","Boylston","Worcester County County","MA","Boylston",2005,112,2193,2305
"1756","Boylston","Worcester County County","MA","Boylston",2006,98,2230,2328
"1757","Boylston","Worcester County County","MA","Boylston",2007,90,2257,2347
"1758","Boylston","Worcester County County","MA","Boylston",2008,108,2214,2322
"1759","Boylston","Worcester County County","MA","Boylston",2009,173,2160,2333
"1760","Boylston","Worcester County County","MA","Boylston",2010,189,2146,2335
"1761","Boylston","Worcester County County","MA","Boylston",2011,158,2166,2324
"1762","Boylston","Worcester County County","MA","Boylston",2012,152,2165,2317
"1763","Braintree","Norfolk County County","MA","Braintree",1990,1018,17114,18132
"1764","Braintree","Norfolk County County","MA","Braintree",1991,1494,16569,18063
"1765","Braintree","Norfolk County County","MA","Braintree",1992,1483,16509,17992
"1766","Braintree","Norfolk County County","MA","Braintree",1993,1206,16529,17735
"1767","Braintree","Norfolk County County","MA","Braintree",1994,1047,16751,17798
"1768","Braintree","Norfolk County County","MA","Braintree",1995,930,17299,18229
"1769","Braintree","Norfolk County County","MA","Braintree",1996,747,17654,18401
"1770","Braintree","Norfolk County County","MA","Braintree",1997,673,18116,18789
"1771","Braintree","Norfolk County County","MA","Braintree",1998,534,18378,18912
"1772","Braintree","Norfolk County County","MA","Braintree",1999,457,18475,18932
"1773","Braintree","Norfolk County County","MA","Braintree",2000,434,17744,18178
"1774","Braintree","Norfolk County County","MA","Braintree",2001,584,17669,18253
"1775","Braintree","Norfolk County County","MA","Braintree",2002,844,17350,18194
"1776","Braintree","Norfolk County County","MA","Braintree",2003,1004,17019,18023
"1777","Braintree","Norfolk County County","MA","Braintree",2004,919,17112,18031
"1778","Braintree","Norfolk County County","MA","Braintree",2005,815,17190,18005
"1779","Braintree","Norfolk County County","MA","Braintree",2006,817,17133,17950
"1780","Braintree","Norfolk County County","MA","Braintree",2007,783,17422,18205
"1781","Braintree","Norfolk County County","MA","Braintree",2008,958,17881,18839
"1782","Braintree","Norfolk County County","MA","Braintree",2009,1428,17284,18712
"1783","Braintree","Norfolk County County","MA","Braintree",2010,1494,17670,19164
"1784","Braintree","Norfolk County County","MA","Braintree",2011,1251,17868,19119
"1785","Braintree","Norfolk County County","MA","Braintree",2012,1160,18063,19223
"1786","Brewster","Barnstable County County","MA","Brewster",1990,261,4174,4435
"1787","Brewster","Barnstable County County","MA","Brewster",1991,340,4102,4442
"1788","Brewster","Barnstable County County","MA","Brewster",1992,341,4083,4424
"1789","Brewster","Barnstable County County","MA","Brewster",1993,297,4268,4565
"1790","Brewster","Barnstable County County","MA","Brewster",1994,262,4372,4634
"1791","Brewster","Barnstable County County","MA","Brewster",1995,210,4376,4586
"1792","Brewster","Barnstable County County","MA","Brewster",1996,193,4521,4714
"1793","Brewster","Barnstable County County","MA","Brewster",1997,181,4616,4797
"1794","Brewster","Barnstable County County","MA","Brewster",1998,170,4719,4889
"1795","Brewster","Barnstable County County","MA","Brewster",1999,128,4947,5075
"1796","Brewster","Barnstable County County","MA","Brewster",2000,148,5145,5293
"1797","Brewster","Barnstable County County","MA","Brewster",2001,166,5206,5372
"1798","Brewster","Barnstable County County","MA","Brewster",2002,199,5306,5505
"1799","Brewster","Barnstable County County","MA","Brewster",2003,235,5413,5648
"1800","Brewster","Barnstable County County","MA","Brewster",2004,235,5460,5695
"1801","Brewster","Barnstable County County","MA","Brewster",2005,225,5425,5650
"1802","Brewster","Barnstable County County","MA","Brewster",2006,227,5424,5651
"1803","Brewster","Barnstable County County","MA","Brewster",2007,223,5392,5615
"1804","Brewster","Barnstable County County","MA","Brewster",2008,280,5338,5618
"1805","Brewster","Barnstable County County","MA","Brewster",2009,419,5210,5629
"1806","Brewster","Barnstable County County","MA","Brewster",2010,457,5202,5659
"1807","Brewster","Barnstable County County","MA","Brewster",2011,412,5193,5605
"1808","Brewster","Barnstable County County","MA","Brewster",2012,361,5280,5641
"1809","Bridgewater","Plymouth County County","MA","Bridgewater",1990,693,10103,10796
"1810","Bridgewater","Plymouth County County","MA","Bridgewater",1991,997,9687,10684
"1811","Bridgewater","Plymouth County County","MA","Bridgewater",1992,1006,9533,10539
"1812","Bridgewater","Plymouth County County","MA","Bridgewater",1993,784,10251,11035
"1813","Bridgewater","Plymouth County County","MA","Bridgewater",1994,694,11061,11755
"1814","Bridgewater","Plymouth County County","MA","Bridgewater",1995,611,11264,11875
"1815","Bridgewater","Plymouth County County","MA","Bridgewater",1996,489,11467,11956
"1816","Bridgewater","Plymouth County County","MA","Bridgewater",1997,431,11945,12376
"1817","Bridgewater","Plymouth County County","MA","Bridgewater",1998,361,12077,12438
"1818","Bridgewater","Plymouth County County","MA","Bridgewater",1999,365,12391,12756
"1819","Bridgewater","Plymouth County County","MA","Bridgewater",2000,305,12846,13151
"1820","Bridgewater","Plymouth County County","MA","Bridgewater",2001,399,12726,13125
"1821","Bridgewater","Plymouth County County","MA","Bridgewater",2002,579,12607,13186
"1822","Bridgewater","Plymouth County County","MA","Bridgewater",2003,660,12354,13014
"1823","Bridgewater","Plymouth County County","MA","Bridgewater",2004,657,12380,13037
"1824","Bridgewater","Plymouth County County","MA","Bridgewater",2005,612,12415,13027
"1825","Bridgewater","Plymouth County County","MA","Bridgewater",2006,596,12564,13160
"1826","Bridgewater","Plymouth County County","MA","Bridgewater",2007,591,12647,13238
"1827","Bridgewater","Plymouth County County","MA","Bridgewater",2008,699,12686,13385
"1828","Bridgewater","Plymouth County County","MA","Bridgewater",2009,1064,12967,14031
"1829","Bridgewater","Plymouth County County","MA","Bridgewater",2010,1097,12619,13716
"1830","Bridgewater","Plymouth County County","MA","Bridgewater",2011,1006,12728,13734
"1831","Bridgewater","Plymouth County County","MA","Bridgewater",2012,923,12841,13764
"1832","Brimfield","Hampden County County","MA","Brimfield",1990,87,1374,1461
"1833","Brimfield","Hampden County County","MA","Brimfield",1991,136,1352,1488
"1834","Brimfield","Hampden County County","MA","Brimfield",1992,153,1296,1449
"1835","Brimfield","Hampden County County","MA","Brimfield",1993,130,1304,1434
"1836","Brimfield","Hampden County County","MA","Brimfield",1994,107,1318,1425
"1837","Brimfield","Hampden County County","MA","Brimfield",1995,100,1535,1635
"1838","Brimfield","Hampden County County","MA","Brimfield",1996,82,1620,1702
"1839","Brimfield","Hampden County County","MA","Brimfield",1997,83,1614,1697
"1840","Brimfield","Hampden County County","MA","Brimfield",1998,77,1565,1642
"1841","Brimfield","Hampden County County","MA","Brimfield",1999,71,1536,1607
"1842","Brimfield","Hampden County County","MA","Brimfield",2000,45,1786,1831
"1843","Brimfield","Hampden County County","MA","Brimfield",2001,66,1821,1887
"1844","Brimfield","Hampden County County","MA","Brimfield",2002,97,1842,1939
"1845","Brimfield","Hampden County County","MA","Brimfield",2003,113,1853,1966
"1846","Brimfield","Hampden County County","MA","Brimfield",2004,110,1878,1988
"1847","Brimfield","Hampden County County","MA","Brimfield",2005,99,1905,2004
"1848","Brimfield","Hampden County County","MA","Brimfield",2006,108,1947,2055
"1849","Brimfield","Hampden County County","MA","Brimfield",2007,106,1953,2059
"1850","Brimfield","Hampden County County","MA","Brimfield",2008,114,1942,2056
"1851","Brimfield","Hampden County County","MA","Brimfield",2009,173,1903,2076
"1852","Brimfield","Hampden County County","MA","Brimfield",2010,162,1809,1971
"1853","Brimfield","Hampden County County","MA","Brimfield",2011,164,1791,1955
"1854","Brimfield","Hampden County County","MA","Brimfield",2012,132,1792,1924
"1855",NA,"Bristol County County","MA","Bristol County County",1990,24323,240931,265254
"1856",NA,"Bristol County County","MA","Bristol County County",1991,33258,232353,265611
"1857",NA,"Bristol County County","MA","Bristol County County",1992,31979,232860,264839
"1858",NA,"Bristol County County","MA","Bristol County County",1993,27713,238197,265910
"1859",NA,"Bristol County County","MA","Bristol County County",1994,24052,242955,267007
"1860",NA,"Bristol County County","MA","Bristol County County",1995,21989,243960,265949
"1861",NA,"Bristol County County","MA","Bristol County County",1996,19622,245280,264902
"1862",NA,"Bristol County County","MA","Bristol County County",1997,17101,251177,268278
"1863",NA,"Bristol County County","MA","Bristol County County",1998,13475,254513,267988
"1864",NA,"Bristol County County","MA","Bristol County County",1999,12534,257366,269900
"1865",NA,"Bristol County County","MA","Bristol County County",2000,10441,267626,278067
"1866",NA,"Bristol County County","MA","Bristol County County",2001,13208,266374,279582
"1867",NA,"Bristol County County","MA","Bristol County County",2002,17497,268084,285581
"1868",NA,"Bristol County County","MA","Bristol County County",2003,18909,267471,286380
"1869",NA,"Bristol County County","MA","Bristol County County",2004,17858,268272,286130
"1870",NA,"Bristol County County","MA","Bristol County County",2005,17171,270583,287754
"1871",NA,"Bristol County County","MA","Bristol County County",2006,17347,273260,290607
"1872",NA,"Bristol County County","MA","Bristol County County",2007,16861,273636,290497
"1873",NA,"Bristol County County","MA","Bristol County County",2008,20586,270811,291397
"1874",NA,"Bristol County County","MA","Bristol County County",2009,31383,261345,292728
"1875",NA,"Bristol County County","MA","Bristol County County",2010,31838,260053,291891
"1876",NA,"Bristol County County","MA","Bristol County County",2011,29053,262273,291326
"1877",NA,"Bristol County County","MA","Bristol County County",2012,27116,263376,290492
"1878","Brockton","Plymouth County County","MA","Brockton",1990,4385,41953,46338
"1879","Brockton","Plymouth County County","MA","Brockton",1991,5856,39354,45210
"1880","Brockton","Plymouth County County","MA","Brockton",1992,5567,38229,43796
"1881","Brockton","Plymouth County County","MA","Brockton",1993,4317,38668,42985
"1882","Brockton","Plymouth County County","MA","Brockton",1994,3557,40358,43915
"1883","Brockton","Plymouth County County","MA","Brockton",1995,3222,42855,46077
"1884","Brockton","Plymouth County County","MA","Brockton",1996,2994,42976,45970
"1885","Brockton","Plymouth County County","MA","Brockton",1997,2594,44258,46852
"1886","Brockton","Plymouth County County","MA","Brockton",1998,2120,44540,46660
"1887","Brockton","Plymouth County County","MA","Brockton",1999,2036,45028,47064
"1888","Brockton","Plymouth County County","MA","Brockton",2000,1540,43817,45357
"1889","Brockton","Plymouth County County","MA","Brockton",2001,2157,43526,45683
"1890","Brockton","Plymouth County County","MA","Brockton",2002,2935,43023,45958
"1891","Brockton","Plymouth County County","MA","Brockton",2003,3280,41894,45174
"1892","Brockton","Plymouth County County","MA","Brockton",2004,3072,41719,44791
"1893","Brockton","Plymouth County County","MA","Brockton",2005,2724,41684,44408
"1894","Brockton","Plymouth County County","MA","Brockton",2006,2721,42029,44750
"1895","Brockton","Plymouth County County","MA","Brockton",2007,2617,42109,44726
"1896","Brockton","Plymouth County County","MA","Brockton",2008,3097,41776,44873
"1897","Brockton","Plymouth County County","MA","Brockton",2009,4694,40593,45287
"1898","Brockton","Plymouth County County","MA","Brockton",2010,5166,40673,45839
"1899","Brockton","Plymouth County County","MA","Brockton",2011,4569,41052,45621
"1900","Brockton","Plymouth County County","MA","Brockton",2012,4115,41416,45531
"1901","Brookfield","Worcester County County","MA","Brookfield",1990,103,1404,1507
"1902","Brookfield","Worcester County County","MA","Brookfield",1991,177,1415,1592
"1903","Brookfield","Worcester County County","MA","Brookfield",1992,178,1391,1569
"1904","Brookfield","Worcester County County","MA","Brookfield",1993,123,1440,1563
"1905","Brookfield","Worcester County County","MA","Brookfield",1994,94,1451,1545
"1906","Brookfield","Worcester County County","MA","Brookfield",1995,68,1362,1430
"1907","Brookfield","Worcester County County","MA","Brookfield",1996,83,1381,1464
"1908","Brookfield","Worcester County County","MA","Brookfield",1997,74,1413,1487
"1909","Brookfield","Worcester County County","MA","Brookfield",1998,62,1436,1498
"1910","Brookfield","Worcester County County","MA","Brookfield",1999,54,1433,1487
"1911","Brookfield","Worcester County County","MA","Brookfield",2000,42,1642,1684
"1912","Brookfield","Worcester County County","MA","Brookfield",2001,54,1644,1698
"1913","Brookfield","Worcester County County","MA","Brookfield",2002,99,1631,1730
"1914","Brookfield","Worcester County County","MA","Brookfield",2003,109,1620,1729
"1915","Brookfield","Worcester County County","MA","Brookfield",2004,98,1610,1708
"1916","Brookfield","Worcester County County","MA","Brookfield",2005,98,1602,1700
"1917","Brookfield","Worcester County County","MA","Brookfield",2006,107,1759,1866
"1918","Brookfield","Worcester County County","MA","Brookfield",2007,110,1765,1875
"1919","Brookfield","Worcester County County","MA","Brookfield",2008,107,1735,1842
"1920","Brookfield","Worcester County County","MA","Brookfield",2009,169,1683,1852
"1921","Brookfield","Worcester County County","MA","Brookfield",2010,177,1679,1856
"1922","Brookfield","Worcester County County","MA","Brookfield",2011,156,1694,1850
"1923","Brookfield","Worcester County County","MA","Brookfield",2012,143,1693,1836
"1924","Brookline","Norfolk County County","MA","Brookline",1990,812,30784,31596
"1925","Brookline","Norfolk County County","MA","Brookline",1991,1240,29218,30458
"1926","Brookline","Norfolk County County","MA","Brookline",1992,1462,28683,30145
"1927","Brookline","Norfolk County County","MA","Brookline",1993,1172,28873,30045
"1928","Brookline","Norfolk County County","MA","Brookline",1994,1102,29189,30291
"1929","Brookline","Norfolk County County","MA","Brookline",1995,887,30233,31120
"1930","Brookline","Norfolk County County","MA","Brookline",1996,698,30763,31461
"1931","Brookline","Norfolk County County","MA","Brookline",1997,612,31428,32040
"1932","Brookline","Norfolk County County","MA","Brookline",1998,488,31717,32205
"1933","Brookline","Norfolk County County","MA","Brookline",1999,474,31770,32244
"1934","Brookline","Norfolk County County","MA","Brookline",2000,561,33760,34321
"1935","Brookline","Norfolk County County","MA","Brookline",2001,881,33571,34452
"1936","Brookline","Norfolk County County","MA","Brookline",2002,1266,32911,34177
"1937","Brookline","Norfolk County County","MA","Brookline",2003,1199,32253,33452
"1938","Brookline","Norfolk County County","MA","Brookline",2004,1021,32001,33022
"1939","Brookline","Norfolk County County","MA","Brookline",2005,924,31989,32913
"1940","Brookline","Norfolk County County","MA","Brookline",2006,872,31907,32779
"1941","Brookline","Norfolk County County","MA","Brookline",2007,841,32167,33008
"1942","Brookline","Norfolk County County","MA","Brookline",2008,1046,32100,33146
"1943","Brookline","Norfolk County County","MA","Brookline",2009,1686,30980,32666
"1944","Brookline","Norfolk County County","MA","Brookline",2010,1554,32735,34289
"1945","Brookline","Norfolk County County","MA","Brookline",2011,1310,33100,34410
"1946","Brookline","Norfolk County County","MA","Brookline",2012,1189,33462,34651
"1947","Buckland","Franklin County County","MA","Buckland",1990,15,1035,1050
"1948","Buckland","Franklin County County","MA","Buckland",1991,19,1047,1066
"1949","Buckland","Franklin County County","MA","Buckland",1992,20,1037,1057
"1950","Buckland","Franklin County County","MA","Buckland",1993,16,1065,1081
"1951","Buckland","Franklin County County","MA","Buckland",1994,16,1152,1168
"1952","Buckland","Franklin County County","MA","Buckland",1995,18,1046,1064
"1953","Buckland","Franklin County County","MA","Buckland",1996,11,1052,1063
"1954","Buckland","Franklin County County","MA","Buckland",1997,12,1074,1086
"1955","Buckland","Franklin County County","MA","Buckland",1998,12,1094,1106
"1956","Buckland","Franklin County County","MA","Buckland",1999,14,1114,1128
"1957","Buckland","Franklin County County","MA","Buckland",2000,15,1128,1143
"1958","Buckland","Franklin County County","MA","Buckland",2001,18,1120,1138
"1959","Buckland","Franklin County County","MA","Buckland",2002,19,1132,1151
"1960","Buckland","Franklin County County","MA","Buckland",2003,25,1136,1161
"1961","Buckland","Franklin County County","MA","Buckland",2004,29,1112,1141
"1962","Buckland","Franklin County County","MA","Buckland",2005,27,1115,1142
"1963","Buckland","Franklin County County","MA","Buckland",2006,29,1125,1154
"1964","Buckland","Franklin County County","MA","Buckland",2007,34,1111,1145
"1965","Buckland","Franklin County County","MA","Buckland",2008,32,1094,1126
"1966","Buckland","Franklin County County","MA","Buckland",2009,43,1063,1106
"1967","Buckland","Franklin County County","MA","Buckland",2010,44,1034,1078
"1968","Buckland","Franklin County County","MA","Buckland",2011,39,1037,1076
"1969","Buckland","Franklin County County","MA","Buckland",2012,40,1040,1080
"1970","Burlington","Middlesex County County","MA","Burlington",1990,732,13821,14553
"1971","Burlington","Middlesex County County","MA","Burlington",1991,1000,13337,14337
"1972","Burlington","Middlesex County County","MA","Burlington",1992,1120,13201,14321
"1973","Burlington","Middlesex County County","MA","Burlington",1993,793,13268,14061
"1974","Burlington","Middlesex County County","MA","Burlington",1994,689,13423,14112
"1975","Burlington","Middlesex County County","MA","Burlington",1995,569,13655,14224
"1976","Burlington","Middlesex County County","MA","Burlington",1996,444,13962,14406
"1977","Burlington","Middlesex County County","MA","Burlington",1997,429,14340,14769
"1978","Burlington","Middlesex County County","MA","Burlington",1998,300,14481,14781
"1979","Burlington","Middlesex County County","MA","Burlington",1999,332,14653,14985
"1980","Burlington","Middlesex County County","MA","Burlington",2000,290,12850,13140
"1981","Burlington","Middlesex County County","MA","Burlington",2001,431,12800,13231
"1982","Burlington","Middlesex County County","MA","Burlington",2002,654,12524,13178
"1983","Burlington","Middlesex County County","MA","Burlington",2003,680,12303,12983
"1984","Burlington","Middlesex County County","MA","Burlington",2004,564,12555,13119
"1985","Burlington","Middlesex County County","MA","Burlington",2005,512,12729,13241
"1986","Burlington","Middlesex County County","MA","Burlington",2006,503,13542,14045
"1987","Burlington","Middlesex County County","MA","Burlington",2007,477,13733,14210
"1988","Burlington","Middlesex County County","MA","Burlington",2008,584,13754,14338
"1989","Burlington","Middlesex County County","MA","Burlington",2009,945,13423,14368
"1990","Burlington","Middlesex County County","MA","Burlington",2010,880,12963,13843
"1991","Burlington","Middlesex County County","MA","Burlington",2011,746,13156,13902
"1992","Burlington","Middlesex County County","MA","Burlington",2012,707,13300,14007
"1993","Cambridge","Middlesex County County","MA","Cambridge",1990,2256,53753,56009
"1994","Cambridge","Middlesex County County","MA","Cambridge",1991,3098,52551,55649
"1995","Cambridge","Middlesex County County","MA","Cambridge",1992,3141,52660,55801
"1996","Cambridge","Middlesex County County","MA","Cambridge",1993,2660,53871,56531
"1997","Cambridge","Middlesex County County","MA","Cambridge",1994,2240,55065,57305
"1998","Cambridge","Middlesex County County","MA","Cambridge",1995,1917,52219,54136
"1999","Cambridge","Middlesex County County","MA","Cambridge",1996,1539,53013,54552
"2000","Cambridge","Middlesex County County","MA","Cambridge",1997,1354,54192,55546
"2001","Cambridge","Middlesex County County","MA","Cambridge",1998,1078,54649,55727
"2002","Cambridge","Middlesex County County","MA","Cambridge",1999,1105,54841,55946
"2003","Cambridge","Middlesex County County","MA","Cambridge",2000,1146,58159,59305
"2004","Cambridge","Middlesex County County","MA","Cambridge",2001,1658,58309,59967
"2005","Cambridge","Middlesex County County","MA","Cambridge",2002,2402,57199,59601
"2006","Cambridge","Middlesex County County","MA","Cambridge",2003,2484,56071,58555
"2007","Cambridge","Middlesex County County","MA","Cambridge",2004,2107,55675,57782
"2008","Cambridge","Middlesex County County","MA","Cambridge",2005,1954,55816,57770
"2009","Cambridge","Middlesex County County","MA","Cambridge",2006,1925,57683,59608
"2010","Cambridge","Middlesex County County","MA","Cambridge",2007,1803,58948,60751
"2011","Cambridge","Middlesex County County","MA","Cambridge",2008,2168,59561,61729
"2012","Cambridge","Middlesex County County","MA","Cambridge",2009,3293,57857,61150
"2013","Cambridge","Middlesex County County","MA","Cambridge",2010,3199,56777,59976
"2014","Cambridge","Middlesex County County","MA","Cambridge",2011,2778,57496,60274
"2015","Cambridge","Middlesex County County","MA","Cambridge",2012,2540,58126,60666
"2016","Canton","Norfolk County County","MA","Canton",1990,550,9987,10537
"2017","Canton","Norfolk County County","MA","Canton",1991,782,9832,10614
"2018","Canton","Norfolk County County","MA","Canton",1992,814,9897,10711
"2019","Canton","Norfolk County County","MA","Canton",1993,618,10183,10801
"2020","Canton","Norfolk County County","MA","Canton",1994,579,10557,11136
"2021","Canton","Norfolk County County","MA","Canton",1995,501,10665,11166
"2022","Canton","Norfolk County County","MA","Canton",1996,408,10984,11392
"2023","Canton","Norfolk County County","MA","Canton",1997,360,11344,11704
"2024","Canton","Norfolk County County","MA","Canton",1998,278,11625,11903
"2025","Canton","Norfolk County County","MA","Canton",1999,264,11779,12043
"2026","Canton","Norfolk County County","MA","Canton",2000,260,10941,11201
"2027","Canton","Norfolk County County","MA","Canton",2001,344,11013,11357
"2028","Canton","Norfolk County County","MA","Canton",2002,500,10936,11436
"2029","Canton","Norfolk County County","MA","Canton",2003,565,10828,11393
"2030","Canton","Norfolk County County","MA","Canton",2004,503,10877,11380
"2031","Canton","Norfolk County County","MA","Canton",2005,449,11023,11472
"2032","Canton","Norfolk County County","MA","Canton",2006,468,10959,11427
"2033","Canton","Norfolk County County","MA","Canton",2007,429,11151,11580
"2034","Canton","Norfolk County County","MA","Canton",2008,539,11162,11701
"2035","Canton","Norfolk County County","MA","Canton",2009,844,10908,11752
"2036","Canton","Norfolk County County","MA","Canton",2010,809,10672,11481
"2037","Canton","Norfolk County County","MA","Canton",2011,706,10792,11498
"2038","Canton","Norfolk County County","MA","Canton",2012,667,10910,11577
"2039","Carlisle","Middlesex County County","MA","Carlisle",1990,59,2404,2463
"2040","Carlisle","Middlesex County County","MA","Carlisle",1991,93,2334,2427
"2041","Carlisle","Middlesex County County","MA","Carlisle",1992,94,2361,2455
"2042","Carlisle","Middlesex County County","MA","Carlisle",1993,67,2444,2511
"2043","Carlisle","Middlesex County County","MA","Carlisle",1994,71,2503,2574
"2044","Carlisle","Middlesex County County","MA","Carlisle",1995,63,2489,2552
"2045","Carlisle","Middlesex County County","MA","Carlisle",1996,52,2560,2612
"2046","Carlisle","Middlesex County County","MA","Carlisle",1997,41,2656,2697
"2047","Carlisle","Middlesex County County","MA","Carlisle",1998,37,2734,2771
"2048","Carlisle","Middlesex County County","MA","Carlisle",1999,47,2791,2838
"2049","Carlisle","Middlesex County County","MA","Carlisle",2000,42,2454,2496
"2050","Carlisle","Middlesex County County","MA","Carlisle",2001,70,2472,2542
"2051","Carlisle","Middlesex County County","MA","Carlisle",2002,128,2449,2577
"2052","Carlisle","Middlesex County County","MA","Carlisle",2003,117,2420,2537
"2053","Carlisle","Middlesex County County","MA","Carlisle",2004,101,2412,2513
"2054","Carlisle","Middlesex County County","MA","Carlisle",2005,92,2436,2528
"2055","Carlisle","Middlesex County County","MA","Carlisle",2006,81,2394,2475
"2056","Carlisle","Middlesex County County","MA","Carlisle",2007,76,2413,2489
"2057","Carlisle","Middlesex County County","MA","Carlisle",2008,90,2410,2500
"2058","Carlisle","Middlesex County County","MA","Carlisle",2009,160,2348,2508
"2059","Carlisle","Middlesex County County","MA","Carlisle",2010,152,2371,2523
"2060","Carlisle","Middlesex County County","MA","Carlisle",2011,109,2406,2515
"2061","Carlisle","Middlesex County County","MA","Carlisle",2012,113,2432,2545
"2062","Carver","Plymouth County County","MA","Carver",1990,391,4744,5135
"2063","Carver","Plymouth County County","MA","Carver",1991,557,4652,5209
"2064","Carver","Plymouth County County","MA","Carver",1992,557,4668,5225
"2065","Carver","Plymouth County County","MA","Carver",1993,494,4810,5304
"2066","Carver","Plymouth County County","MA","Carver",1994,380,4887,5267
"2067","Carver","Plymouth County County","MA","Carver",1995,371,4917,5288
"2068","Carver","Plymouth County County","MA","Carver",1996,303,5063,5366
"2069","Carver","Plymouth County County","MA","Carver",1997,306,5248,5554
"2070","Carver","Plymouth County County","MA","Carver",1998,227,5409,5636
"2071","Carver","Plymouth County County","MA","Carver",1999,217,5557,5774
"2072","Carver","Plymouth County County","MA","Carver",2000,175,5856,6031
"2073","Carver","Plymouth County County","MA","Carver",2001,232,5875,6107
"2074","Carver","Plymouth County County","MA","Carver",2002,302,5824,6126
"2075","Carver","Plymouth County County","MA","Carver",2003,381,5769,6150
"2076","Carver","Plymouth County County","MA","Carver",2004,332,5791,6123
"2077","Carver","Plymouth County County","MA","Carver",2005,327,5888,6215
"2078","Carver","Plymouth County County","MA","Carver",2006,318,5874,6192
"2079","Carver","Plymouth County County","MA","Carver",2007,324,5986,6310
"2080","Carver","Plymouth County County","MA","Carver",2008,377,6019,6396
"2081","Carver","Plymouth County County","MA","Carver",2009,571,5851,6422
"2082","Carver","Plymouth County County","MA","Carver",2010,572,5676,6248
"2083","Carver","Plymouth County County","MA","Carver",2011,492,5733,6225
"2084","Carver","Plymouth County County","MA","Carver",2012,437,5796,6233
"2085","Charlemont","Franklin County County","MA","Charlemont",1990,46,610,656
"2086","Charlemont","Franklin County County","MA","Charlemont",1991,62,594,656
"2087","Charlemont","Franklin County County","MA","Charlemont",1992,70,598,668
"2088","Charlemont","Franklin County County","MA","Charlemont",1993,59,597,656
"2089","Charlemont","Franklin County County","MA","Charlemont",1994,51,600,651
"2090","Charlemont","Franklin County County","MA","Charlemont",1995,34,618,652
"2091","Charlemont","Franklin County County","MA","Charlemont",1996,36,620,656
"2092","Charlemont","Franklin County County","MA","Charlemont",1997,40,632,672
"2093","Charlemont","Franklin County County","MA","Charlemont",1998,32,644,676
"2094","Charlemont","Franklin County County","MA","Charlemont",1999,32,655,687
"2095","Charlemont","Franklin County County","MA","Charlemont",2000,21,758,779
"2096","Charlemont","Franklin County County","MA","Charlemont",2001,24,767,791
"2097","Charlemont","Franklin County County","MA","Charlemont",2002,35,776,811
"2098","Charlemont","Franklin County County","MA","Charlemont",2003,41,776,817
"2099","Charlemont","Franklin County County","MA","Charlemont",2004,38,768,806
"2100","Charlemont","Franklin County County","MA","Charlemont",2005,31,762,793
"2101","Charlemont","Franklin County County","MA","Charlemont",2006,30,760,790
"2102","Charlemont","Franklin County County","MA","Charlemont",2007,37,751,788
"2103","Charlemont","Franklin County County","MA","Charlemont",2008,37,745,782
"2104","Charlemont","Franklin County County","MA","Charlemont",2009,56,728,784
"2105","Charlemont","Franklin County County","MA","Charlemont",2010,54,677,731
"2106","Charlemont","Franklin County County","MA","Charlemont",2011,48,678,726
"2107","Charlemont","Franklin County County","MA","Charlemont",2012,47,680,727
"2108","Charlton","Worcester County County","MA","Charlton",1990,319,4887,5206
"2109","Charlton","Worcester County County","MA","Charlton",1991,469,4664,5133
"2110","Charlton","Worcester County County","MA","Charlton",1992,565,5317,5882
"2111","Charlton","Worcester County County","MA","Charlton",1993,414,5672,6086
"2112","Charlton","Worcester County County","MA","Charlton",1994,313,5910,6223
"2113","Charlton","Worcester County County","MA","Charlton",1995,316,5062,5378
"2114","Charlton","Worcester County County","MA","Charlton",1996,258,5172,5430
"2115","Charlton","Worcester County County","MA","Charlton",1997,222,5339,5561
"2116","Charlton","Worcester County County","MA","Charlton",1998,223,5483,5706
"2117","Charlton","Worcester County County","MA","Charlton",1999,193,5542,5735
"2118","Charlton","Worcester County County","MA","Charlton",2000,157,6076,6233
"2119","Charlton","Worcester County County","MA","Charlton",2001,225,6169,6394
"2120","Charlton","Worcester County County","MA","Charlton",2002,363,6225,6588
"2121","Charlton","Worcester County County","MA","Charlton",2003,405,6318,6723
"2122","Charlton","Worcester County County","MA","Charlton",2004,373,6373,6746
"2123","Charlton","Worcester County County","MA","Charlton",2005,352,6446,6798
"2124","Charlton","Worcester County County","MA","Charlton",2006,341,6517,6858
"2125","Charlton","Worcester County County","MA","Charlton",2007,340,6526,6866
"2126","Charlton","Worcester County County","MA","Charlton",2008,372,6387,6759
"2127","Charlton","Worcester County County","MA","Charlton",2009,591,6230,6821
"2128","Charlton","Worcester County County","MA","Charlton",2010,582,6421,7003
"2129","Charlton","Worcester County County","MA","Charlton",2011,515,6478,6993
"2130","Charlton","Worcester County County","MA","Charlton",2012,507,6476,6983
"2131","Chatham","Barnstable County County","MA","Chatham",1990,114,2771,2885
"2132","Chatham","Barnstable County County","MA","Chatham",1991,224,2616,2840
"2133","Chatham","Barnstable County County","MA","Chatham",1992,227,2521,2748
"2134","Chatham","Barnstable County County","MA","Chatham",1993,199,2565,2764
"2135","Chatham","Barnstable County County","MA","Chatham",1994,194,2550,2744
"2136","Chatham","Barnstable County County","MA","Chatham",1995,179,2848,3027
"2137","Chatham","Barnstable County County","MA","Chatham",1996,152,2909,3061
"2138","Chatham","Barnstable County County","MA","Chatham",1997,138,2940,3078
"2139","Chatham","Barnstable County County","MA","Chatham",1998,119,2994,3113
"2140","Chatham","Barnstable County County","MA","Chatham",1999,117,3108,3225
"2141","Chatham","Barnstable County County","MA","Chatham",2000,99,3057,3156
"2142","Chatham","Barnstable County County","MA","Chatham",2001,114,3098,3212
"2143","Chatham","Barnstable County County","MA","Chatham",2002,133,3153,3286
"2144","Chatham","Barnstable County County","MA","Chatham",2003,147,3225,3372
"2145","Chatham","Barnstable County County","MA","Chatham",2004,152,3270,3422
"2146","Chatham","Barnstable County County","MA","Chatham",2005,155,3276,3431
"2147","Chatham","Barnstable County County","MA","Chatham",2006,155,3283,3438
"2148","Chatham","Barnstable County County","MA","Chatham",2007,153,3275,3428
"2149","Chatham","Barnstable County County","MA","Chatham",2008,187,3258,3445
"2150","Chatham","Barnstable County County","MA","Chatham",2009,264,3191,3455
"2151","Chatham","Barnstable County County","MA","Chatham",2010,251,2936,3187
"2152","Chatham","Barnstable County County","MA","Chatham",2011,225,2932,3157
"2153","Chatham","Barnstable County County","MA","Chatham",2012,217,2982,3199
"2154","Chelmsford","Middlesex County County","MA","Chelmsford",1990,1084,19116,20200
"2155","Chelmsford","Middlesex County County","MA","Chelmsford",1991,1521,18513,20034
"2156","Chelmsford","Middlesex County County","MA","Chelmsford",1992,1606,18445,20051
"2157","Chelmsford","Middlesex County County","MA","Chelmsford",1993,1363,18604,19967
"2158","Chelmsford","Middlesex County County","MA","Chelmsford",1994,1110,18837,19947
"2159","Chelmsford","Middlesex County County","MA","Chelmsford",1995,837,18766,19603
"2160","Chelmsford","Middlesex County County","MA","Chelmsford",1996,613,19441,20054
"2161","Chelmsford","Middlesex County County","MA","Chelmsford",1997,577,20183,20760
"2162","Chelmsford","Middlesex County County","MA","Chelmsford",1998,529,20662,21191
"2163","Chelmsford","Middlesex County County","MA","Chelmsford",1999,567,21292,21859
"2164","Chelmsford","Middlesex County County","MA","Chelmsford",2000,410,18713,19123
"2165","Chelmsford","Middlesex County County","MA","Chelmsford",2001,607,18740,19347
"2166","Chelmsford","Middlesex County County","MA","Chelmsford",2002,1050,18346,19396
"2167","Chelmsford","Middlesex County County","MA","Chelmsford",2003,1101,18180,19281
"2168","Chelmsford","Middlesex County County","MA","Chelmsford",2004,868,18028,18896
"2169","Chelmsford","Middlesex County County","MA","Chelmsford",2005,758,18152,18910
"2170","Chelmsford","Middlesex County County","MA","Chelmsford",2006,742,18106,18848
"2171","Chelmsford","Middlesex County County","MA","Chelmsford",2007,708,18325,19033
"2172","Chelmsford","Middlesex County County","MA","Chelmsford",2008,843,18426,19269
"2173","Chelmsford","Middlesex County County","MA","Chelmsford",2009,1345,17734,19079
"2174","Chelmsford","Middlesex County County","MA","Chelmsford",2010,1325,17705,19030
"2175","Chelmsford","Middlesex County County","MA","Chelmsford",2011,1143,17896,19039
"2176","Chelmsford","Middlesex County County","MA","Chelmsford",2012,1076,18094,19170
"2177","Chelsea","Suffolk County County","MA","Chelsea",1990,1131,11886,13017
"2178","Chelsea","Suffolk County County","MA","Chelsea",1991,1451,11106,12557
"2179","Chelsea","Suffolk County County","MA","Chelsea",1992,1457,10506,11963
"2180","Chelsea","Suffolk County County","MA","Chelsea",1993,1113,10409,11522
"2181","Chelsea","Suffolk County County","MA","Chelsea",1994,930,10481,11411
"2182","Chelsea","Suffolk County County","MA","Chelsea",1995,948,11415,12363
"2183","Chelsea","Suffolk County County","MA","Chelsea",1996,835,11543,12378
"2184","Chelsea","Suffolk County County","MA","Chelsea",1997,737,11746,12483
"2185","Chelsea","Suffolk County County","MA","Chelsea",1998,673,11886,12559
"2186","Chelsea","Suffolk County County","MA","Chelsea",1999,708,11959,12667
"2187","Chelsea","Suffolk County County","MA","Chelsea",2000,515,13590,14105
"2188","Chelsea","Suffolk County County","MA","Chelsea",2001,713,13531,14244
"2189","Chelsea","Suffolk County County","MA","Chelsea",2002,1041,13071,14112
"2190","Chelsea","Suffolk County County","MA","Chelsea",2003,1207,12668,13875
"2191","Chelsea","Suffolk County County","MA","Chelsea",2004,1024,12387,13411
"2192","Chelsea","Suffolk County County","MA","Chelsea",2005,927,12267,13194
"2193","Chelsea","Suffolk County County","MA","Chelsea",2006,890,13218,14108
"2194","Chelsea","Suffolk County County","MA","Chelsea",2007,859,13675,14534
"2195","Chelsea","Suffolk County County","MA","Chelsea",2008,978,13601,14579
"2196","Chelsea","Suffolk County County","MA","Chelsea",2009,1473,13492,14965
"2197","Chelsea","Suffolk County County","MA","Chelsea",2010,1536,12852,14388
"2198","Chelsea","Suffolk County County","MA","Chelsea",2011,1367,13081,14448
"2199","Chelsea","Suffolk County County","MA","Chelsea",2012,1262,13225,14487
"2200","Cheshire","Berkshire County County","MA","Cheshire",1990,118,1739,1857
"2201","Cheshire","Berkshire County County","MA","Cheshire",1991,223,1632,1855
"2202","Cheshire","Berkshire County County","MA","Cheshire",1992,210,1592,1802
"2203","Cheshire","Berkshire County County","MA","Cheshire",1993,173,1593,1766
"2204","Cheshire","Berkshire County County","MA","Cheshire",1994,161,1639,1800
"2205","Cheshire","Berkshire County County","MA","Cheshire",1995,134,1624,1758
"2206","Cheshire","Berkshire County County","MA","Cheshire",1996,106,1652,1758
"2207","Cheshire","Berkshire County County","MA","Cheshire",1997,107,1670,1777
"2208","Cheshire","Berkshire County County","MA","Cheshire",1998,80,1680,1760
"2209","Cheshire","Berkshire County County","MA","Cheshire",1999,72,1691,1763
"2210","Cheshire","Berkshire County County","MA","Cheshire",2000,56,1799,1855
"2211","Cheshire","Berkshire County County","MA","Cheshire",2001,70,1801,1871
"2212","Cheshire","Berkshire County County","MA","Cheshire",2002,114,1825,1939
"2213","Cheshire","Berkshire County County","MA","Cheshire",2003,119,1811,1930
"2214","Cheshire","Berkshire County County","MA","Cheshire",2004,106,1812,1918
"2215","Cheshire","Berkshire County County","MA","Cheshire",2005,101,1845,1946
"2216","Cheshire","Berkshire County County","MA","Cheshire",2006,86,1877,1963
"2217","Cheshire","Berkshire County County","MA","Cheshire",2007,94,1857,1951
"2218","Cheshire","Berkshire County County","MA","Cheshire",2008,111,1853,1964
"2219","Cheshire","Berkshire County County","MA","Cheshire",2009,169,1796,1965
"2220","Cheshire","Berkshire County County","MA","Cheshire",2010,166,1696,1862
"2221","Cheshire","Berkshire County County","MA","Cheshire",2011,154,1711,1865
"2222","Cheshire","Berkshire County County","MA","Cheshire",2012,139,1704,1843
"2223","Chester","Hampden County County","MA","Chester",1990,38,633,671
"2224","Chester","Hampden County County","MA","Chester",1991,78,601,679
"2225","Chester","Hampden County County","MA","Chester",1992,103,678,781
"2226","Chester","Hampden County County","MA","Chester",1993,75,688,763
"2227","Chester","Hampden County County","MA","Chester",1994,102,738,840
"2228","Chester","Hampden County County","MA","Chester",1995,68,715,783
"2229","Chester","Hampden County County","MA","Chester",1996,59,691,750
"2230","Chester","Hampden County County","MA","Chester",1997,51,694,745
"2231","Chester","Hampden County County","MA","Chester",1998,49,725,774
"2232","Chester","Hampden County County","MA","Chester",1999,47,785,832
"2233","Chester","Hampden County County","MA","Chester",2000,34,698,732
"2234","Chester","Hampden County County","MA","Chester",2001,38,699,737
"2235","Chester","Hampden County County","MA","Chester",2002,58,701,759
"2236","Chester","Hampden County County","MA","Chester",2003,56,692,748
"2237","Chester","Hampden County County","MA","Chester",2004,40,691,731
"2238","Chester","Hampden County County","MA","Chester",2005,39,692,731
"2239","Chester","Hampden County County","MA","Chester",2006,29,692,721
"2240","Chester","Hampden County County","MA","Chester",2007,30,685,715
"2241","Chester","Hampden County County","MA","Chester",2008,37,674,711
"2242","Chester","Hampden County County","MA","Chester",2009,67,652,719
"2243","Chester","Hampden County County","MA","Chester",2010,69,670,739
"2244","Chester","Hampden County County","MA","Chester",2011,59,664,723
"2245","Chester","Hampden County County","MA","Chester",2012,42,664,706
"2246","Chesterfield","Hampshire County County","MA","Chesterfield",1990,32,592,624
"2247","Chesterfield","Hampshire County County","MA","Chesterfield",1991,77,577,654
"2248","Chesterfield","Hampshire County County","MA","Chesterfield",1992,56,601,657
"2249","Chesterfield","Hampshire County County","MA","Chesterfield",1993,51,600,651
"2250","Chesterfield","Hampshire County County","MA","Chesterfield",1994,30,647,677
"2251","Chesterfield","Hampshire County County","MA","Chesterfield",1995,26,721,747
"2252","Chesterfield","Hampshire County County","MA","Chesterfield",1996,27,711,738
"2253","Chesterfield","Hampshire County County","MA","Chesterfield",1997,25,720,745
"2254","Chesterfield","Hampshire County County","MA","Chesterfield",1998,24,757,781
"2255","Chesterfield","Hampshire County County","MA","Chesterfield",1999,20,827,847
"2256","Chesterfield","Hampshire County County","MA","Chesterfield",2000,13,706,719
"2257","Chesterfield","Hampshire County County","MA","Chesterfield",2001,19,717,736
"2258","Chesterfield","Hampshire County County","MA","Chesterfield",2002,24,713,737
"2259","Chesterfield","Hampshire County County","MA","Chesterfield",2003,30,716,746
"2260","Chesterfield","Hampshire County County","MA","Chesterfield",2004,30,723,753
"2261","Chesterfield","Hampshire County County","MA","Chesterfield",2005,22,732,754
"2262","Chesterfield","Hampshire County County","MA","Chesterfield",2006,34,739,773
"2263","Chesterfield","Hampshire County County","MA","Chesterfield",2007,25,740,765
"2264","Chesterfield","Hampshire County County","MA","Chesterfield",2008,32,742,774
"2265","Chesterfield","Hampshire County County","MA","Chesterfield",2009,50,710,760
"2266","Chesterfield","Hampshire County County","MA","Chesterfield",2010,55,674,729
"2267","Chesterfield","Hampshire County County","MA","Chesterfield",2011,39,665,704
"2268","Chesterfield","Hampshire County County","MA","Chesterfield",2012,40,665,705
"2269","Chicopee","Hampden County County","MA","Chicopee",1990,2026,27039,29065
"2270","Chicopee","Hampden County County","MA","Chicopee",1991,2857,26073,28930
"2271","Chicopee","Hampden County County","MA","Chicopee",1992,2663,25802,28465
"2272","Chicopee","Hampden County County","MA","Chicopee",1993,2538,25692,28230
"2273","Chicopee","Hampden County County","MA","Chicopee",1994,1978,25417,27395
"2274","Chicopee","Hampden County County","MA","Chicopee",1995,1794,25469,27263
"2275","Chicopee","Hampden County County","MA","Chicopee",1996,1447,25673,27120
"2276","Chicopee","Hampden County County","MA","Chicopee",1997,1282,26197,27479
"2277","Chicopee","Hampden County County","MA","Chicopee",1998,1143,26221,27364
"2278","Chicopee","Hampden County County","MA","Chicopee",1999,1070,26214,27284
"2279","Chicopee","Hampden County County","MA","Chicopee",2000,899,26521,27420
"2280","Chicopee","Hampden County County","MA","Chicopee",2001,1168,26548,27716
"2281","Chicopee","Hampden County County","MA","Chicopee",2002,1609,26398,28007
"2282","Chicopee","Hampden County County","MA","Chicopee",2003,1880,26129,28009
"2283","Chicopee","Hampden County County","MA","Chicopee",2004,1750,26078,27828
"2284","Chicopee","Hampden County County","MA","Chicopee",2005,1605,26103,27708
"2285","Chicopee","Hampden County County","MA","Chicopee",2006,1642,26160,27802
"2286","Chicopee","Hampden County County","MA","Chicopee",2007,1571,25967,27538
"2287","Chicopee","Hampden County County","MA","Chicopee",2008,1818,26244,28062
"2288","Chicopee","Hampden County County","MA","Chicopee",2009,2740,25491,28231
"2289","Chicopee","Hampden County County","MA","Chicopee",2010,2774,25275,28049
"2290","Chicopee","Hampden County County","MA","Chicopee",2011,2454,25022,27476
"2291","Chicopee","Hampden County County","MA","Chicopee",2012,2214,25037,27251
"2292","Chilmark","Dukes County County","MA","Chilmark",1990,13,353,366
"2293","Chilmark","Dukes County County","MA","Chilmark",1991,14,386,400
"2294","Chilmark","Dukes County County","MA","Chilmark",1992,12,369,381
"2295","Chilmark","Dukes County County","MA","Chilmark",1993,19,379,398
"2296","Chilmark","Dukes County County","MA","Chilmark",1994,21,428,449
"2297","Chilmark","Dukes County County","MA","Chilmark",1995,11,416,427
"2298","Chilmark","Dukes County County","MA","Chilmark",1996,16,437,453
"2299","Chilmark","Dukes County County","MA","Chilmark",1997,12,451,463
"2300","Chilmark","Dukes County County","MA","Chilmark",1998,11,449,460
"2301","Chilmark","Dukes County County","MA","Chilmark",1999,21,457,478
"2302","Chilmark","Dukes County County","MA","Chilmark",2000,16,543,559
"2303","Chilmark","Dukes County County","MA","Chilmark",2001,11,551,562
"2304","Chilmark","Dukes County County","MA","Chilmark",2002,14,580,594
"2305","Chilmark","Dukes County County","MA","Chilmark",2003,17,612,629
"2306","Chilmark","Dukes County County","MA","Chilmark",2004,14,626,640
"2307","Chilmark","Dukes County County","MA","Chilmark",2005,17,628,645
"2308","Chilmark","Dukes County County","MA","Chilmark",2006,19,642,661
"2309","Chilmark","Dukes County County","MA","Chilmark",2007,18,656,674
"2310","Chilmark","Dukes County County","MA","Chilmark",2008,19,661,680
"2311","Chilmark","Dukes County County","MA","Chilmark",2009,22,585,607
"2312","Chilmark","Dukes County County","MA","Chilmark",2010,36,549,585
"2313","Chilmark","Dukes County County","MA","Chilmark",2011,32,554,586
"2314","Chilmark","Dukes County County","MA","Chilmark",2012,30,559,589
"2315","Clarksburg","Berkshire County County","MA","Clarksburg",1990,50,879,929
"2316","Clarksburg","Berkshire County County","MA","Clarksburg",1991,102,855,957
"2317","Clarksburg","Berkshire County County","MA","Clarksburg",1992,96,844,940
"2318","Clarksburg","Berkshire County County","MA","Clarksburg",1993,81,888,969
"2319","Clarksburg","Berkshire County County","MA","Clarksburg",1994,72,884,956
"2320","Clarksburg","Berkshire County County","MA","Clarksburg",1995,56,842,898
"2321","Clarksburg","Berkshire County County","MA","Clarksburg",1996,58,852,910
"2322","Clarksburg","Berkshire County County","MA","Clarksburg",1997,40,863,903
"2323","Clarksburg","Berkshire County County","MA","Clarksburg",1998,39,798,837
"2324","Clarksburg","Berkshire County County","MA","Clarksburg",1999,40,808,848
"2325","Clarksburg","Berkshire County County","MA","Clarksburg",2000,26,888,914
"2326","Clarksburg","Berkshire County County","MA","Clarksburg",2001,32,895,927
"2327","Clarksburg","Berkshire County County","MA","Clarksburg",2002,42,894,936
"2328","Clarksburg","Berkshire County County","MA","Clarksburg",2003,47,886,933
"2329","Clarksburg","Berkshire County County","MA","Clarksburg",2004,52,880,932
"2330","Clarksburg","Berkshire County County","MA","Clarksburg",2005,49,885,934
"2331","Clarksburg","Berkshire County County","MA","Clarksburg",2006,43,893,936
"2332","Clarksburg","Berkshire County County","MA","Clarksburg",2007,43,893,936
"2333","Clarksburg","Berkshire County County","MA","Clarksburg",2008,55,888,943
"2334","Clarksburg","Berkshire County County","MA","Clarksburg",2009,92,866,958
"2335","Clarksburg","Berkshire County County","MA","Clarksburg",2010,82,898,980
"2336","Clarksburg","Berkshire County County","MA","Clarksburg",2011,76,896,972
"2337","Clarksburg","Berkshire County County","MA","Clarksburg",2012,63,885,948
"2338","Clinton","Worcester County County","MA","Clinton",1990,523,6828,7351
"2339","Clinton","Worcester County County","MA","Clinton",1991,722,6458,7180
"2340","Clinton","Worcester County County","MA","Clinton",1992,724,6446,7170
"2341","Clinton","Worcester County County","MA","Clinton",1993,600,6567,7167
"2342","Clinton","Worcester County County","MA","Clinton",1994,504,6605,7109
"2343","Clinton","Worcester County County","MA","Clinton",1995,474,6721,7195
"2344","Clinton","Worcester County County","MA","Clinton",1996,377,6794,7171
"2345","Clinton","Worcester County County","MA","Clinton",1997,268,6931,7199
"2346","Clinton","Worcester County County","MA","Clinton",1998,241,7060,7301
"2347","Clinton","Worcester County County","MA","Clinton",1999,276,7009,7285
"2348","Clinton","Worcester County County","MA","Clinton",2000,194,7072,7266
"2349","Clinton","Worcester County County","MA","Clinton",2001,302,7086,7388
"2350","Clinton","Worcester County County","MA","Clinton",2002,443,7050,7493
"2351","Clinton","Worcester County County","MA","Clinton",2003,494,7004,7498
"2352","Clinton","Worcester County County","MA","Clinton",2004,464,7049,7513
"2353","Clinton","Worcester County County","MA","Clinton",2005,425,7079,7504
"2354","Clinton","Worcester County County","MA","Clinton",2006,418,7220,7638
"2355","Clinton","Worcester County County","MA","Clinton",2007,396,7205,7601
"2356","Clinton","Worcester County County","MA","Clinton",2008,469,7048,7517
"2357","Clinton","Worcester County County","MA","Clinton",2009,715,6851,7566
"2358","Clinton","Worcester County County","MA","Clinton",2010,748,6588,7336
"2359","Clinton","Worcester County County","MA","Clinton",2011,666,6646,7312
"2360","Clinton","Worcester County County","MA","Clinton",2012,616,6644,7260
"2361","Cohasset","Norfolk County County","MA","Cohasset",1990,255,3766,4021
"2362","Cohasset","Norfolk County County","MA","Cohasset",1991,264,3681,3945
"2363","Cohasset","Norfolk County County","MA","Cohasset",1992,235,3708,3943
"2364","Cohasset","Norfolk County County","MA","Cohasset",1993,167,3775,3942
"2365","Cohasset","Norfolk County County","MA","Cohasset",1994,137,3903,4040
"2366","Cohasset","Norfolk County County","MA","Cohasset",1995,114,3714,3828
"2367","Cohasset","Norfolk County County","MA","Cohasset",1996,117,3774,3891
"2368","Cohasset","Norfolk County County","MA","Cohasset",1997,86,3864,3950
"2369","Cohasset","Norfolk County County","MA","Cohasset",1998,82,3922,4004
"2370","Cohasset","Norfolk County County","MA","Cohasset",1999,60,3961,4021
"2371","Cohasset","Norfolk County County","MA","Cohasset",2000,77,3625,3702
"2372","Cohasset","Norfolk County County","MA","Cohasset",2001,105,3618,3723
"2373","Cohasset","Norfolk County County","MA","Cohasset",2002,148,3559,3707
"2374","Cohasset","Norfolk County County","MA","Cohasset",2003,164,3504,3668
"2375","Cohasset","Norfolk County County","MA","Cohasset",2004,152,3495,3647
"2376","Cohasset","Norfolk County County","MA","Cohasset",2005,127,3506,3633
"2377","Cohasset","Norfolk County County","MA","Cohasset",2006,115,3506,3621
"2378","Cohasset","Norfolk County County","MA","Cohasset",2007,120,3531,3651
"2379","Cohasset","Norfolk County County","MA","Cohasset",2008,146,3534,3680
"2380","Cohasset","Norfolk County County","MA","Cohasset",2009,232,3433,3665
"2381","Cohasset","Norfolk County County","MA","Cohasset",2010,210,3547,3757
"2382","Cohasset","Norfolk County County","MA","Cohasset",2011,189,3586,3775
"2383","Cohasset","Norfolk County County","MA","Cohasset",2012,182,3626,3808
"2384","Colrain","Franklin County County","MA","Colrain",1990,43,822,865
"2385","Colrain","Franklin County County","MA","Colrain",1991,67,805,872
"2386","Colrain","Franklin County County","MA","Colrain",1992,64,804,868
"2387","Colrain","Franklin County County","MA","Colrain",1993,63,811,874
"2388","Colrain","Franklin County County","MA","Colrain",1994,47,837,884
"2389","Colrain","Franklin County County","MA","Colrain",1995,47,861,908
"2390","Colrain","Franklin County County","MA","Colrain",1996,41,863,904
"2391","Colrain","Franklin County County","MA","Colrain",1997,57,882,939
"2392","Colrain","Franklin County County","MA","Colrain",1998,48,907,955
"2393","Colrain","Franklin County County","MA","Colrain",1999,30,927,957
"2394","Colrain","Franklin County County","MA","Colrain",2000,25,944,969
"2395","Colrain","Franklin County County","MA","Colrain",2001,30,946,976
"2396","Colrain","Franklin County County","MA","Colrain",2002,38,966,1004
"2397","Colrain","Franklin County County","MA","Colrain",2003,50,974,1024
"2398","Colrain","Franklin County County","MA","Colrain",2004,55,956,1011
"2399","Colrain","Franklin County County","MA","Colrain",2005,45,954,999
"2400","Colrain","Franklin County County","MA","Colrain",2006,48,955,1003
"2401","Colrain","Franklin County County","MA","Colrain",2007,38,943,981
"2402","Colrain","Franklin County County","MA","Colrain",2008,51,948,999
"2403","Colrain","Franklin County County","MA","Colrain",2009,76,929,1005
"2404","Colrain","Franklin County County","MA","Colrain",2010,84,834,918
"2405","Colrain","Franklin County County","MA","Colrain",2011,59,836,895
"2406","Colrain","Franklin County County","MA","Colrain",2012,61,838,899
"2407","Concord","Middlesex County County","MA","Concord",1990,285,8211,8496
"2408","Concord","Middlesex County County","MA","Concord",1991,312,8063,8375
"2409","Concord","Middlesex County County","MA","Concord",1992,340,8072,8412
"2410","Concord","Middlesex County County","MA","Concord",1993,309,8101,8410
"2411","Concord","Middlesex County County","MA","Concord",1994,263,8263,8526
"2412","Concord","Middlesex County County","MA","Concord",1995,215,8426,8641
"2413","Concord","Middlesex County County","MA","Concord",1996,179,8590,8769
"2414","Concord","Middlesex County County","MA","Concord",1997,151,8801,8952
"2415","Concord","Middlesex County County","MA","Concord",1998,141,8885,9026
"2416","Concord","Middlesex County County","MA","Concord",1999,142,8966,9108
"2417","Concord","Middlesex County County","MA","Concord",2000,152,7712,7864
"2418","Concord","Middlesex County County","MA","Concord",2001,231,7663,7894
"2419","Concord","Middlesex County County","MA","Concord",2002,346,7508,7854
"2420","Concord","Middlesex County County","MA","Concord",2003,346,7384,7730
"2421","Concord","Middlesex County County","MA","Concord",2004,304,7390,7694
"2422","Concord","Middlesex County County","MA","Concord",2005,275,7431,7706
"2423","Concord","Middlesex County County","MA","Concord",2006,261,7712,7973
"2424","Concord","Middlesex County County","MA","Concord",2007,233,7682,7915
"2425","Concord","Middlesex County County","MA","Concord",2008,300,7672,7972
"2426","Concord","Middlesex County County","MA","Concord",2009,460,7405,7865
"2427","Concord","Middlesex County County","MA","Concord",2010,463,7554,8017
"2428","Concord","Middlesex County County","MA","Concord",2011,389,7658,8047
"2429","Concord","Middlesex County County","MA","Concord",2012,385,7742,8127
"2430","Conway","Franklin County County","MA","Conway",1990,46,836,882
"2431","Conway","Franklin County County","MA","Conway",1991,56,835,891
"2432","Conway","Franklin County County","MA","Conway",1992,71,828,899
"2433","Conway","Franklin County County","MA","Conway",1993,50,864,914
"2434","Conway","Franklin County County","MA","Conway",1994,36,928,964
"2435","Conway","Franklin County County","MA","Conway",1995,36,892,928
"2436","Conway","Franklin County County","MA","Conway",1996,27,903,930
"2437","Conway","Franklin County County","MA","Conway",1997,23,925,948
"2438","Conway","Franklin County County","MA","Conway",1998,22,946,968
"2439","Conway","Franklin County County","MA","Conway",1999,30,972,1002
"2440","Conway","Franklin County County","MA","Conway",2000,21,1095,1116
"2441","Conway","Franklin County County","MA","Conway",2001,28,1112,1140
"2442","Conway","Franklin County County","MA","Conway",2002,30,1119,1149
"2443","Conway","Franklin County County","MA","Conway",2003,39,1114,1153
"2444","Conway","Franklin County County","MA","Conway",2004,36,1118,1154
"2445","Conway","Franklin County County","MA","Conway",2005,37,1132,1169
"2446","Conway","Franklin County County","MA","Conway",2006,38,1136,1174
"2447","Conway","Franklin County County","MA","Conway",2007,32,1130,1162
"2448","Conway","Franklin County County","MA","Conway",2008,40,1127,1167
"2449","Conway","Franklin County County","MA","Conway",2009,56,1076,1132
"2450","Conway","Franklin County County","MA","Conway",2010,62,1079,1141
"2451","Conway","Franklin County County","MA","Conway",2011,58,1071,1129
"2452","Conway","Franklin County County","MA","Conway",2012,44,1072,1116
"2453","Cummington","Hampshire County County","MA","Cummington",1990,32,448,480
"2454","Cummington","Hampshire County County","MA","Cummington",1991,53,422,475
"2455","Cummington","Hampshire County County","MA","Cummington",1992,68,475,543
"2456","Cummington","Hampshire County County","MA","Cummington",1993,45,485,530
"2457","Cummington","Hampshire County County","MA","Cummington",1994,39,517,556
"2458","Cummington","Hampshire County County","MA","Cummington",1995,28,521,549
"2459","Cummington","Hampshire County County","MA","Cummington",1996,30,505,535
"2460","Cummington","Hampshire County County","MA","Cummington",1997,24,508,532
"2461","Cummington","Hampshire County County","MA","Cummington",1998,16,531,547
"2462","Cummington","Hampshire County County","MA","Cummington",1999,19,574,593
"2463","Cummington","Hampshire County County","MA","Cummington",2000,13,499,512
"2464","Cummington","Hampshire County County","MA","Cummington",2001,18,499,517
"2465","Cummington","Hampshire County County","MA","Cummington",2002,27,496,523
"2466","Cummington","Hampshire County County","MA","Cummington",2003,29,496,525
"2467","Cummington","Hampshire County County","MA","Cummington",2004,30,497,527
"2468","Cummington","Hampshire County County","MA","Cummington",2005,29,496,525
"2469","Cummington","Hampshire County County","MA","Cummington",2006,36,497,533
"2470","Cummington","Hampshire County County","MA","Cummington",2007,27,494,521
"2471","Cummington","Hampshire County County","MA","Cummington",2008,32,484,516
"2472","Cummington","Hampshire County County","MA","Cummington",2009,43,465,508
"2473","Cummington","Hampshire County County","MA","Cummington",2010,38,419,457
"2474","Cummington","Hampshire County County","MA","Cummington",2011,38,414,452
"2475","Cummington","Hampshire County County","MA","Cummington",2012,32,414,446
"2476","Dalton","Berkshire County County","MA","Dalton",1990,189,3538,3727
"2477","Dalton","Berkshire County County","MA","Dalton",1991,302,3386,3688
"2478","Dalton","Berkshire County County","MA","Dalton",1992,348,3353,3701
"2479","Dalton","Berkshire County County","MA","Dalton",1993,289,3358,3647
"2480","Dalton","Berkshire County County","MA","Dalton",1994,238,3338,3576
"2481","Dalton","Berkshire County County","MA","Dalton",1995,173,3256,3429
"2482","Dalton","Berkshire County County","MA","Dalton",1996,152,3309,3461
"2483","Dalton","Berkshire County County","MA","Dalton",1997,146,3333,3479
"2484","Dalton","Berkshire County County","MA","Dalton",1998,125,3310,3435
"2485","Dalton","Berkshire County County","MA","Dalton",1999,120,3311,3431
"2486","Dalton","Berkshire County County","MA","Dalton",2000,89,3605,3694
"2487","Dalton","Berkshire County County","MA","Dalton",2001,123,3591,3714
"2488","Dalton","Berkshire County County","MA","Dalton",2002,151,3632,3783
"2489","Dalton","Berkshire County County","MA","Dalton",2003,171,3604,3775
"2490","Dalton","Berkshire County County","MA","Dalton",2004,145,3602,3747
"2491","Dalton","Berkshire County County","MA","Dalton",2005,148,3646,3794
"2492","Dalton","Berkshire County County","MA","Dalton",2006,149,3702,3851
"2493","Dalton","Berkshire County County","MA","Dalton",2007,151,3670,3821
"2494","Dalton","Berkshire County County","MA","Dalton",2008,170,3651,3821
"2495","Dalton","Berkshire County County","MA","Dalton",2009,287,3527,3814
"2496","Dalton","Berkshire County County","MA","Dalton",2010,290,3508,3798
"2497","Dalton","Berkshire County County","MA","Dalton",2011,249,3539,3788
"2498","Dalton","Berkshire County County","MA","Dalton",2012,240,3523,3763
"2499","Danvers","Essex County County","MA","Danvers",1990,702,13101,13803
"2500","Danvers","Essex County County","MA","Danvers",1991,946,12795,13741
"2501","Danvers","Essex County County","MA","Danvers",1992,1067,12636,13703
"2502","Danvers","Essex County County","MA","Danvers",1993,830,12783,13613
"2503","Danvers","Essex County County","MA","Danvers",1994,627,13059,13686
"2504","Danvers","Essex County County","MA","Danvers",1995,531,13041,13572
"2505","Danvers","Essex County County","MA","Danvers",1996,426,13346,13772
"2506","Danvers","Essex County County","MA","Danvers",1997,418,13790,14208
"2507","Danvers","Essex County County","MA","Danvers",1998,398,14271,14669
"2508","Danvers","Essex County County","MA","Danvers",1999,340,14509,14849
"2509","Danvers","Essex County County","MA","Danvers",2000,296,13297,13593
"2510","Danvers","Essex County County","MA","Danvers",2001,440,13348,13788
"2511","Danvers","Essex County County","MA","Danvers",2002,648,13172,13820
"2512","Danvers","Essex County County","MA","Danvers",2003,738,13094,13832
"2513","Danvers","Essex County County","MA","Danvers",2004,696,13048,13744
"2514","Danvers","Essex County County","MA","Danvers",2005,611,13379,13990
"2515","Danvers","Essex County County","MA","Danvers",2006,601,13431,14032
"2516","Danvers","Essex County County","MA","Danvers",2007,560,13953,14513
"2517","Danvers","Essex County County","MA","Danvers",2008,702,13985,14687
"2518","Danvers","Essex County County","MA","Danvers",2009,1133,13806,14939
"2519","Danvers","Essex County County","MA","Danvers",2010,1071,13459,14530
"2520","Danvers","Essex County County","MA","Danvers",2011,913,13612,14525
"2521","Danvers","Essex County County","MA","Danvers",2012,895,13717,14612
"2522","Dartmouth","Bristol County County","MA","Dartmouth",1990,1126,12676,13802
"2523","Dartmouth","Bristol County County","MA","Dartmouth",1991,1541,12258,13799
"2524","Dartmouth","Bristol County County","MA","Dartmouth",1992,1499,12245,13744
"2525","Dartmouth","Bristol County County","MA","Dartmouth",1993,1272,12675,13947
"2526","Dartmouth","Bristol County County","MA","Dartmouth",1994,1211,13013,14224
"2527","Dartmouth","Bristol County County","MA","Dartmouth",1995,1080,12769,13849
"2528","Dartmouth","Bristol County County","MA","Dartmouth",1996,963,12743,13706
"2529","Dartmouth","Bristol County County","MA","Dartmouth",1997,878,13121,13999
"2530","Dartmouth","Bristol County County","MA","Dartmouth",1998,735,13757,14492
"2531","Dartmouth","Bristol County County","MA","Dartmouth",1999,658,13937,14595
"2532","Dartmouth","Bristol County County","MA","Dartmouth",2000,544,14810,15354
"2533","Dartmouth","Bristol County County","MA","Dartmouth",2001,633,14453,15086
"2534","Dartmouth","Bristol County County","MA","Dartmouth",2002,810,14675,15485
"2535","Dartmouth","Bristol County County","MA","Dartmouth",2003,933,14453,15386
"2536","Dartmouth","Bristol County County","MA","Dartmouth",2004,867,14609,15476
"2537","Dartmouth","Bristol County County","MA","Dartmouth",2005,882,14871,15753
"2538","Dartmouth","Bristol County County","MA","Dartmouth",2006,852,15118,15970
"2539","Dartmouth","Bristol County County","MA","Dartmouth",2007,875,15100,15975
"2540","Dartmouth","Bristol County County","MA","Dartmouth",2008,1082,15955,17037
"2541","Dartmouth","Bristol County County","MA","Dartmouth",2009,1592,15754,17346
"2542","Dartmouth","Bristol County County","MA","Dartmouth",2010,1688,15357,17045
"2543","Dartmouth","Bristol County County","MA","Dartmouth",2011,1504,15513,17017
"2544","Dartmouth","Bristol County County","MA","Dartmouth",2012,1388,15696,17084
"2545","Dedham","Norfolk County County","MA","Dedham",1990,661,12245,12906
"2546","Dedham","Norfolk County County","MA","Dedham",1991,934,11821,12755
"2547","Dedham","Norfolk County County","MA","Dedham",1992,1005,11705,12710
"2548","Dedham","Norfolk County County","MA","Dedham",1993,863,11838,12701
"2549","Dedham","Norfolk County County","MA","Dedham",1994,728,11901,12629
"2550","Dedham","Norfolk County County","MA","Dedham",1995,615,16581,17196
"2551","Dedham","Norfolk County County","MA","Dedham",1996,532,16854,17386
"2552","Dedham","Norfolk County County","MA","Dedham",1997,510,12592,13102
"2553","Dedham","Norfolk County County","MA","Dedham",1998,381,12714,13095
"2554","Dedham","Norfolk County County","MA","Dedham",1999,332,12760,13092
"2555","Dedham","Norfolk County County","MA","Dedham",2000,324,12139,12463
"2556","Dedham","Norfolk County County","MA","Dedham",2001,411,12040,12451
"2557","Dedham","Norfolk County County","MA","Dedham",2002,622,11791,12413
"2558","Dedham","Norfolk County County","MA","Dedham",2003,651,11565,12216
"2559","Dedham","Norfolk County County","MA","Dedham",2004,622,11573,12195
"2560","Dedham","Norfolk County County","MA","Dedham",2005,538,11949,12487
"2561","Dedham","Norfolk County County","MA","Dedham",2006,547,11867,12414
"2562","Dedham","Norfolk County County","MA","Dedham",2007,503,12237,12740
"2563","Dedham","Norfolk County County","MA","Dedham",2008,623,12356,12979
"2564","Dedham","Norfolk County County","MA","Dedham",2009,960,11919,12879
"2565","Dedham","Norfolk County County","MA","Dedham",2010,992,12059,13051
"2566","Dedham","Norfolk County County","MA","Dedham",2011,824,12191,13015
"2567","Dedham","Norfolk County County","MA","Dedham",2012,766,12325,13091
"2568","Deerfield","Franklin County County","MA","Deerfield",1990,111,2869,2980
"2569","Deerfield","Franklin County County","MA","Deerfield",1991,182,2835,3017
"2570","Deerfield","Franklin County County","MA","Deerfield",1992,193,2782,2975
"2571","Deerfield","Franklin County County","MA","Deerfield",1993,161,2805,2966
"2572","Deerfield","Franklin County County","MA","Deerfield",1994,158,2915,3073
"2573","Deerfield","Franklin County County","MA","Deerfield",1995,127,2847,2974
"2574","Deerfield","Franklin County County","MA","Deerfield",1996,94,2858,2952
"2575","Deerfield","Franklin County County","MA","Deerfield",1997,100,2922,3022
"2576","Deerfield","Franklin County County","MA","Deerfield",1998,89,3094,3183
"2577","Deerfield","Franklin County County","MA","Deerfield",1999,74,3144,3218
"2578","Deerfield","Franklin County County","MA","Deerfield",2000,66,2738,2804
"2579","Deerfield","Franklin County County","MA","Deerfield",2001,80,2748,2828
"2580","Deerfield","Franklin County County","MA","Deerfield",2002,109,2735,2844
"2581","Deerfield","Franklin County County","MA","Deerfield",2003,136,2700,2836
"2582","Deerfield","Franklin County County","MA","Deerfield",2004,103,2713,2816
"2583","Deerfield","Franklin County County","MA","Deerfield",2005,105,2716,2821
"2584","Deerfield","Franklin County County","MA","Deerfield",2006,114,2718,2832
"2585","Deerfield","Franklin County County","MA","Deerfield",2007,111,2711,2822
"2586","Deerfield","Franklin County County","MA","Deerfield",2008,120,2666,2786
"2587","Deerfield","Franklin County County","MA","Deerfield",2009,204,2537,2741
"2588","Deerfield","Franklin County County","MA","Deerfield",2010,197,2784,2981
"2589","Deerfield","Franklin County County","MA","Deerfield",2011,177,2763,2940
"2590","Deerfield","Franklin County County","MA","Deerfield",2012,172,2765,2937
"2591","Dennis","Barnstable County County","MA","Dennis",1990,387,6027,6414
"2592","Dennis","Barnstable County County","MA","Dennis",1991,607,5687,6294
"2593","Dennis","Barnstable County County","MA","Dennis",1992,797,5609,6406
"2594","Dennis","Barnstable County County","MA","Dennis",1993,641,5712,6353
"2595","Dennis","Barnstable County County","MA","Dennis",1994,596,5817,6413
"2596","Dennis","Barnstable County County","MA","Dennis",1995,488,6090,6578
"2597","Dennis","Barnstable County County","MA","Dennis",1996,414,6208,6622
"2598","Dennis","Barnstable County County","MA","Dennis",1997,405,6267,6672
"2599","Dennis","Barnstable County County","MA","Dennis",1998,366,6362,6728
"2600","Dennis","Barnstable County County","MA","Dennis",1999,342,6564,6906
"2601","Dennis","Barnstable County County","MA","Dennis",2000,301,7543,7844
"2602","Dennis","Barnstable County County","MA","Dennis",2001,337,7586,7923
"2603","Dennis","Barnstable County County","MA","Dennis",2002,421,7693,8114
"2604","Dennis","Barnstable County County","MA","Dennis",2003,483,7838,8321
"2605","Dennis","Barnstable County County","MA","Dennis",2004,443,7881,8324
"2606","Dennis","Barnstable County County","MA","Dennis",2005,447,7812,8259
"2607","Dennis","Barnstable County County","MA","Dennis",2006,439,7788,8227
"2608","Dennis","Barnstable County County","MA","Dennis",2007,424,7724,8148
"2609","Dennis","Barnstable County County","MA","Dennis",2008,499,7653,8152
"2610","Dennis","Barnstable County County","MA","Dennis",2009,723,7482,8205
"2611","Dennis","Barnstable County County","MA","Dennis",2010,771,6985,7756
"2612","Dennis","Barnstable County County","MA","Dennis",2011,649,6973,7622
"2613","Dennis","Barnstable County County","MA","Dennis",2012,571,7090,7661
"2614","Dighton","Bristol County County","MA","Dighton",1990,215,2858,3073
"2615","Dighton","Bristol County County","MA","Dighton",1991,298,2793,3091
"2616","Dighton","Bristol County County","MA","Dighton",1992,315,2809,3124
"2617","Dighton","Bristol County County","MA","Dighton",1993,252,2782,3034
"2618","Dighton","Bristol County County","MA","Dighton",1994,231,2859,3090
"2619","Dighton","Bristol County County","MA","Dighton",1995,190,2926,3116
"2620","Dighton","Bristol County County","MA","Dighton",1996,153,2990,3143
"2621","Dighton","Bristol County County","MA","Dighton",1997,152,3070,3222
"2622","Dighton","Bristol County County","MA","Dighton",1998,111,3113,3224
"2623","Dighton","Bristol County County","MA","Dighton",1999,101,3162,3263
"2624","Dighton","Bristol County County","MA","Dighton",2000,96,3406,3502
"2625","Dighton","Bristol County County","MA","Dighton",2001,125,3453,3578
"2626","Dighton","Bristol County County","MA","Dighton",2002,174,3488,3662
"2627","Dighton","Bristol County County","MA","Dighton",2003,192,3519,3711
"2628","Dighton","Bristol County County","MA","Dighton",2004,191,3533,3724
"2629","Dighton","Bristol County County","MA","Dighton",2005,173,3617,3790
"2630","Dighton","Bristol County County","MA","Dighton",2006,180,3690,3870
"2631","Dighton","Bristol County County","MA","Dighton",2007,178,3739,3917
"2632","Dighton","Bristol County County","MA","Dighton",2008,228,3721,3949
"2633","Dighton","Bristol County County","MA","Dighton",2009,335,3608,3943
"2634","Dighton","Bristol County County","MA","Dighton",2010,360,3757,4117
"2635","Dighton","Bristol County County","MA","Dighton",2011,281,3795,4076
"2636","Dighton","Bristol County County","MA","Dighton",2012,272,3784,4056
"2637","Douglas","Worcester County County","MA","Douglas",1990,231,2696,2927
"2638","Douglas","Worcester County County","MA","Douglas",1991,303,2683,2986
"2639","Douglas","Worcester County County","MA","Douglas",1992,307,2832,3139
"2640","Douglas","Worcester County County","MA","Douglas",1993,170,3034,3204
"2641","Douglas","Worcester County County","MA","Douglas",1994,169,3194,3363
"2642","Douglas","Worcester County County","MA","Douglas",1995,138,2912,3050
"2643","Douglas","Worcester County County","MA","Douglas",1996,131,3048,3179
"2644","Douglas","Worcester County County","MA","Douglas",1997,108,3231,3339
"2645","Douglas","Worcester County County","MA","Douglas",1998,100,3533,3633
"2646","Douglas","Worcester County County","MA","Douglas",1999,116,3608,3724
"2647","Douglas","Worcester County County","MA","Douglas",2000,102,4024,4126
"2648","Douglas","Worcester County County","MA","Douglas",2001,139,4122,4261
"2649","Douglas","Worcester County County","MA","Douglas",2002,223,4161,4384
"2650","Douglas","Worcester County County","MA","Douglas",2003,240,4203,4443
"2651","Douglas","Worcester County County","MA","Douglas",2004,215,4250,4465
"2652","Douglas","Worcester County County","MA","Douglas",2005,213,4305,4518
"2653","Douglas","Worcester County County","MA","Douglas",2006,215,4373,4588
"2654","Douglas","Worcester County County","MA","Douglas",2007,222,4389,4611
"2655","Douglas","Worcester County County","MA","Douglas",2008,246,4324,4570
"2656","Douglas","Worcester County County","MA","Douglas",2009,394,4217,4611
"2657","Douglas","Worcester County County","MA","Douglas",2010,365,4427,4792
"2658","Douglas","Worcester County County","MA","Douglas",2011,334,4466,4800
"2659","Douglas","Worcester County County","MA","Douglas",2012,308,4464,4772
"2660","Dover","Norfolk County County","MA","Dover",1990,74,2453,2527
"2661","Dover","Norfolk County County","MA","Dover",1991,114,2408,2522
"2662","Dover","Norfolk County County","MA","Dover",1992,128,2460,2588
"2663","Dover","Norfolk County County","MA","Dover",1993,74,2544,2618
"2664","Dover","Norfolk County County","MA","Dover",1994,94,2681,2775
"2665","Dover","Norfolk County County","MA","Dover",1995,72,2604,2676
"2666","Dover","Norfolk County County","MA","Dover",1996,46,2693,2739
"2667","Dover","Norfolk County County","MA","Dover",1997,50,2782,2832
"2668","Dover","Norfolk County County","MA","Dover",1998,38,2831,2869
"2669","Dover","Norfolk County County","MA","Dover",1999,27,2869,2896
"2670","Dover","Norfolk County County","MA","Dover",2000,43,2796,2839
"2671","Dover","Norfolk County County","MA","Dover",2001,70,2810,2880
"2672","Dover","Norfolk County County","MA","Dover",2002,102,2776,2878
"2673","Dover","Norfolk County County","MA","Dover",2003,97,2743,2840
"2674","Dover","Norfolk County County","MA","Dover",2004,84,2734,2818
"2675","Dover","Norfolk County County","MA","Dover",2005,76,2755,2831
"2676","Dover","Norfolk County County","MA","Dover",2006,72,2715,2787
"2677","Dover","Norfolk County County","MA","Dover",2007,65,2739,2804
"2678","Dover","Norfolk County County","MA","Dover",2008,88,2748,2836
"2679","Dover","Norfolk County County","MA","Dover",2009,145,2671,2816
"2680","Dover","Norfolk County County","MA","Dover",2010,135,2644,2779
"2681","Dover","Norfolk County County","MA","Dover",2011,117,2673,2790
"2682","Dover","Norfolk County County","MA","Dover",2012,110,2703,2813
"2683","Dracut","Middlesex County County","MA","Dracut",1990,1149,14209,15358
"2684","Dracut","Middlesex County County","MA","Dracut",1991,1585,13860,15445
"2685","Dracut","Middlesex County County","MA","Dracut",1992,1765,14008,15773
"2686","Dracut","Middlesex County County","MA","Dracut",1993,1498,14141,15639
"2687","Dracut","Middlesex County County","MA","Dracut",1994,1206,14443,15649
"2688","Dracut","Middlesex County County","MA","Dracut",1995,970,14530,15500
"2689","Dracut","Middlesex County County","MA","Dracut",1996,749,15071,15820
"2690","Dracut","Middlesex County County","MA","Dracut",1997,658,15693,16351
"2691","Dracut","Middlesex County County","MA","Dracut",1998,541,16088,16629
"2692","Dracut","Middlesex County County","MA","Dracut",1999,563,16563,17126
"2693","Dracut","Middlesex County County","MA","Dracut",2000,413,15877,16290
"2694","Dracut","Middlesex County County","MA","Dracut",2001,584,15966,16550
"2695","Dracut","Middlesex County County","MA","Dracut",2002,995,15640,16635
"2696","Dracut","Middlesex County County","MA","Dracut",2003,994,15398,16392
"2697","Dracut","Middlesex County County","MA","Dracut",2004,930,15271,16201
"2698","Dracut","Middlesex County County","MA","Dracut",2005,799,15494,16293
"2699","Dracut","Middlesex County County","MA","Dracut",2006,781,15741,16522
"2700","Dracut","Middlesex County County","MA","Dracut",2007,777,15796,16573
"2701","Dracut","Middlesex County County","MA","Dracut",2008,892,15755,16647
"2702","Dracut","Middlesex County County","MA","Dracut",2009,1438,15252,16690
"2703","Dracut","Middlesex County County","MA","Dracut",2010,1470,15387,16857
"2704","Dracut","Middlesex County County","MA","Dracut",2011,1217,15555,16772
"2705","Dracut","Middlesex County County","MA","Dracut",2012,1132,15726,16858
"2706","Dudley","Worcester County County","MA","Dudley",1990,337,4863,5200
"2707","Dudley","Worcester County County","MA","Dudley",1991,489,4745,5234
"2708","Dudley","Worcester County County","MA","Dudley",1992,519,4699,5218
"2709","Dudley","Worcester County County","MA","Dudley",1993,399,4789,5188
"2710","Dudley","Worcester County County","MA","Dudley",1994,295,4858,5153
"2711","Dudley","Worcester County County","MA","Dudley",1995,252,4880,5132
"2712","Dudley","Worcester County County","MA","Dudley",1996,225,4974,5199
"2713","Dudley","Worcester County County","MA","Dudley",1997,212,5111,5323
"2714","Dudley","Worcester County County","MA","Dudley",1998,220,4967,5187
"2715","Dudley","Worcester County County","MA","Dudley",1999,191,4958,5149
"2716","Dudley","Worcester County County","MA","Dudley",2000,149,5421,5570
"2717","Dudley","Worcester County County","MA","Dudley",2001,214,5471,5685
"2718","Dudley","Worcester County County","MA","Dudley",2002,305,5520,5825
"2719","Dudley","Worcester County County","MA","Dudley",2003,379,5578,5957
"2720","Dudley","Worcester County County","MA","Dudley",2004,334,5595,5929
"2721","Dudley","Worcester County County","MA","Dudley",2005,321,5597,5918
"2722","Dudley","Worcester County County","MA","Dudley",2006,324,5648,5972
"2723","Dudley","Worcester County County","MA","Dudley",2007,301,5695,5996
"2724","Dudley","Worcester County County","MA","Dudley",2008,355,5719,6074
"2725","Dudley","Worcester County County","MA","Dudley",2009,556,5548,6104
"2726","Dudley","Worcester County County","MA","Dudley",2010,547,5644,6191
"2727","Dudley","Worcester County County","MA","Dudley",2011,471,5692,6163
"2728","Dudley","Worcester County County","MA","Dudley",2012,435,5690,6125
"2729",NA,"Dukes County County","MA","Dukes County County",1990,382,7149,7531
"2730",NA,"Dukes County County","MA","Dukes County County",1991,562,7292,7854
"2731",NA,"Dukes County County","MA","Dukes County County",1992,596,6916,7512
"2732",NA,"Dukes County County","MA","Dukes County County",1993,583,7180,7763
"2733",NA,"Dukes County County","MA","Dukes County County",1994,565,7772,8337
"2734",NA,"Dukes County County","MA","Dukes County County",1995,496,8217,8713
"2735",NA,"Dukes County County","MA","Dukes County County",1996,486,8582,9068
"2736",NA,"Dukes County County","MA","Dukes County County",1997,468,8815,9283
"2737",NA,"Dukes County County","MA","Dukes County County",1998,382,9009,9391
"2738",NA,"Dukes County County","MA","Dukes County County",1999,370,9164,9534
"2739",NA,"Dukes County County","MA","Dukes County County",2000,281,9794,10075
"2740",NA,"Dukes County County","MA","Dukes County County",2001,296,9855,10151
"2741",NA,"Dukes County County","MA","Dukes County County",2002,407,10228,10635
"2742",NA,"Dukes County County","MA","Dukes County County",2003,469,10607,11076
"2743",NA,"Dukes County County","MA","Dukes County County",2004,450,10685,11135
"2744",NA,"Dukes County County","MA","Dukes County County",2005,431,10543,10974
"2745",NA,"Dukes County County","MA","Dukes County County",2006,430,10639,11069
"2746",NA,"Dukes County County","MA","Dukes County County",2007,393,10752,11145
"2747",NA,"Dukes County County","MA","Dukes County County",2008,466,10758,11224
"2748",NA,"Dukes County County","MA","Dukes County County",2009,727,10604,11331
"2749",NA,"Dukes County County","MA","Dukes County County",2010,877,10670,11547
"2750",NA,"Dukes County County","MA","Dukes County County",2011,843,10752,11595
"2751",NA,"Dukes County County","MA","Dukes County County",2012,805,10860,11665
"2752","Dunstable","Middlesex County County","MA","Dunstable",1990,78,1272,1350
"2753","Dunstable","Middlesex County County","MA","Dunstable",1991,108,1269,1377
"2754","Dunstable","Middlesex County County","MA","Dunstable",1992,114,1298,1412
"2755","Dunstable","Middlesex County County","MA","Dunstable",1993,65,1331,1396
"2756","Dunstable","Middlesex County County","MA","Dunstable",1994,69,1356,1425
"2757","Dunstable","Middlesex County County","MA","Dunstable",1995,61,1351,1412
"2758","Dunstable","Middlesex County County","MA","Dunstable",1996,52,1432,1484
"2759","Dunstable","Middlesex County County","MA","Dunstable",1997,50,1522,1572
"2760","Dunstable","Middlesex County County","MA","Dunstable",1998,44,1592,1636
"2761","Dunstable","Middlesex County County","MA","Dunstable",1999,40,1679,1719
"2762","Dunstable","Middlesex County County","MA","Dunstable",2000,35,1638,1673
"2763","Dunstable","Middlesex County County","MA","Dunstable",2001,52,1685,1737
"2764","Dunstable","Middlesex County County","MA","Dunstable",2002,88,1684,1772
"2765","Dunstable","Middlesex County County","MA","Dunstable",2003,90,1693,1783
"2766","Dunstable","Middlesex County County","MA","Dunstable",2004,75,1711,1786
"2767","Dunstable","Middlesex County County","MA","Dunstable",2005,64,1752,1816
"2768","Dunstable","Middlesex County County","MA","Dunstable",2006,64,1788,1852
"2769","Dunstable","Middlesex County County","MA","Dunstable",2007,62,1825,1887
"2770","Dunstable","Middlesex County County","MA","Dunstable",2008,74,1838,1912
"2771","Dunstable","Middlesex County County","MA","Dunstable",2009,119,1819,1938
"2772","Dunstable","Middlesex County County","MA","Dunstable",2010,110,1720,1830
"2773","Dunstable","Middlesex County County","MA","Dunstable",2011,102,1739,1841
"2774","Dunstable","Middlesex County County","MA","Dunstable",2012,98,1758,1856
"2775","Duxbury","Plymouth County County","MA","Duxbury",1990,320,6829,7149
"2776","Duxbury","Plymouth County County","MA","Duxbury",1991,409,6643,7052
"2777","Duxbury","Plymouth County County","MA","Duxbury",1992,459,6624,7083
"2778","Duxbury","Plymouth County County","MA","Duxbury",1993,362,6786,7148
"2779","Duxbury","Plymouth County County","MA","Duxbury",1994,324,7014,7338
"2780","Duxbury","Plymouth County County","MA","Duxbury",1995,265,7227,7492
"2781","Duxbury","Plymouth County County","MA","Duxbury",1996,219,7422,7641
"2782","Duxbury","Plymouth County County","MA","Duxbury",1997,196,7670,7866
"2783","Duxbury","Plymouth County County","MA","Duxbury",1998,177,7859,8036
"2784","Duxbury","Plymouth County County","MA","Duxbury",1999,182,8013,8195
"2785","Duxbury","Plymouth County County","MA","Duxbury",2000,158,7050,7208
"2786","Duxbury","Plymouth County County","MA","Duxbury",2001,221,7074,7295
"2787","Duxbury","Plymouth County County","MA","Duxbury",2002,315,7019,7334
"2788","Duxbury","Plymouth County County","MA","Duxbury",2003,322,6964,7286
"2789","Duxbury","Plymouth County County","MA","Duxbury",2004,292,6983,7275
"2790","Duxbury","Plymouth County County","MA","Duxbury",2005,283,7042,7325
"2791","Duxbury","Plymouth County County","MA","Duxbury",2006,255,6724,6979
"2792","Duxbury","Plymouth County County","MA","Duxbury",2007,255,6773,7028
"2793","Duxbury","Plymouth County County","MA","Duxbury",2008,313,6775,7088
"2794","Duxbury","Plymouth County County","MA","Duxbury",2009,491,6584,7075
"2795","Duxbury","Plymouth County County","MA","Duxbury",2010,502,7007,7509
"2796","Duxbury","Plymouth County County","MA","Duxbury",2011,404,7075,7479
"2797","Duxbury","Plymouth County County","MA","Duxbury",2012,395,7152,7547
"2798","East Bridgewater","Plymouth County County","MA","East Bridgewater",1990,401,5748,6149
"2799","East Bridgewater","Plymouth County County","MA","East Bridgewater",1991,759,5616,6375
"2800","East Bridgewater","Plymouth County County","MA","East Bridgewater",1992,689,5673,6362
"2801","East Bridgewater","Plymouth County County","MA","East Bridgewater",1993,475,5927,6402
"2802","East Bridgewater","Plymouth County County","MA","East Bridgewater",1994,426,6283,6709
"2803","East Bridgewater","Plymouth County County","MA","East Bridgewater",1995,380,6306,6686
"2804","East Bridgewater","Plymouth County County","MA","East Bridgewater",1996,319,6403,6722
"2805","East Bridgewater","Plymouth County County","MA","East Bridgewater",1997,314,6664,6978
"2806","East Bridgewater","Plymouth County County","MA","East Bridgewater",1998,216,6811,7027
"2807","East Bridgewater","Plymouth County County","MA","East Bridgewater",1999,201,6991,7192
"2808","East Bridgewater","Plymouth County County","MA","East Bridgewater",2000,179,6977,7156
"2809","East Bridgewater","Plymouth County County","MA","East Bridgewater",2001,228,7030,7258
"2810","East Bridgewater","Plymouth County County","MA","East Bridgewater",2002,339,7022,7361
"2811","East Bridgewater","Plymouth County County","MA","East Bridgewater",2003,389,6938,7327
"2812","East Bridgewater","Plymouth County County","MA","East Bridgewater",2004,352,6934,7286
"2813","East Bridgewater","Plymouth County County","MA","East Bridgewater",2005,344,7041,7385
"2814","East Bridgewater","Plymouth County County","MA","East Bridgewater",2006,360,7172,7532
"2815","East Bridgewater","Plymouth County County","MA","East Bridgewater",2007,338,7241,7579
"2816","East Bridgewater","Plymouth County County","MA","East Bridgewater",2008,431,7251,7682
"2817","East Bridgewater","Plymouth County County","MA","East Bridgewater",2009,666,7057,7723
"2818","East Bridgewater","Plymouth County County","MA","East Bridgewater",2010,664,6898,7562
"2819","East Bridgewater","Plymouth County County","MA","East Bridgewater",2011,612,6960,7572
"2820","East Bridgewater","Plymouth County County","MA","East Bridgewater",2012,543,7022,7565
"2821","East Brookfield","Worcester County County","MA","East Brookfield",1990,72,984,1056
"2822","East Brookfield","Worcester County County","MA","East Brookfield",1991,151,975,1126
"2823","East Brookfield","Worcester County County","MA","East Brookfield",1992,112,934,1046
"2824","East Brookfield","Worcester County County","MA","East Brookfield",1993,86,971,1057
"2825","East Brookfield","Worcester County County","MA","East Brookfield",1994,51,978,1029
"2826","East Brookfield","Worcester County County","MA","East Brookfield",1995,59,968,1027
"2827","East Brookfield","Worcester County County","MA","East Brookfield",1996,64,978,1042
"2828","East Brookfield","Worcester County County","MA","East Brookfield",1997,48,1001,1049
"2829","East Brookfield","Worcester County County","MA","East Brookfield",1998,39,1018,1057
"2830","East Brookfield","Worcester County County","MA","East Brookfield",1999,40,1015,1055
"2831","East Brookfield","Worcester County County","MA","East Brookfield",2000,35,1168,1203
"2832","East Brookfield","Worcester County County","MA","East Brookfield",2001,37,1164,1201
"2833","East Brookfield","Worcester County County","MA","East Brookfield",2002,52,1154,1206
"2834","East Brookfield","Worcester County County","MA","East Brookfield",2003,63,1145,1208
"2835","East Brookfield","Worcester County County","MA","East Brookfield",2004,67,1139,1206
"2836","East Brookfield","Worcester County County","MA","East Brookfield",2005,48,1130,1178
"2837","East Brookfield","Worcester County County","MA","East Brookfield",2006,51,1129,1180
"2838","East Brookfield","Worcester County County","MA","East Brookfield",2007,51,1125,1176
"2839","East Brookfield","Worcester County County","MA","East Brookfield",2008,59,1097,1156
"2840","East Brookfield","Worcester County County","MA","East Brookfield",2009,107,1066,1173
"2841","East Brookfield","Worcester County County","MA","East Brookfield",2010,98,1119,1217
"2842","East Brookfield","Worcester County County","MA","East Brookfield",2011,95,1128,1223
"2843","East Brookfield","Worcester County County","MA","East Brookfield",2012,80,1128,1208
"2844","East Longmeadow","Hampden County County","MA","East Longmeadow",1990,299,6585,6884
"2845","East Longmeadow","Hampden County County","MA","East Longmeadow",1991,460,6440,6900
"2846","East Longmeadow","Hampden County County","MA","East Longmeadow",1992,530,6493,7023
"2847","East Longmeadow","Hampden County County","MA","East Longmeadow",1993,461,6585,7046
"2848","East Longmeadow","Hampden County County","MA","East Longmeadow",1994,378,6737,7115
"2849","East Longmeadow","Hampden County County","MA","East Longmeadow",1995,315,6601,6916
"2850","East Longmeadow","Hampden County County","MA","East Longmeadow",1996,251,6742,6993
"2851","East Longmeadow","Hampden County County","MA","East Longmeadow",1997,258,6938,7196
"2852","East Longmeadow","Hampden County County","MA","East Longmeadow",1998,208,6970,7178
"2853","East Longmeadow","Hampden County County","MA","East Longmeadow",1999,201,7004,7205
"2854","East Longmeadow","Hampden County County","MA","East Longmeadow",2000,188,7166,7354
"2855","East Longmeadow","Hampden County County","MA","East Longmeadow",2001,216,7247,7463
"2856","East Longmeadow","Hampden County County","MA","East Longmeadow",2002,294,7301,7595
"2857","East Longmeadow","Hampden County County","MA","East Longmeadow",2003,359,7304,7663
"2858","East Longmeadow","Hampden County County","MA","East Longmeadow",2004,334,7358,7692
"2859","East Longmeadow","Hampden County County","MA","East Longmeadow",2005,325,7424,7749
"2860","East Longmeadow","Hampden County County","MA","East Longmeadow",2006,297,7500,7797
"2861","East Longmeadow","Hampden County County","MA","East Longmeadow",2007,318,7664,7982
"2862","East Longmeadow","Hampden County County","MA","East Longmeadow",2008,367,7652,8019
"2863","East Longmeadow","Hampden County County","MA","East Longmeadow",2009,523,7577,8100
"2864","East Longmeadow","Hampden County County","MA","East Longmeadow",2010,572,7506,8078
"2865","East Longmeadow","Hampden County County","MA","East Longmeadow",2011,489,7432,7921
"2866","East Longmeadow","Hampden County County","MA","East Longmeadow",2012,472,7437,7909
"2867","Eastham","Barnstable County County","MA","Eastham",1990,137,2191,2328
"2868","Eastham","Barnstable County County","MA","Eastham",1991,213,2119,2332
"2869","Eastham","Barnstable County County","MA","Eastham",1992,224,2094,2318
"2870","Eastham","Barnstable County County","MA","Eastham",1993,206,2141,2347
"2871","Eastham","Barnstable County County","MA","Eastham",1994,187,2187,2374
"2872","Eastham","Barnstable County County","MA","Eastham",1995,168,2306,2474
"2873","Eastham","Barnstable County County","MA","Eastham",1996,142,2362,2504
"2874","Eastham","Barnstable County County","MA","Eastham",1997,150,2399,2549
"2875","Eastham","Barnstable County County","MA","Eastham",1998,131,2458,2589
"2876","Eastham","Barnstable County County","MA","Eastham",1999,113,2571,2684
"2877","Eastham","Barnstable County County","MA","Eastham",2000,106,2510,2616
"2878","Eastham","Barnstable County County","MA","Eastham",2001,114,2550,2664
"2879","Eastham","Barnstable County County","MA","Eastham",2002,144,2596,2740
"2880","Eastham","Barnstable County County","MA","Eastham",2003,157,2648,2805
"2881","Eastham","Barnstable County County","MA","Eastham",2004,154,2670,2824
"2882","Eastham","Barnstable County County","MA","Eastham",2005,153,2652,2805
"2883","Eastham","Barnstable County County","MA","Eastham",2006,148,2658,2806
"2884","Eastham","Barnstable County County","MA","Eastham",2007,136,2643,2779
"2885","Eastham","Barnstable County County","MA","Eastham",2008,175,2636,2811
"2886","Eastham","Barnstable County County","MA","Eastham",2009,253,2574,2827
"2887","Eastham","Barnstable County County","MA","Eastham",2010,280,2368,2648
"2888","Eastham","Barnstable County County","MA","Eastham",2011,234,2365,2599
"2889","Eastham","Barnstable County County","MA","Eastham",2012,235,2404,2639
"2890","Easthampton","Hampshire County County","MA","Easthampton",1990,498,8136,8634
"2891","Easthampton","Hampshire County County","MA","Easthampton",1991,764,7822,8586
"2892","Easthampton","Hampshire County County","MA","Easthampton",1992,748,7795,8543
"2893","Easthampton","Hampshire County County","MA","Easthampton",1993,564,7814,8378
"2894","Easthampton","Hampshire County County","MA","Easthampton",1994,516,7857,8373
"2895","Easthampton","Hampshire County County","MA","Easthampton",1995,500,7990,8490
"2896","Easthampton","Hampshire County County","MA","Easthampton",1996,347,8127,8474
"2897","Easthampton","Hampshire County County","MA","Easthampton",1997,330,8294,8624
"2898","Easthampton","Hampshire County County","MA","Easthampton",1998,317,8248,8565
"2899","Easthampton","Hampshire County County","MA","Easthampton",1999,265,8303,8568
"2900","Easthampton","Hampshire County County","MA","Easthampton",2000,216,9220,9436
"2901","Easthampton","Hampshire County County","MA","Easthampton",2001,272,9216,9488
"2902","Easthampton","Hampshire County County","MA","Easthampton",2002,365,9191,9556
"2903","Easthampton","Hampshire County County","MA","Easthampton",2003,417,9139,9556
"2904","Easthampton","Hampshire County County","MA","Easthampton",2004,393,9077,9470
"2905","Easthampton","Hampshire County County","MA","Easthampton",2005,384,9077,9461
"2906","Easthampton","Hampshire County County","MA","Easthampton",2006,375,9182,9557
"2907","Easthampton","Hampshire County County","MA","Easthampton",2007,371,9198,9569
"2908","Easthampton","Hampshire County County","MA","Easthampton",2008,460,9191,9651
"2909","Easthampton","Hampshire County County","MA","Easthampton",2009,729,8807,9536
"2910","Easthampton","Hampshire County County","MA","Easthampton",2010,737,8716,9453
"2911","Easthampton","Hampshire County County","MA","Easthampton",2011,625,8608,9233
"2912","Easthampton","Hampshire County County","MA","Easthampton",2012,563,8613,9176
"2913","Easton","Bristol County County","MA","Easton",1990,672,10667,11339
"2914","Easton","Bristol County County","MA","Easton",1991,992,10263,11255
"2915","Easton","Bristol County County","MA","Easton",1992,1012,10173,11185
"2916","Easton","Bristol County County","MA","Easton",1993,776,10712,11488
"2917","Easton","Bristol County County","MA","Easton",1994,720,11362,12082
"2918","Easton","Bristol County County","MA","Easton",1995,557,11462,12019
"2919","Easton","Bristol County County","MA","Easton",1996,531,11574,12105
"2920","Easton","Bristol County County","MA","Easton",1997,468,11939,12407
"2921","Easton","Bristol County County","MA","Easton",1998,367,12094,12461
"2922","Easton","Bristol County County","MA","Easton",1999,383,12283,12666
"2923","Easton","Bristol County County","MA","Easton",2000,300,12782,13082
"2924","Easton","Bristol County County","MA","Easton",2001,404,12698,13102
"2925","Easton","Bristol County County","MA","Easton",2002,563,12637,13200
"2926","Easton","Bristol County County","MA","Easton",2003,630,12458,13088
"2927","Easton","Bristol County County","MA","Easton",2004,586,12477,13063
"2928","Easton","Bristol County County","MA","Easton",2005,535,12501,13036
"2929","Easton","Bristol County County","MA","Easton",2006,535,12665,13200
"2930","Easton","Bristol County County","MA","Easton",2007,495,12805,13300
"2931","Easton","Bristol County County","MA","Easton",2008,631,12848,13479
"2932","Easton","Bristol County County","MA","Easton",2009,953,12297,13250
"2933","Easton","Bristol County County","MA","Easton",2010,978,12350,13328
"2934","Easton","Bristol County County","MA","Easton",2011,817,12412,13229
"2935","Easton","Bristol County County","MA","Easton",2012,787,12521,13308
"2936","Edgartown","Dukes County County","MA","Edgartown",1990,142,2007,2149
"2937","Edgartown","Dukes County County","MA","Edgartown",1991,224,2042,2266
"2938","Edgartown","Dukes County County","MA","Edgartown",1992,212,1936,2148
"2939","Edgartown","Dukes County County","MA","Edgartown",1993,192,2051,2243
"2940","Edgartown","Dukes County County","MA","Edgartown",1994,203,2209,2412
"2941","Edgartown","Dukes County County","MA","Edgartown",1995,187,2330,2517
"2942","Edgartown","Dukes County County","MA","Edgartown",1996,173,2432,2605
"2943","Edgartown","Dukes County County","MA","Edgartown",1997,164,2498,2662
"2944","Edgartown","Dukes County County","MA","Edgartown",1998,130,2594,2724
"2945","Edgartown","Dukes County County","MA","Edgartown",1999,126,2636,2762
"2946","Edgartown","Dukes County County","MA","Edgartown",2000,81,2484,2565
"2947","Edgartown","Dukes County County","MA","Edgartown",2001,96,2491,2587
"2948","Edgartown","Dukes County County","MA","Edgartown",2002,126,2584,2710
"2949","Edgartown","Dukes County County","MA","Edgartown",2003,135,2687,2822
"2950","Edgartown","Dukes County County","MA","Edgartown",2004,123,2705,2828
"2951","Edgartown","Dukes County County","MA","Edgartown",2005,126,2678,2804
"2952","Edgartown","Dukes County County","MA","Edgartown",2006,128,2704,2832
"2953","Edgartown","Dukes County County","MA","Edgartown",2007,115,2740,2855
"2954","Edgartown","Dukes County County","MA","Edgartown",2008,136,2741,2877
"2955","Edgartown","Dukes County County","MA","Edgartown",2009,215,2717,2932
"2956","Edgartown","Dukes County County","MA","Edgartown",2010,247,2644,2891
"2957","Edgartown","Dukes County County","MA","Edgartown",2011,248,2665,2913
"2958","Edgartown","Dukes County County","MA","Edgartown",2012,228,2692,2920
"2959","Egremont","Berkshire County County","MA","Egremont",1990,19,661,680
"2960","Egremont","Berkshire County County","MA","Egremont",1991,35,650,685
"2961","Egremont","Berkshire County County","MA","Egremont",1992,35,675,710
"2962","Egremont","Berkshire County County","MA","Egremont",1993,21,660,681
"2963","Egremont","Berkshire County County","MA","Egremont",1994,18,672,690
"2964","Egremont","Berkshire County County","MA","Egremont",1995,15,718,733
"2965","Egremont","Berkshire County County","MA","Egremont",1996,20,737,757
"2966","Egremont","Berkshire County County","MA","Egremont",1997,16,754,770
"2967","Egremont","Berkshire County County","MA","Egremont",1998,15,724,739
"2968","Egremont","Berkshire County County","MA","Egremont",1999,14,723,737
"2969","Egremont","Berkshire County County","MA","Egremont",2000,12,771,783
"2970","Egremont","Berkshire County County","MA","Egremont",2001,16,797,813
"2971","Egremont","Berkshire County County","MA","Egremont",2002,23,821,844
"2972","Egremont","Berkshire County County","MA","Egremont",2003,25,823,848
"2973","Egremont","Berkshire County County","MA","Egremont",2004,28,821,849
"2974","Egremont","Berkshire County County","MA","Egremont",2005,29,843,872
"2975","Egremont","Berkshire County County","MA","Egremont",2006,25,852,877
"2976","Egremont","Berkshire County County","MA","Egremont",2007,25,835,860
"2977","Egremont","Berkshire County County","MA","Egremont",2008,30,836,866
"2978","Egremont","Berkshire County County","MA","Egremont",2009,41,809,850
"2979","Egremont","Berkshire County County","MA","Egremont",2010,44,744,788
"2980","Egremont","Berkshire County County","MA","Egremont",2011,35,748,783
"2981","Egremont","Berkshire County County","MA","Egremont",2012,28,742,770
"2982","Erving","Franklin County County","MA","Erving",1990,28,700,728
"2983","Erving","Franklin County County","MA","Erving",1991,55,674,729
"2984","Erving","Franklin County County","MA","Erving",1992,55,647,702
"2985","Erving","Franklin County County","MA","Erving",1993,40,659,699
"2986","Erving","Franklin County County","MA","Erving",1994,25,674,699
"2987","Erving","Franklin County County","MA","Erving",1995,26,707,733
"2988","Erving","Franklin County County","MA","Erving",1996,22,713,735
"2989","Erving","Franklin County County","MA","Erving",1997,23,730,753
"2990","Erving","Franklin County County","MA","Erving",1998,23,743,766
"2991","Erving","Franklin County County","MA","Erving",1999,23,751,774
"2992","Erving","Franklin County County","MA","Erving",2000,20,777,797
"2993","Erving","Franklin County County","MA","Erving",2001,28,779,807
"2994","Erving","Franklin County County","MA","Erving",2002,46,791,837
"2995","Erving","Franklin County County","MA","Erving",2003,38,804,842
"2996","Erving","Franklin County County","MA","Erving",2004,32,800,832
"2997","Erving","Franklin County County","MA","Erving",2005,43,805,848
"2998","Erving","Franklin County County","MA","Erving",2006,37,818,855
"2999","Erving","Franklin County County","MA","Erving",2007,39,802,841
"3000","Erving","Franklin County County","MA","Erving",2008,46,796,842
"3001","Erving","Franklin County County","MA","Erving",2009,78,772,850
"3002","Erving","Franklin County County","MA","Erving",2010,76,914,990
"3003","Erving","Franklin County County","MA","Erving",2011,69,915,984
"3004","Erving","Franklin County County","MA","Erving",2012,56,918,974
"3005","Essex","Essex County County","MA","Essex",1990,101,1761,1862
"3006","Essex","Essex County County","MA","Essex",1991,136,1702,1838
"3007","Essex","Essex County County","MA","Essex",1992,146,1733,1879
"3008","Essex","Essex County County","MA","Essex",1993,113,1809,1922
"3009","Essex","Essex County County","MA","Essex",1994,89,1879,1968
"3010","Essex","Essex County County","MA","Essex",1995,96,1785,1881
"3011","Essex","Essex County County","MA","Essex",1996,66,1827,1893
"3012","Essex","Essex County County","MA","Essex",1997,63,1873,1936
"3013","Essex","Essex County County","MA","Essex",1998,60,1914,1974
"3014","Essex","Essex County County","MA","Essex",1999,56,1934,1990
"3015","Essex","Essex County County","MA","Essex",2000,46,1777,1823
"3016","Essex","Essex County County","MA","Essex",2001,61,1794,1855
"3017","Essex","Essex County County","MA","Essex",2002,86,1768,1854
"3018","Essex","Essex County County","MA","Essex",2003,96,1750,1846
"3019","Essex","Essex County County","MA","Essex",2004,91,1750,1841
"3020","Essex","Essex County County","MA","Essex",2005,78,1764,1842
"3021","Essex","Essex County County","MA","Essex",2006,74,1708,1782
"3022","Essex","Essex County County","MA","Essex",2007,74,1725,1799
"3023","Essex","Essex County County","MA","Essex",2008,93,1732,1825
"3024","Essex","Essex County County","MA","Essex",2009,133,1680,1813
"3025","Essex","Essex County County","MA","Essex",2010,147,1789,1936
"3026","Essex","Essex County County","MA","Essex",2011,131,1812,1943
"3027","Essex","Essex County County","MA","Essex",2012,115,1832,1947
"3028",NA,"Essex County County","MA","Essex County County",1990,23368,326511,349879
"3029",NA,"Essex County County","MA","Essex County County",1991,31376,317592,348968
"3030",NA,"Essex County County","MA","Essex County County",1992,32281,317089,349370
"3031",NA,"Essex County County","MA","Essex County County",1993,26357,321811,348168
"3032",NA,"Essex County County","MA","Essex County County",1994,22915,327915,350830
"3033",NA,"Essex County County","MA","Essex County County",1995,19475,333162,352637
"3034",NA,"Essex County County","MA","Essex County County",1996,16741,341478,358219
"3035",NA,"Essex County County","MA","Essex County County",1997,15774,349896,365670
"3036",NA,"Essex County County","MA","Essex County County",1998,13968,358353,372321
"3037",NA,"Essex County County","MA","Essex County County",1999,13495,364053,377548
"3038",NA,"Essex County County","MA","Essex County County",2000,10407,362525,372932
"3039",NA,"Essex County County","MA","Essex County County",2001,15305,363684,378989
"3040",NA,"Essex County County","MA","Essex County County",2002,22565,358960,381525
"3041",NA,"Essex County County","MA","Essex County County",2003,24247,354844,379091
"3042",NA,"Essex County County","MA","Essex County County",2004,21693,353660,375353
"3043",NA,"Essex County County","MA","Essex County County",2005,19700,355977,375677
"3044",NA,"Essex County County","MA","Essex County County",2006,19133,355217,374350
"3045",NA,"Essex County County","MA","Essex County County",2007,17838,356503,374341
"3046",NA,"Essex County County","MA","Essex County County",2008,21418,356798,378216
"3047",NA,"Essex County County","MA","Essex County County",2009,33230,347911,381141
"3048",NA,"Essex County County","MA","Essex County County",2010,33384,349156,382540
"3049",NA,"Essex County County","MA","Essex County County",2011,29642,353716,383358
"3050",NA,"Essex County County","MA","Essex County County",2012,27467,357483,384950
"3051","Everett","Middlesex County County","MA","Everett",1990,1339,17695,19034
"3052","Everett","Middlesex County County","MA","Everett",1991,1811,16899,18710
"3053","Everett","Middlesex County County","MA","Everett",1992,1850,16596,18446
"3054","Everett","Middlesex County County","MA","Everett",1993,1424,16480,17904
"3055","Everett","Middlesex County County","MA","Everett",1994,1264,16611,17875
"3056","Everett","Middlesex County County","MA","Everett",1995,1211,17220,18431
"3057","Everett","Middlesex County County","MA","Everett",1996,910,17481,18391
"3058","Everett","Middlesex County County","MA","Everett",1997,839,17882,18721
"3059","Everett","Middlesex County County","MA","Everett",1998,708,18051,18759
"3060","Everett","Middlesex County County","MA","Everett",1999,761,18110,18871
"3061","Everett","Middlesex County County","MA","Everett",2000,593,18813,19406
"3062","Everett","Middlesex County County","MA","Everett",2001,755,18674,19429
"3063","Everett","Middlesex County County","MA","Everett",2002,1140,18220,19360
"3064","Everett","Middlesex County County","MA","Everett",2003,1361,17861,19222
"3065","Everett","Middlesex County County","MA","Everett",2004,1079,17721,18800
"3066","Everett","Middlesex County County","MA","Everett",2005,1006,17736,18742
"3067","Everett","Middlesex County County","MA","Everett",2006,1000,17702,18702
"3068","Everett","Middlesex County County","MA","Everett",2007,940,17922,18862
"3069","Everett","Middlesex County County","MA","Everett",2008,1102,17973,19075
"3070","Everett","Middlesex County County","MA","Everett",2009,1639,17597,19236
"3071","Everett","Middlesex County County","MA","Everett",2010,1756,19432,21188
"3072","Everett","Middlesex County County","MA","Everett",2011,1651,19718,21369
"3073","Everett","Middlesex County County","MA","Everett",2012,1475,19934,21409
"3074","Fairhaven","Bristol County County","MA","Fairhaven",1990,662,7465,8127
"3075","Fairhaven","Bristol County County","MA","Fairhaven",1991,1012,7251,8263
"3076","Fairhaven","Bristol County County","MA","Fairhaven",1992,967,7236,8203
"3077","Fairhaven","Bristol County County","MA","Fairhaven",1993,823,7412,8235
"3078","Fairhaven","Bristol County County","MA","Fairhaven",1994,768,7568,8336
"3079","Fairhaven","Bristol County County","MA","Fairhaven",1995,689,7286,7975
"3080","Fairhaven","Bristol County County","MA","Fairhaven",1996,614,7212,7826
"3081","Fairhaven","Bristol County County","MA","Fairhaven",1997,516,7364,7880
"3082","Fairhaven","Bristol County County","MA","Fairhaven",1998,441,7393,7834
"3083","Fairhaven","Bristol County County","MA","Fairhaven",1999,411,7436,7847
"3084","Fairhaven","Bristol County County","MA","Fairhaven",2000,304,8149,8453
"3085","Fairhaven","Bristol County County","MA","Fairhaven",2001,354,8085,8439
"3086","Fairhaven","Bristol County County","MA","Fairhaven",2002,500,8130,8630
"3087","Fairhaven","Bristol County County","MA","Fairhaven",2003,540,7941,8481
"3088","Fairhaven","Bristol County County","MA","Fairhaven",2004,486,7961,8447
"3089","Fairhaven","Bristol County County","MA","Fairhaven",2005,488,8036,8524
"3090","Fairhaven","Bristol County County","MA","Fairhaven",2006,492,8197,8689
"3091","Fairhaven","Bristol County County","MA","Fairhaven",2007,485,8149,8634
"3092","Fairhaven","Bristol County County","MA","Fairhaven",2008,605,7929,8534
"3093","Fairhaven","Bristol County County","MA","Fairhaven",2009,866,7703,8569
"3094","Fairhaven","Bristol County County","MA","Fairhaven",2010,908,7489,8397
"3095","Fairhaven","Bristol County County","MA","Fairhaven",2011,785,7567,8352
"3096","Fairhaven","Bristol County County","MA","Fairhaven",2012,760,7656,8416
"3097","Fall River","Bristol County County","MA","Fall River",1990,5898,40138,46036
"3098","Fall River","Bristol County County","MA","Fall River",1991,7872,38242,46114
"3099","Fall River","Bristol County County","MA","Fall River",1992,7034,38221,45255
"3100","Fall River","Bristol County County","MA","Fall River",1993,6781,38500,45281
"3101","Fall River","Bristol County County","MA","Fall River",1994,5093,38592,43685
"3102","Fall River","Bristol County County","MA","Fall River",1995,4819,39720,44539
"3103","Fall River","Bristol County County","MA","Fall River",1996,4512,39754,44266
"3104","Fall River","Bristol County County","MA","Fall River",1997,3834,40391,44225
"3105","Fall River","Bristol County County","MA","Fall River",1998,2850,40738,43588
"3106","Fall River","Bristol County County","MA","Fall River",1999,2744,40917,43661
"3107","Fall River","Bristol County County","MA","Fall River",2000,2224,41047,43271
"3108","Fall River","Bristol County County","MA","Fall River",2001,2699,40668,43367
"3109","Fall River","Bristol County County","MA","Fall River",2002,3474,40888,44362
"3110","Fall River","Bristol County County","MA","Fall River",2003,3707,41038,44745
"3111","Fall River","Bristol County County","MA","Fall River",2004,3680,40952,44632
"3112","Fall River","Bristol County County","MA","Fall River",2005,3604,40902,44506
"3113","Fall River","Bristol County County","MA","Fall River",2006,3698,41183,44881
"3114","Fall River","Bristol County County","MA","Fall River",2007,3744,41030,44774
"3115","Fall River","Bristol County County","MA","Fall River",2008,4248,40428,44676
"3116","Fall River","Bristol County County","MA","Fall River",2009,6368,38526,44894
"3117","Fall River","Bristol County County","MA","Fall River",2010,6369,37546,43915
"3118","Fall River","Bristol County County","MA","Fall River",2011,6149,37821,43970
"3119","Fall River","Bristol County County","MA","Fall River",2012,5641,37881,43522
"3120","Falmouth","Barnstable County County","MA","Falmouth",1990,885,13673,14558
"3121","Falmouth","Barnstable County County","MA","Falmouth",1991,1256,13343,14599
"3122","Falmouth","Barnstable County County","MA","Falmouth",1992,1322,13235,14557
"3123","Falmouth","Barnstable County County","MA","Falmouth",1993,1162,14037,15199
"3124","Falmouth","Barnstable County County","MA","Falmouth",1994,1030,14346,15376
"3125","Falmouth","Barnstable County County","MA","Falmouth",1995,886,14699,15585
"3126","Falmouth","Barnstable County County","MA","Falmouth",1996,823,15037,15860
"3127","Falmouth","Barnstable County County","MA","Falmouth",1997,793,15549,16342
"3128","Falmouth","Barnstable County County","MA","Falmouth",1998,689,15847,16536
"3129","Falmouth","Barnstable County County","MA","Falmouth",1999,575,16053,16628
"3130","Falmouth","Barnstable County County","MA","Falmouth",2000,484,16212,16696
"3131","Falmouth","Barnstable County County","MA","Falmouth",2001,571,16413,16984
"3132","Falmouth","Barnstable County County","MA","Falmouth",2002,728,16742,17470
"3133","Falmouth","Barnstable County County","MA","Falmouth",2003,852,17111,17963
"3134","Falmouth","Barnstable County County","MA","Falmouth",2004,829,17337,18166
"3135","Falmouth","Barnstable County County","MA","Falmouth",2005,780,17356,18136
"3136","Falmouth","Barnstable County County","MA","Falmouth",2006,799,17495,18294
"3137","Falmouth","Barnstable County County","MA","Falmouth",2007,774,17417,18191
"3138","Falmouth","Barnstable County County","MA","Falmouth",2008,941,17330,18271
"3139","Falmouth","Barnstable County County","MA","Falmouth",2009,1321,16694,18015
"3140","Falmouth","Barnstable County County","MA","Falmouth",2010,1432,16266,17698
"3141","Falmouth","Barnstable County County","MA","Falmouth",2011,1302,16239,17541
"3142","Falmouth","Barnstable County County","MA","Falmouth",2012,1175,16512,17687
"3143","Fitchburg","Worcester County County","MA","Fitchburg",1990,1818,17663,19481
"3144","Fitchburg","Worcester County County","MA","Fitchburg",1991,2236,16585,18821
"3145","Fitchburg","Worcester County County","MA","Fitchburg",1992,1967,16186,18153
"3146","Fitchburg","Worcester County County","MA","Fitchburg",1993,1428,16011,17439
"3147","Fitchburg","Worcester County County","MA","Fitchburg",1994,1237,15864,17101
"3148","Fitchburg","Worcester County County","MA","Fitchburg",1995,1145,17211,18356
"3149","Fitchburg","Worcester County County","MA","Fitchburg",1996,1110,17102,18212
"3150","Fitchburg","Worcester County County","MA","Fitchburg",1997,1048,17431,18479
"3151","Fitchburg","Worcester County County","MA","Fitchburg",1998,851,17471,18322
"3152","Fitchburg","Worcester County County","MA","Fitchburg",1999,837,17387,18224
"3153","Fitchburg","Worcester County County","MA","Fitchburg",2000,658,17890,18548
"3154","Fitchburg","Worcester County County","MA","Fitchburg",2001,895,17633,18528
"3155","Fitchburg","Worcester County County","MA","Fitchburg",2002,1321,17543,18864
"3156","Fitchburg","Worcester County County","MA","Fitchburg",2003,1484,17408,18892
"3157","Fitchburg","Worcester County County","MA","Fitchburg",2004,1317,17281,18598
"3158","Fitchburg","Worcester County County","MA","Fitchburg",2005,1294,17149,18443
"3159","Fitchburg","Worcester County County","MA","Fitchburg",2006,1258,17299,18557
"3160","Fitchburg","Worcester County County","MA","Fitchburg",2007,1175,17279,18454
"3161","Fitchburg","Worcester County County","MA","Fitchburg",2008,1361,17220,18581
"3162","Fitchburg","Worcester County County","MA","Fitchburg",2009,2131,17031,19162
"3163","Fitchburg","Worcester County County","MA","Fitchburg",2010,2200,16637,18837
"3164","Fitchburg","Worcester County County","MA","Fitchburg",2011,2058,16626,18684
"3165","Fitchburg","Worcester County County","MA","Fitchburg",2012,1851,16614,18465
"3166","Florida","Berkshire County County","MA","Florida",1990,42,348,390
"3167","Florida","Berkshire County County","MA","Florida",1991,24,346,370
"3168","Florida","Berkshire County County","MA","Florida",1992,50,350,400
"3169","Florida","Berkshire County County","MA","Florida",1993,35,386,421
"3170","Florida","Berkshire County County","MA","Florida",1994,22,374,396
"3171","Florida","Berkshire County County","MA","Florida",1995,18,345,363
"3172","Florida","Berkshire County County","MA","Florida",1996,20,351,371
"3173","Florida","Berkshire County County","MA","Florida",1997,29,357,386
"3174","Florida","Berkshire County County","MA","Florida",1998,19,349,368
"3175","Florida","Berkshire County County","MA","Florida",1999,17,351,368
"3176","Florida","Berkshire County County","MA","Florida",2000,14,367,381
"3177","Florida","Berkshire County County","MA","Florida",2001,21,369,390
"3178","Florida","Berkshire County County","MA","Florida",2002,26,367,393
"3179","Florida","Berkshire County County","MA","Florida",2003,37,363,400
"3180","Florida","Berkshire County County","MA","Florida",2004,31,360,391
"3181","Florida","Berkshire County County","MA","Florida",2005,27,366,393
"3182","Florida","Berkshire County County","MA","Florida",2006,27,377,404
"3183","Florida","Berkshire County County","MA","Florida",2007,30,383,413
"3184","Florida","Berkshire County County","MA","Florida",2008,22,381,403
"3185","Florida","Berkshire County County","MA","Florida",2009,41,373,414
"3186","Florida","Berkshire County County","MA","Florida",2010,41,410,451
"3187","Florida","Berkshire County County","MA","Florida",2011,36,409,445
"3188","Florida","Berkshire County County","MA","Florida",2012,31,404,435
"3189","Foxborough","Norfolk County County","MA","Foxborough",1990,443,7965,8408
"3190","Foxborough","Norfolk County County","MA","Foxborough",1991,655,7717,8372
"3191","Foxborough","Norfolk County County","MA","Foxborough",1992,697,7748,8445
"3192","Foxborough","Norfolk County County","MA","Foxborough",1993,534,7877,8411
"3193","Foxborough","Norfolk County County","MA","Foxborough",1994,444,8275,8719
"3194","Foxborough","Norfolk County County","MA","Foxborough",1995,403,8462,8865
"3195","Foxborough","Norfolk County County","MA","Foxborough",1996,317,8755,9072
"3196","Foxborough","Norfolk County County","MA","Foxborough",1997,316,9077,9393
"3197","Foxborough","Norfolk County County","MA","Foxborough",1998,229,9255,9484
"3198","Foxborough","Norfolk County County","MA","Foxborough",1999,250,9375,9625
"3199","Foxborough","Norfolk County County","MA","Foxborough",2000,202,8959,9161
"3200","Foxborough","Norfolk County County","MA","Foxborough",2001,285,8965,9250
"3201","Foxborough","Norfolk County County","MA","Foxborough",2002,441,8810,9251
"3202","Foxborough","Norfolk County County","MA","Foxborough",2003,472,8682,9154
"3203","Foxborough","Norfolk County County","MA","Foxborough",2004,423,8677,9100
"3204","Foxborough","Norfolk County County","MA","Foxborough",2005,388,8744,9132
"3205","Foxborough","Norfolk County County","MA","Foxborough",2006,357,8599,8956
"3206","Foxborough","Norfolk County County","MA","Foxborough",2007,361,8714,9075
"3207","Foxborough","Norfolk County County","MA","Foxborough",2008,451,8737,9188
"3208","Foxborough","Norfolk County County","MA","Foxborough",2009,695,8754,9449
"3209","Foxborough","Norfolk County County","MA","Foxborough",2010,694,8755,9449
"3210","Foxborough","Norfolk County County","MA","Foxborough",2011,607,8854,9461
"3211","Foxborough","Norfolk County County","MA","Foxborough",2012,535,8951,9486
"3212","Framingham","Middlesex County County","MA","Framingham",1990,2015,36371,38386
"3213","Framingham","Middlesex County County","MA","Framingham",1991,2658,34988,37646
"3214","Framingham","Middlesex County County","MA","Framingham",1992,2772,34347,37119
"3215","Framingham","Middlesex County County","MA","Framingham",1993,2107,34528,36635
"3216","Framingham","Middlesex County County","MA","Framingham",1994,1832,34899,36731
"3217","Framingham","Middlesex County County","MA","Framingham",1995,1569,35810,37379
"3218","Framingham","Middlesex County County","MA","Framingham",1996,1313,36477,37790
"3219","Framingham","Middlesex County County","MA","Framingham",1997,1037,37339,38376
"3220","Framingham","Middlesex County County","MA","Framingham",1998,859,38051,38910
"3221","Framingham","Middlesex County County","MA","Framingham",1999,950,38317,39267
"3222","Framingham","Middlesex County County","MA","Framingham",2000,841,36987,37828
"3223","Framingham","Middlesex County County","MA","Framingham",2001,1137,36791,37928
"3224","Framingham","Middlesex County County","MA","Framingham",2002,1713,35759,37472
"3225","Framingham","Middlesex County County","MA","Framingham",2003,1787,34961,36748
"3226","Framingham","Middlesex County County","MA","Framingham",2004,1527,34925,36452
"3227","Framingham","Middlesex County County","MA","Framingham",2005,1331,35185,36516
"3228","Framingham","Middlesex County County","MA","Framingham",2006,1355,35225,36580
"3229","Framingham","Middlesex County County","MA","Framingham",2007,1237,35670,36907
"3230","Framingham","Middlesex County County","MA","Framingham",2008,1504,36050,37554
"3231","Framingham","Middlesex County County","MA","Framingham",2009,2352,35600,37952
"3232","Framingham","Middlesex County County","MA","Framingham",2010,2375,35828,38203
"3233","Framingham","Middlesex County County","MA","Framingham",2011,2041,36157,38198
"3234","Framingham","Middlesex County County","MA","Framingham",2012,1903,36488,38391
"3235","Franklin","Norfolk County County","MA","Franklin",1990,750,11764,12514
"3236","Franklin","Norfolk County County","MA","Franklin",1991,1019,11771,12790
"3237","Franklin","Norfolk County County","MA","Franklin",1992,971,12159,13130
"3238","Franklin","Norfolk County County","MA","Franklin",1993,811,12677,13488
"3239","Franklin","Norfolk County County","MA","Franklin",1994,653,13369,14022
"3240","Franklin","Norfolk County County","MA","Franklin",1995,654,13525,14179
"3241","Franklin","Norfolk County County","MA","Franklin",1996,514,14170,14684
"3242","Franklin","Norfolk County County","MA","Franklin",1997,458,14937,15395
"3243","Franklin","Norfolk County County","MA","Franklin",1998,373,15445,15818
"3244","Franklin","Norfolk County County","MA","Franklin",1999,383,16007,16390
"3245","Franklin","Norfolk County County","MA","Franklin",2000,335,15521,15856
"3246","Franklin","Norfolk County County","MA","Franklin",2001,496,15559,16055
"3247","Franklin","Norfolk County County","MA","Franklin",2002,744,15339,16083
"3248","Franklin","Norfolk County County","MA","Franklin",2003,814,15250,16064
"3249","Franklin","Norfolk County County","MA","Franklin",2004,696,15246,15942
"3250","Franklin","Norfolk County County","MA","Franklin",2005,635,15756,16391
"3251","Franklin","Norfolk County County","MA","Franklin",2006,629,15590,16219
"3252","Franklin","Norfolk County County","MA","Franklin",2007,636,15807,16443
"3253","Franklin","Norfolk County County","MA","Franklin",2008,759,15892,16651
"3254","Franklin","Norfolk County County","MA","Franklin",2009,1245,15606,16851
"3255","Franklin","Norfolk County County","MA","Franklin",2010,1238,15628,16866
"3256","Franklin","Norfolk County County","MA","Franklin",2011,1059,15802,16861
"3257","Franklin","Norfolk County County","MA","Franklin",2012,954,15975,16929
"3258",NA,"Franklin County County","MA","Franklin County County",1990,1929,35274,37203
"3259",NA,"Franklin County County","MA","Franklin County County",1991,2966,34752,37718
"3260",NA,"Franklin County County","MA","Franklin County County",1992,2984,33983,36967
"3261",NA,"Franklin County County","MA","Franklin County County",1993,2344,34192,36536
"3262",NA,"Franklin County County","MA","Franklin County County",1994,1987,35047,37034
"3263",NA,"Franklin County County","MA","Franklin County County",1995,1803,35621,37424
"3264",NA,"Franklin County County","MA","Franklin County County",1996,1490,35764,37254
"3265",NA,"Franklin County County","MA","Franklin County County",1997,1477,36499,37976
"3266",NA,"Franklin County County","MA","Franklin County County",1998,1277,37076,38353
"3267",NA,"Franklin County County","MA","Franklin County County",1999,1169,37644,38813
"3268",NA,"Franklin County County","MA","Franklin County County",2000,972,38052,39024
"3269",NA,"Franklin County County","MA","Franklin County County",2001,1205,38006,39211
"3270",NA,"Franklin County County","MA","Franklin County County",2002,1596,38304,39900
"3271",NA,"Franklin County County","MA","Franklin County County",2003,1828,38259,40087
"3272",NA,"Franklin County County","MA","Franklin County County",2004,1702,37888,39590
"3273",NA,"Franklin County County","MA","Franklin County County",2005,1696,37872,39568
"3274",NA,"Franklin County County","MA","Franklin County County",2006,1713,37987,39700
"3275",NA,"Franklin County County","MA","Franklin County County",2007,1634,37532,39166
"3276",NA,"Franklin County County","MA","Franklin County County",2008,1956,37106,39062
"3277",NA,"Franklin County County","MA","Franklin County County",2009,2973,35943,38916
"3278",NA,"Franklin County County","MA","Franklin County County",2010,3018,35916,38934
"3279",NA,"Franklin County County","MA","Franklin County County",2011,2582,35941,38523
"3280",NA,"Franklin County County","MA","Franklin County County",2012,2411,36055,38466
"3281","Freetown","Bristol County County","MA","Freetown",1990,332,4295,4627
"3282","Freetown","Bristol County County","MA","Freetown",1991,494,4110,4604
"3283","Freetown","Bristol County County","MA","Freetown",1992,510,4113,4623
"3284","Freetown","Bristol County County","MA","Freetown",1993,394,4225,4619
"3285","Freetown","Bristol County County","MA","Freetown",1994,368,4284,4652
"3286","Freetown","Bristol County County","MA","Freetown",1995,361,4316,4677
"3287","Freetown","Bristol County County","MA","Freetown",1996,310,4290,4600
"3288","Freetown","Bristol County County","MA","Freetown",1997,289,4404,4693
"3289","Freetown","Bristol County County","MA","Freetown",1998,249,4434,4683
"3290","Freetown","Bristol County County","MA","Freetown",1999,218,4499,4717
"3291","Freetown","Bristol County County","MA","Freetown",2000,154,5049,5203
"3292","Freetown","Bristol County County","MA","Freetown",2001,189,5052,5241
"3293","Freetown","Bristol County County","MA","Freetown",2002,250,5117,5367
"3294","Freetown","Bristol County County","MA","Freetown",2003,293,5068,5361
"3295","Freetown","Bristol County County","MA","Freetown",2004,283,5157,5440
"3296","Freetown","Bristol County County","MA","Freetown",2005,281,5246,5527
"3297","Freetown","Bristol County County","MA","Freetown",2006,264,5327,5591
"3298","Freetown","Bristol County County","MA","Freetown",2007,265,5325,5590
"3299","Freetown","Bristol County County","MA","Freetown",2008,330,5239,5569
"3300","Freetown","Bristol County County","MA","Freetown",2009,477,5118,5595
"3301","Freetown","Bristol County County","MA","Freetown",2010,491,4936,5427
"3302","Freetown","Bristol County County","MA","Freetown",2011,444,4987,5431
"3303","Freetown","Bristol County County","MA","Freetown",2012,398,5046,5444
"3304","Gardner","Worcester County County","MA","Gardner",1990,887,8664,9551
"3305","Gardner","Worcester County County","MA","Gardner",1991,1177,8497,9674
"3306","Gardner","Worcester County County","MA","Gardner",1992,957,8592,9549
"3307","Gardner","Worcester County County","MA","Gardner",1993,715,8810,9525
"3308","Gardner","Worcester County County","MA","Gardner",1994,705,8777,9482
"3309","Gardner","Worcester County County","MA","Gardner",1995,657,8699,9356
"3310","Gardner","Worcester County County","MA","Gardner",1996,563,8647,9210
"3311","Gardner","Worcester County County","MA","Gardner",1997,497,8803,9300
"3312","Gardner","Worcester County County","MA","Gardner",1998,387,8782,9169
"3313","Gardner","Worcester County County","MA","Gardner",1999,401,8764,9165
"3314","Gardner","Worcester County County","MA","Gardner",2000,330,9815,10145
"3315","Gardner","Worcester County County","MA","Gardner",2001,487,9672,10159
"3316","Gardner","Worcester County County","MA","Gardner",2002,651,9565,10216
"3317","Gardner","Worcester County County","MA","Gardner",2003,713,9468,10181
"3318","Gardner","Worcester County County","MA","Gardner",2004,673,9375,10048
"3319","Gardner","Worcester County County","MA","Gardner",2005,706,9246,9952
"3320","Gardner","Worcester County County","MA","Gardner",2006,614,9280,9894
"3321","Gardner","Worcester County County","MA","Gardner",2007,590,9233,9823
"3322","Gardner","Worcester County County","MA","Gardner",2008,758,9139,9897
"3323","Gardner","Worcester County County","MA","Gardner",2009,1094,8740,9834
"3324","Gardner","Worcester County County","MA","Gardner",2010,1092,8620,9712
"3325","Gardner","Worcester County County","MA","Gardner",2011,997,8614,9611
"3326","Gardner","Worcester County County","MA","Gardner",2012,888,8607,9495
"3327","Georgetown","Essex County County","MA","Georgetown",1990,184,3368,3552
"3328","Georgetown","Essex County County","MA","Georgetown",1991,267,3355,3622
"3329","Georgetown","Essex County County","MA","Georgetown",1992,283,3429,3712
"3330","Georgetown","Essex County County","MA","Georgetown",1993,192,3539,3731
"3331","Georgetown","Essex County County","MA","Georgetown",1994,203,3799,4002
"3332","Georgetown","Essex County County","MA","Georgetown",1995,167,3732,3899
"3333","Georgetown","Essex County County","MA","Georgetown",1996,129,3866,3995
"3334","Georgetown","Essex County County","MA","Georgetown",1997,130,3955,4085
"3335","Georgetown","Essex County County","MA","Georgetown",1998,113,4218,4331
"3336","Georgetown","Essex County County","MA","Georgetown",1999,107,4381,4488
"3337","Georgetown","Essex County County","MA","Georgetown",2000,89,4020,4109
"3338","Georgetown","Essex County County","MA","Georgetown",2001,127,4069,4196
"3339","Georgetown","Essex County County","MA","Georgetown",2002,176,3975,4151
"3340","Georgetown","Essex County County","MA","Georgetown",2003,191,3929,4120
"3341","Georgetown","Essex County County","MA","Georgetown",2004,177,3956,4133
"3342","Georgetown","Essex County County","MA","Georgetown",2005,170,4029,4199
"3343","Georgetown","Essex County County","MA","Georgetown",2006,153,4100,4253
"3344","Georgetown","Essex County County","MA","Georgetown",2007,158,4125,4283
"3345","Georgetown","Essex County County","MA","Georgetown",2008,195,4304,4499
"3346","Georgetown","Essex County County","MA","Georgetown",2009,312,4210,4522
"3347","Georgetown","Essex County County","MA","Georgetown",2010,291,4047,4338
"3348","Georgetown","Essex County County","MA","Georgetown",2011,256,4099,4355
"3349","Georgetown","Essex County County","MA","Georgetown",2012,223,4153,4376
"3350","Gill","Franklin County County","MA","Gill",1990,40,909,949
"3351","Gill","Franklin County County","MA","Gill",1991,64,907,971
"3352","Gill","Franklin County County","MA","Gill",1992,34,863,897
"3353","Gill","Franklin County County","MA","Gill",1993,34,867,901
"3354","Gill","Franklin County County","MA","Gill",1994,32,920,952
"3355","Gill","Franklin County County","MA","Gill",1995,29,917,946
"3356","Gill","Franklin County County","MA","Gill",1996,28,923,951
"3357","Gill","Franklin County County","MA","Gill",1997,25,947,972
"3358","Gill","Franklin County County","MA","Gill",1998,19,941,960
"3359","Gill","Franklin County County","MA","Gill",1999,19,968,987
"3360","Gill","Franklin County County","MA","Gill",2000,15,772,787
"3361","Gill","Franklin County County","MA","Gill",2001,17,770,787
"3362","Gill","Franklin County County","MA","Gill",2002,20,779,799
"3363","Gill","Franklin County County","MA","Gill",2003,28,782,810
"3364","Gill","Franklin County County","MA","Gill",2004,29,779,808
"3365","Gill","Franklin County County","MA","Gill",2005,30,778,808
"3366","Gill","Franklin County County","MA","Gill",2006,30,776,806
"3367","Gill","Franklin County County","MA","Gill",2007,26,770,796
"3368","Gill","Franklin County County","MA","Gill",2008,41,762,803
"3369","Gill","Franklin County County","MA","Gill",2009,63,745,808
"3370","Gill","Franklin County County","MA","Gill",2010,65,815,880
"3371","Gill","Franklin County County","MA","Gill",2011,57,816,873
"3372","Gill","Franklin County County","MA","Gill",2012,45,818,863
"3373","Gloucester","Essex County County","MA","Gloucester",1990,1742,14409,16151
"3374","Gloucester","Essex County County","MA","Gloucester",1991,2152,13958,16110
"3375","Gloucester","Essex County County","MA","Gloucester",1992,2387,13873,16260
"3376","Gloucester","Essex County County","MA","Gloucester",1993,1954,14023,15977
"3377","Gloucester","Essex County County","MA","Gloucester",1994,1579,14314,15893
"3378","Gloucester","Essex County County","MA","Gloucester",1995,1343,14488,15831
"3379","Gloucester","Essex County County","MA","Gloucester",1996,1030,14776,15806
"3380","Gloucester","Essex County County","MA","Gloucester",1997,938,15217,16155
"3381","Gloucester","Essex County County","MA","Gloucester",1998,884,15518,16402
"3382","Gloucester","Essex County County","MA","Gloucester",1999,733,15662,16395
"3383","Gloucester","Essex County County","MA","Gloucester",2000,601,15844,16445
"3384","Gloucester","Essex County County","MA","Gloucester",2001,815,15900,16715
"3385","Gloucester","Essex County County","MA","Gloucester",2002,1059,15710,16769
"3386","Gloucester","Essex County County","MA","Gloucester",2003,1150,15509,16659
"3387","Gloucester","Essex County County","MA","Gloucester",2004,1048,15484,16532
"3388","Gloucester","Essex County County","MA","Gloucester",2005,987,15608,16595
"3389","Gloucester","Essex County County","MA","Gloucester",2006,959,15164,16123
"3390","Gloucester","Essex County County","MA","Gloucester",2007,877,15250,16127
"3391","Gloucester","Essex County County","MA","Gloucester",2008,1079,15264,16343
"3392","Gloucester","Essex County County","MA","Gloucester",2009,1589,14804,16393
"3393","Gloucester","Essex County County","MA","Gloucester",2010,1575,14170,15745
"3394","Gloucester","Essex County County","MA","Gloucester",2011,1360,14342,15702
"3395","Gloucester","Essex County County","MA","Gloucester",2012,1232,14499,15731
"3396","Goshen","Hampshire County County","MA","Goshen",1990,26,493,519
"3397","Goshen","Hampshire County County","MA","Goshen",1991,28,478,506
"3398","Goshen","Hampshire County County","MA","Goshen",1992,29,511,540
"3399","Goshen","Hampshire County County","MA","Goshen",1993,23,532,555
"3400","Goshen","Hampshire County County","MA","Goshen",1994,27,567,594
"3401","Goshen","Hampshire County County","MA","Goshen",1995,15,587,602
"3402","Goshen","Hampshire County County","MA","Goshen",1996,11,573,584
"3403","Goshen","Hampshire County County","MA","Goshen",1997,18,577,595
"3404","Goshen","Hampshire County County","MA","Goshen",1998,11,557,568
"3405","Goshen","Hampshire County County","MA","Goshen",1999,11,604,615
"3406","Goshen","Hampshire County County","MA","Goshen",2000,8,564,572
"3407","Goshen","Hampshire County County","MA","Goshen",2001,10,569,579
"3408","Goshen","Hampshire County County","MA","Goshen",2002,14,570,584
"3409","Goshen","Hampshire County County","MA","Goshen",2003,22,572,594
"3410","Goshen","Hampshire County County","MA","Goshen",2004,20,573,593
"3411","Goshen","Hampshire County County","MA","Goshen",2005,15,574,589
"3412","Goshen","Hampshire County County","MA","Goshen",2006,20,580,600
"3413","Goshen","Hampshire County County","MA","Goshen",2007,16,580,596
"3414","Goshen","Hampshire County County","MA","Goshen",2008,29,585,614
"3415","Goshen","Hampshire County County","MA","Goshen",2009,38,560,598
"3416","Goshen","Hampshire County County","MA","Goshen",2010,36,606,642
"3417","Goshen","Hampshire County County","MA","Goshen",2011,28,599,627
"3418","Goshen","Hampshire County County","MA","Goshen",2012,32,599,631
"3419","Gosnold","Dukes County County","MA","Gosnold",1990,0,89,89
"3420","Gosnold","Dukes County County","MA","Gosnold",1991,0,86,86
"3421","Gosnold","Dukes County County","MA","Gosnold",1992,0,73,73
"3422","Gosnold","Dukes County County","MA","Gosnold",1993,2,84,86
"3423","Gosnold","Dukes County County","MA","Gosnold",1994,0,87,87
"3424","Gosnold","Dukes County County","MA","Gosnold",1995,0,88,88
"3425","Gosnold","Dukes County County","MA","Gosnold",1996,0,90,90
"3426","Gosnold","Dukes County County","MA","Gosnold",1997,1,90,91
"3427","Gosnold","Dukes County County","MA","Gosnold",1998,0,90,90
"3428","Gosnold","Dukes County County","MA","Gosnold",1999,0,89,89
"3429","Gosnold","Dukes County County","MA","Gosnold",2000,2,35,37
"3430","Gosnold","Dukes County County","MA","Gosnold",2001,0,35,35
"3431","Gosnold","Dukes County County","MA","Gosnold",2002,1,35,36
"3432","Gosnold","Dukes County County","MA","Gosnold",2003,1,34,35
"3433","Gosnold","Dukes County County","MA","Gosnold",2004,1,34,35
"3434","Gosnold","Dukes County County","MA","Gosnold",2005,1,35,36
"3435","Gosnold","Dukes County County","MA","Gosnold",2006,1,35,36
"3436","Gosnold","Dukes County County","MA","Gosnold",2007,2,34,36
"3437","Gosnold","Dukes County County","MA","Gosnold",2008,1,33,34
"3438","Gosnold","Dukes County County","MA","Gosnold",2009,1,33,34
"3439","Gosnold","Dukes County County","MA","Gosnold",2010,4,29,33
"3440","Gosnold","Dukes County County","MA","Gosnold",2011,2,29,31
"3441","Gosnold","Dukes County County","MA","Gosnold",2012,2,30,32
"3442","Grafton","Worcester County County","MA","Grafton",1990,410,6752,7162
"3443","Grafton","Worcester County County","MA","Grafton",1991,732,6532,7264
"3444","Grafton","Worcester County County","MA","Grafton",1992,586,6570,7156
"3445","Grafton","Worcester County County","MA","Grafton",1993,455,6821,7276
"3446","Grafton","Worcester County County","MA","Grafton",1994,333,6898,7231
"3447","Grafton","Worcester County County","MA","Grafton",1995,332,6771,7103
"3448","Grafton","Worcester County County","MA","Grafton",1996,279,6915,7194
"3449","Grafton","Worcester County County","MA","Grafton",1997,244,7166,7410
"3450","Grafton","Worcester County County","MA","Grafton",1998,221,7217,7438
"3451","Grafton","Worcester County County","MA","Grafton",1999,223,7343,7566
"3452","Grafton","Worcester County County","MA","Grafton",2000,206,8184,8390
"3453","Grafton","Worcester County County","MA","Grafton",2001,271,8293,8564
"3454","Grafton","Worcester County County","MA","Grafton",2002,433,8414,8847
"3455","Grafton","Worcester County County","MA","Grafton",2003,488,8464,8952
"3456","Grafton","Worcester County County","MA","Grafton",2004,440,8609,9049
"3457","Grafton","Worcester County County","MA","Grafton",2005,402,8896,9298
"3458","Grafton","Worcester County County","MA","Grafton",2006,395,9211,9606
"3459","Grafton","Worcester County County","MA","Grafton",2007,426,9341,9767
"3460","Grafton","Worcester County County","MA","Grafton",2008,478,9182,9660
"3461","Grafton","Worcester County County","MA","Grafton",2009,802,8942,9744
"3462","Grafton","Worcester County County","MA","Grafton",2010,733,8956,9689
"3463","Grafton","Worcester County County","MA","Grafton",2011,593,9036,9629
"3464","Grafton","Worcester County County","MA","Grafton",2012,602,9033,9635
"3465","Granby","Hampshire County County","MA","Granby",1990,187,2949,3136
"3466","Granby","Hampshire County County","MA","Granby",1991,264,2895,3159
"3467","Granby","Hampshire County County","MA","Granby",1992,265,2942,3207
"3468","Granby","Hampshire County County","MA","Granby",1993,233,2958,3191
"3469","Granby","Hampshire County County","MA","Granby",1994,209,3069,3278
"3470","Granby","Hampshire County County","MA","Granby",1995,162,2972,3134
"3471","Granby","Hampshire County County","MA","Granby",1996,157,3038,3195
"3472","Granby","Hampshire County County","MA","Granby",1997,152,3114,3266
"3473","Granby","Hampshire County County","MA","Granby",1998,132,3150,3282
"3474","Granby","Hampshire County County","MA","Granby",1999,99,3190,3289
"3475","Granby","Hampshire County County","MA","Granby",2000,90,3384,3474
"3476","Granby","Hampshire County County","MA","Granby",2001,109,3403,3512
"3477","Granby","Hampshire County County","MA","Granby",2002,157,3402,3559
"3478","Granby","Hampshire County County","MA","Granby",2003,172,3396,3568
"3479","Granby","Hampshire County County","MA","Granby",2004,168,3418,3586
"3480","Granby","Hampshire County County","MA","Granby",2005,151,3440,3591
"3481","Granby","Hampshire County County","MA","Granby",2006,157,3464,3621
"3482","Granby","Hampshire County County","MA","Granby",2007,163,3440,3603
"3483","Granby","Hampshire County County","MA","Granby",2008,178,3408,3586
"3484","Granby","Hampshire County County","MA","Granby",2009,274,3251,3525
"3485","Granby","Hampshire County County","MA","Granby",2010,255,3239,3494
"3486","Granby","Hampshire County County","MA","Granby",2011,232,3198,3430
"3487","Granby","Hampshire County County","MA","Granby",2012,234,3200,3434
"3488","Granville","Hampden County County","MA","Granville",1990,29,734,763
"3489","Granville","Hampden County County","MA","Granville",1991,59,718,777
"3490","Granville","Hampden County County","MA","Granville",1992,57,819,876
"3491","Granville","Hampden County County","MA","Granville",1993,62,845,907
"3492","Granville","Hampden County County","MA","Granville",1994,59,904,963
"3493","Granville","Hampden County County","MA","Granville",1995,51,849,900
"3494","Granville","Hampden County County","MA","Granville",1996,45,831,876
"3495","Granville","Hampden County County","MA","Granville",1997,33,841,874
"3496","Granville","Hampden County County","MA","Granville",1998,28,887,915
"3497","Granville","Hampden County County","MA","Granville",1999,29,967,996
"3498","Granville","Hampden County County","MA","Granville",2000,20,850,870
"3499","Granville","Hampden County County","MA","Granville",2001,21,861,882
"3500","Granville","Hampden County County","MA","Granville",2002,32,869,901
"3501","Granville","Hampden County County","MA","Granville",2003,32,873,905
"3502","Granville","Hampden County County","MA","Granville",2004,29,887,916
"3503","Granville","Hampden County County","MA","Granville",2005,32,902,934
"3504","Granville","Hampden County County","MA","Granville",2006,31,920,951
"3505","Granville","Hampden County County","MA","Granville",2007,32,927,959
"3506","Granville","Hampden County County","MA","Granville",2008,44,924,968
"3507","Granville","Hampden County County","MA","Granville",2009,76,861,937
"3508","Granville","Hampden County County","MA","Granville",2010,83,821,904
"3509","Granville","Hampden County County","MA","Granville",2011,69,813,882
"3510","Granville","Hampden County County","MA","Granville",2012,64,814,878
"3511","Great Barrington","Berkshire County County","MA","Great Barrington",1990,241,3704,3945
"3512","Great Barrington","Berkshire County County","MA","Great Barrington",1991,327,3588,3915
"3513","Great Barrington","Berkshire County County","MA","Great Barrington",1992,331,3572,3903
"3514","Great Barrington","Berkshire County County","MA","Great Barrington",1993,291,3699,3990
"3515","Great Barrington","Berkshire County County","MA","Great Barrington",1994,241,3682,3923
"3516","Great Barrington","Berkshire County County","MA","Great Barrington",1995,211,3985,4196
"3517","Great Barrington","Berkshire County County","MA","Great Barrington",1996,163,4070,4233
"3518","Great Barrington","Berkshire County County","MA","Great Barrington",1997,151,4160,4311
"3519","Great Barrington","Berkshire County County","MA","Great Barrington",1998,120,4212,4332
"3520","Great Barrington","Berkshire County County","MA","Great Barrington",1999,115,4195,4310
"3521","Great Barrington","Berkshire County County","MA","Great Barrington",2000,103,3984,4087
"3522","Great Barrington","Berkshire County County","MA","Great Barrington",2001,121,4118,4239
"3523","Great Barrington","Berkshire County County","MA","Great Barrington",2002,153,4230,4383
"3524","Great Barrington","Berkshire County County","MA","Great Barrington",2003,179,4212,4391
"3525","Great Barrington","Berkshire County County","MA","Great Barrington",2004,163,4185,4348
"3526","Great Barrington","Berkshire County County","MA","Great Barrington",2005,153,4272,4425
"3527","Great Barrington","Berkshire County County","MA","Great Barrington",2006,156,4304,4460
"3528","Great Barrington","Berkshire County County","MA","Great Barrington",2007,164,4210,4374
"3529","Great Barrington","Berkshire County County","MA","Great Barrington",2008,206,4224,4430
"3530","Great Barrington","Berkshire County County","MA","Great Barrington",2009,300,4093,4393
"3531","Great Barrington","Berkshire County County","MA","Great Barrington",2010,299,3987,4286
"3532","Great Barrington","Berkshire County County","MA","Great Barrington",2011,267,4010,4277
"3533","Great Barrington","Berkshire County County","MA","Great Barrington",2012,247,3977,4224
"3534","Greenfield","Franklin County County","MA","Greenfield",1990,463,8768,9231
"3535","Greenfield","Franklin County County","MA","Greenfield",1991,768,8652,9420
"3536","Greenfield","Franklin County County","MA","Greenfield",1992,789,8314,9103
"3537","Greenfield","Franklin County County","MA","Greenfield",1993,600,8265,8865
"3538","Greenfield","Franklin County County","MA","Greenfield",1994,491,8389,8880
"3539","Greenfield","Franklin County County","MA","Greenfield",1995,471,8805,9276
"3540","Greenfield","Franklin County County","MA","Greenfield",1996,385,8804,9189
"3541","Greenfield","Franklin County County","MA","Greenfield",1997,354,8955,9309
"3542","Greenfield","Franklin County County","MA","Greenfield",1998,334,9063,9397
"3543","Greenfield","Franklin County County","MA","Greenfield",1999,318,9182,9500
"3544","Greenfield","Franklin County County","MA","Greenfield",2000,248,8975,9223
"3545","Greenfield","Franklin County County","MA","Greenfield",2001,321,8905,9226
"3546","Greenfield","Franklin County County","MA","Greenfield",2002,423,8979,9402
"3547","Greenfield","Franklin County County","MA","Greenfield",2003,468,8954,9422
"3548","Greenfield","Franklin County County","MA","Greenfield",2004,425,8762,9187
"3549","Greenfield","Franklin County County","MA","Greenfield",2005,447,8701,9148
"3550","Greenfield","Franklin County County","MA","Greenfield",2006,431,8683,9114
"3551","Greenfield","Franklin County County","MA","Greenfield",2007,428,8636,9064
"3552","Greenfield","Franklin County County","MA","Greenfield",2008,508,8559,9067
"3553","Greenfield","Franklin County County","MA","Greenfield",2009,759,8336,9095
"3554","Greenfield","Franklin County County","MA","Greenfield",2010,741,8290,9031
"3555","Greenfield","Franklin County County","MA","Greenfield",2011,632,8301,8933
"3556","Greenfield","Franklin County County","MA","Greenfield",2012,629,8324,8953
"3557","Groton","Middlesex County County","MA","Groton",1990,200,4214,4414
"3558","Groton","Middlesex County County","MA","Groton",1991,312,4169,4481
"3559","Groton","Middlesex County County","MA","Groton",1992,319,4360,4679
"3560","Groton","Middlesex County County","MA","Groton",1993,237,4449,4686
"3561","Groton","Middlesex County County","MA","Groton",1994,232,4612,4844
"3562","Groton","Middlesex County County","MA","Groton",1995,184,4578,4762
"3563","Groton","Middlesex County County","MA","Groton",1996,145,4821,4966
"3564","Groton","Middlesex County County","MA","Groton",1997,145,5087,5232
"3565","Groton","Middlesex County County","MA","Groton",1998,140,5302,5442
"3566","Groton","Middlesex County County","MA","Groton",1999,138,5584,5722
"3567","Groton","Middlesex County County","MA","Groton",2000,105,5050,5155
"3568","Groton","Middlesex County County","MA","Groton",2001,174,5139,5313
"3569","Groton","Middlesex County County","MA","Groton",2002,300,5135,5435
"3570","Groton","Middlesex County County","MA","Groton",2003,272,5162,5434
"3571","Groton","Middlesex County County","MA","Groton",2004,229,5249,5478
"3572","Groton","Middlesex County County","MA","Groton",2005,208,5339,5547
"3573","Groton","Middlesex County County","MA","Groton",2006,188,5327,5515
"3574","Groton","Middlesex County County","MA","Groton",2007,185,5386,5571
"3575","Groton","Middlesex County County","MA","Groton",2008,238,5394,5632
"3576","Groton","Middlesex County County","MA","Groton",2009,354,5262,5616
"3577","Groton","Middlesex County County","MA","Groton",2010,356,5275,5631
"3578","Groton","Middlesex County County","MA","Groton",2011,334,5352,5686
"3579","Groton","Middlesex County County","MA","Groton",2012,293,5411,5704
"3580","Groveland","Essex County County","MA","Groveland",1990,194,2784,2978
"3581","Groveland","Essex County County","MA","Groveland",1991,248,2770,3018
"3582","Groveland","Essex County County","MA","Groveland",1992,215,2835,3050
"3583","Groveland","Essex County County","MA","Groveland",1993,212,2917,3129
"3584","Groveland","Essex County County","MA","Groveland",1994,191,2952,3143
"3585","Groveland","Essex County County","MA","Groveland",1995,160,2992,3152
"3586","Groveland","Essex County County","MA","Groveland",1996,144,3109,3253
"3587","Groveland","Essex County County","MA","Groveland",1997,122,3189,3311
"3588","Groveland","Essex County County","MA","Groveland",1998,99,3311,3410
"3589","Groveland","Essex County County","MA","Groveland",1999,98,3401,3499
"3590","Groveland","Essex County County","MA","Groveland",2000,75,3291,3366
"3591","Groveland","Essex County County","MA","Groveland",2001,109,3264,3373
"3592","Groveland","Essex County County","MA","Groveland",2002,155,3222,3377
"3593","Groveland","Essex County County","MA","Groveland",2003,161,3202,3363
"3594","Groveland","Essex County County","MA","Groveland",2004,158,3233,3391
"3595","Groveland","Essex County County","MA","Groveland",2005,144,3328,3472
"3596","Groveland","Essex County County","MA","Groveland",2006,147,3441,3588
"3597","Groveland","Essex County County","MA","Groveland",2007,135,3524,3659
"3598","Groveland","Essex County County","MA","Groveland",2008,157,3609,3766
"3599","Groveland","Essex County County","MA","Groveland",2009,264,3617,3881
"3600","Groveland","Essex County County","MA","Groveland",2010,251,3211,3462
"3601","Groveland","Essex County County","MA","Groveland",2011,204,3252,3456
"3602","Groveland","Essex County County","MA","Groveland",2012,203,3295,3498
"3603","Hadley","Hampshire County County","MA","Hadley",1990,110,2258,2368
"3604","Hadley","Hampshire County County","MA","Hadley",1991,174,2185,2359
"3605","Hadley","Hampshire County County","MA","Hadley",1992,151,2179,2330
"3606","Hadley","Hampshire County County","MA","Hadley",1993,104,2188,2292
"3607","Hadley","Hampshire County County","MA","Hadley",1994,114,2238,2352
"3608","Hadley","Hampshire County County","MA","Hadley",1995,78,2253,2331
"3609","Hadley","Hampshire County County","MA","Hadley",1996,75,2303,2378
"3610","Hadley","Hampshire County County","MA","Hadley",1997,65,2378,2443
"3611","Hadley","Hampshire County County","MA","Hadley",1998,54,2408,2462
"3612","Hadley","Hampshire County County","MA","Hadley",1999,53,2441,2494
"3613","Hadley","Hampshire County County","MA","Hadley",2000,54,2530,2584
"3614","Hadley","Hampshire County County","MA","Hadley",2001,62,2530,2592
"3615","Hadley","Hampshire County County","MA","Hadley",2002,92,2522,2614
"3616","Hadley","Hampshire County County","MA","Hadley",2003,130,2512,2642
"3617","Hadley","Hampshire County County","MA","Hadley",2004,116,2511,2627
"3618","Hadley","Hampshire County County","MA","Hadley",2005,117,2504,2621
"3619","Hadley","Hampshire County County","MA","Hadley",2006,108,2516,2624
"3620","Hadley","Hampshire County County","MA","Hadley",2007,104,2510,2614
"3621","Hadley","Hampshire County County","MA","Hadley",2008,109,2459,2568
"3622","Hadley","Hampshire County County","MA","Hadley",2009,157,2347,2504
"3623","Hadley","Hampshire County County","MA","Hadley",2010,184,2611,2795
"3624","Hadley","Hampshire County County","MA","Hadley",2011,161,2578,2739
"3625","Hadley","Hampshire County County","MA","Hadley",2012,155,2580,2735
"3626","Halifax","Plymouth County County","MA","Halifax",1990,285,3273,3558
"3627","Halifax","Plymouth County County","MA","Halifax",1991,387,3156,3543
"3628","Halifax","Plymouth County County","MA","Halifax",1992,375,3130,3505
"3629","Halifax","Plymouth County County","MA","Halifax",1993,316,3309,3625
"3630","Halifax","Plymouth County County","MA","Halifax",1994,252,3514,3766
"3631","Halifax","Plymouth County County","MA","Halifax",1995,201,3469,3670
"3632","Halifax","Plymouth County County","MA","Halifax",1996,226,3496,3722
"3633","Halifax","Plymouth County County","MA","Halifax",1997,195,3629,3824
"3634","Halifax","Plymouth County County","MA","Halifax",1998,130,3732,3862
"3635","Halifax","Plymouth County County","MA","Halifax",1999,134,3865,3999
"3636","Halifax","Plymouth County County","MA","Halifax",2000,111,4069,4180
"3637","Halifax","Plymouth County County","MA","Halifax",2001,144,4070,4214
"3638","Halifax","Plymouth County County","MA","Halifax",2002,200,4048,4248
"3639","Halifax","Plymouth County County","MA","Halifax",2003,237,3977,4214
"3640","Halifax","Plymouth County County","MA","Halifax",2004,221,3983,4204
"3641","Halifax","Plymouth County County","MA","Halifax",2005,221,4011,4232
"3642","Halifax","Plymouth County County","MA","Halifax",2006,228,4051,4279
"3643","Halifax","Plymouth County County","MA","Halifax",2007,214,4060,4274
"3644","Halifax","Plymouth County County","MA","Halifax",2008,254,4028,4282
"3645","Halifax","Plymouth County County","MA","Halifax",2009,381,3947,4328
"3646","Halifax","Plymouth County County","MA","Halifax",2010,395,3799,4194
"3647","Halifax","Plymouth County County","MA","Halifax",2011,329,3837,4166
"3648","Halifax","Plymouth County County","MA","Halifax",2012,318,3870,4188
"3649","Hamilton","Essex County County","MA","Hamilton",1990,163,3526,3689
"3650","Hamilton","Essex County County","MA","Hamilton",1991,222,3448,3670
"3651","Hamilton","Essex County County","MA","Hamilton",1992,197,3439,3636
"3652","Hamilton","Essex County County","MA","Hamilton",1993,176,3529,3705
"3653","Hamilton","Essex County County","MA","Hamilton",1994,154,3599,3753
"3654","Hamilton","Essex County County","MA","Hamilton",1995,119,3579,3698
"3655","Hamilton","Essex County County","MA","Hamilton",1996,96,3653,3749
"3656","Hamilton","Essex County County","MA","Hamilton",1997,88,3748,3836
"3657","Hamilton","Essex County County","MA","Hamilton",1998,86,3826,3912
"3658","Hamilton","Essex County County","MA","Hamilton",1999,76,3855,3931
"3659","Hamilton","Essex County County","MA","Hamilton",2000,75,3926,4001
"3660","Hamilton","Essex County County","MA","Hamilton",2001,116,3938,4054
"3661","Hamilton","Essex County County","MA","Hamilton",2002,160,3887,4047
"3662","Hamilton","Essex County County","MA","Hamilton",2003,191,3832,4023
"3663","Hamilton","Essex County County","MA","Hamilton",2004,167,3820,3987
"3664","Hamilton","Essex County County","MA","Hamilton",2005,152,3828,3980
"3665","Hamilton","Essex County County","MA","Hamilton",2006,145,3709,3854
"3666","Hamilton","Essex County County","MA","Hamilton",2007,137,3729,3866
"3667","Hamilton","Essex County County","MA","Hamilton",2008,173,3729,3902
"3668","Hamilton","Essex County County","MA","Hamilton",2009,259,3609,3868
"3669","Hamilton","Essex County County","MA","Hamilton",2010,240,3448,3688
"3670","Hamilton","Essex County County","MA","Hamilton",2011,196,3490,3686
"3671","Hamilton","Essex County County","MA","Hamilton",2012,175,3529,3704
"3672","Hampden","Hampden County County","MA","Hampden",1990,125,2607,2732
"3673","Hampden","Hampden County County","MA","Hampden",1991,181,2530,2711
"3674","Hampden","Hampden County County","MA","Hampden",1992,209,2551,2760
"3675","Hampden","Hampden County County","MA","Hampden",1993,186,2560,2746
"3676","Hampden","Hampden County County","MA","Hampden",1994,147,2578,2725
"3677","Hampden","Hampden County County","MA","Hampden",1995,136,2551,2687
"3678","Hampden","Hampden County County","MA","Hampden",1996,109,2586,2695
"3679","Hampden","Hampden County County","MA","Hampden",1997,84,2650,2734
"3680","Hampden","Hampden County County","MA","Hampden",1998,64,2671,2735
"3681","Hampden","Hampden County County","MA","Hampden",1999,70,2691,2761
"3682","Hampden","Hampden County County","MA","Hampden",2000,68,2753,2821
"3683","Hampden","Hampden County County","MA","Hampden",2001,85,2777,2862
"3684","Hampden","Hampden County County","MA","Hampden",2002,122,2771,2893
"3685","Hampden","Hampden County County","MA","Hampden",2003,148,2765,2913
"3686","Hampden","Hampden County County","MA","Hampden",2004,149,2769,2918
"3687","Hampden","Hampden County County","MA","Hampden",2005,126,2781,2907
"3688","Hampden","Hampden County County","MA","Hampden",2006,116,2804,2920
"3689","Hampden","Hampden County County","MA","Hampden",2007,115,2800,2915
"3690","Hampden","Hampden County County","MA","Hampden",2008,140,2825,2965
"3691","Hampden","Hampden County County","MA","Hampden",2009,206,2683,2889
"3692","Hampden","Hampden County County","MA","Hampden",2010,218,2572,2790
"3693","Hampden","Hampden County County","MA","Hampden",2011,184,2547,2731
"3694","Hampden","Hampden County County","MA","Hampden",2012,172,2548,2720
"3695",NA,"Hampden County County","MA","Hampden County County",1990,14857,208015,222872
"3696",NA,"Hampden County County","MA","Hampden County County",1991,21582,200238,221820
"3697",NA,"Hampden County County","MA","Hampden County County",1992,20835,199015,219850
"3698",NA,"Hampden County County","MA","Hampden County County",1993,19341,198001,217342
"3699",NA,"Hampden County County","MA","Hampden County County",1994,16961,197840,214801
"3700",NA,"Hampden County County","MA","Hampden County County",1995,14143,197823,211966
"3701",NA,"Hampden County County","MA","Hampden County County",1996,11172,199829,211001
"3702",NA,"Hampden County County","MA","Hampden County County",1997,10382,204128,214510
"3703",NA,"Hampden County County","MA","Hampden County County",1998,9270,204770,214040
"3704",NA,"Hampden County County","MA","Hampden County County",1999,8783,205357,214140
"3705",NA,"Hampden County County","MA","Hampden County County",2000,7318,211898,219216
"3706",NA,"Hampden County County","MA","Hampden County County",2001,9304,212446,221750
"3707",NA,"Hampden County County","MA","Hampden County County",2002,12856,211762,224618
"3708",NA,"Hampden County County","MA","Hampden County County",2003,14732,210081,224813
"3709",NA,"Hampden County County","MA","Hampden County County",2004,13901,210330,224231
"3710",NA,"Hampden County County","MA","Hampden County County",2005,13029,211071,224100
"3711",NA,"Hampden County County","MA","Hampden County County",2006,13201,212066,225267
"3712",NA,"Hampden County County","MA","Hampden County County",2007,12489,211474,223963
"3713",NA,"Hampden County County","MA","Hampden County County",2008,14579,210907,225486
"3714",NA,"Hampden County County","MA","Hampden County County",2009,21263,205679,226942
"3715",NA,"Hampden County County","MA","Hampden County County",2010,22466,202854,225320
"3716",NA,"Hampden County County","MA","Hampden County County",2011,20404,200849,221253
"3717",NA,"Hampden County County","MA","Hampden County County",2012,18729,200969,219698
"3718",NA,"Hampshire County County","MA","Hampshire County County",1990,4111,76100,80211
"3719",NA,"Hampshire County County","MA","Hampshire County County",1991,5589,73144,78733
"3720",NA,"Hampshire County County","MA","Hampshire County County",1992,5398,73514,78912
"3721",NA,"Hampshire County County","MA","Hampshire County County",1993,4368,74173,78541
"3722",NA,"Hampshire County County","MA","Hampshire County County",1994,3906,75448,79354
"3723",NA,"Hampshire County County","MA","Hampshire County County",1995,3308,75869,79177
"3724",NA,"Hampshire County County","MA","Hampshire County County",1996,2699,77109,79808
"3725",NA,"Hampshire County County","MA","Hampshire County County",1997,2402,78922,81324
"3726",NA,"Hampshire County County","MA","Hampshire County County",1998,2287,80014,82301
"3727",NA,"Hampshire County County","MA","Hampshire County County",1999,2094,81005,83099
"3728",NA,"Hampshire County County","MA","Hampshire County County",2000,1899,84104,86003
"3729",NA,"Hampshire County County","MA","Hampshire County County",2001,2334,84150,86484
"3730",NA,"Hampshire County County","MA","Hampshire County County",2002,3113,84068,87181
"3731",NA,"Hampshire County County","MA","Hampshire County County",2003,3718,84026,87744
"3732",NA,"Hampshire County County","MA","Hampshire County County",2004,3627,84168,87795
"3733",NA,"Hampshire County County","MA","Hampshire County County",2005,3547,84257,87804
"3734",NA,"Hampshire County County","MA","Hampshire County County",2006,3489,85011,88500
"3735",NA,"Hampshire County County","MA","Hampshire County County",2007,3345,85099,88444
"3736",NA,"Hampshire County County","MA","Hampshire County County",2008,3896,84818,88714
"3737",NA,"Hampshire County County","MA","Hampshire County County",2009,5672,81759,87431
"3738",NA,"Hampshire County County","MA","Hampshire County County",2010,5855,82485,88340
"3739",NA,"Hampshire County County","MA","Hampshire County County",2011,5186,81818,87004
"3740",NA,"Hampshire County County","MA","Hampshire County County",2012,4874,82030,86904
"3741","Hancock","Berkshire County County","MA","Hancock",1990,16,357,373
"3742","Hancock","Berkshire County County","MA","Hancock",1991,17,348,365
"3743","Hancock","Berkshire County County","MA","Hancock",1992,13,397,410
"3744","Hancock","Berkshire County County","MA","Hancock",1993,23,417,440
"3745","Hancock","Berkshire County County","MA","Hancock",1994,16,396,412
"3746","Hancock","Berkshire County County","MA","Hancock",1995,17,329,346
"3747","Hancock","Berkshire County County","MA","Hancock",1996,6,331,337
"3748","Hancock","Berkshire County County","MA","Hancock",1997,7,333,340
"3749","Hancock","Berkshire County County","MA","Hancock",1998,4,223,227
"3750","Hancock","Berkshire County County","MA","Hancock",1999,1,224,225
"3751","Hancock","Berkshire County County","MA","Hancock",2000,4,388,392
"3752","Hancock","Berkshire County County","MA","Hancock",2001,7,391,398
"3753","Hancock","Berkshire County County","MA","Hancock",2002,10,424,434
"3754","Hancock","Berkshire County County","MA","Hancock",2003,11,516,527
"3755","Hancock","Berkshire County County","MA","Hancock",2004,19,554,573
"3756","Hancock","Berkshire County County","MA","Hancock",2005,13,572,585
"3757","Hancock","Berkshire County County","MA","Hancock",2006,15,589,604
"3758","Hancock","Berkshire County County","MA","Hancock",2007,12,619,631
"3759","Hancock","Berkshire County County","MA","Hancock",2008,14,631,645
"3760","Hancock","Berkshire County County","MA","Hancock",2009,19,697,716
"3761","Hancock","Berkshire County County","MA","Hancock",2010,21,382,403
"3762","Hancock","Berkshire County County","MA","Hancock",2011,18,385,403
"3763","Hancock","Berkshire County County","MA","Hancock",2012,22,384,406
"3764","Hanover","Plymouth County County","MA","Hanover",1990,351,6374,6725
"3765","Hanover","Plymouth County County","MA","Hanover",1991,500,6309,6809
"3766","Hanover","Plymouth County County","MA","Hanover",1992,526,6309,6835
"3767","Hanover","Plymouth County County","MA","Hanover",1993,433,6446,6879
"3768","Hanover","Plymouth County County","MA","Hanover",1994,312,6564,6876
"3769","Hanover","Plymouth County County","MA","Hanover",1995,323,6714,7037
"3770","Hanover","Plymouth County County","MA","Hanover",1996,261,6917,7178
"3771","Hanover","Plymouth County County","MA","Hanover",1997,237,7180,7417
"3772","Hanover","Plymouth County County","MA","Hanover",1998,167,7386,7553
"3773","Hanover","Plymouth County County","MA","Hanover",1999,195,7540,7735
"3774","Hanover","Plymouth County County","MA","Hanover",2000,156,7055,7211
"3775","Hanover","Plymouth County County","MA","Hanover",2001,205,7106,7311
"3776","Hanover","Plymouth County County","MA","Hanover",2002,276,7094,7370
"3777","Hanover","Plymouth County County","MA","Hanover",2003,335,7047,7382
"3778","Hanover","Plymouth County County","MA","Hanover",2004,316,7126,7442
"3779","Hanover","Plymouth County County","MA","Hanover",2005,310,7330,7640
"3780","Hanover","Plymouth County County","MA","Hanover",2006,302,7152,7454
"3781","Hanover","Plymouth County County","MA","Hanover",2007,278,7189,7467
"3782","Hanover","Plymouth County County","MA","Hanover",2008,339,7209,7548
"3783","Hanover","Plymouth County County","MA","Hanover",2009,521,6998,7519
"3784","Hanover","Plymouth County County","MA","Hanover",2010,540,6988,7528
"3785","Hanover","Plymouth County County","MA","Hanover",2011,460,7056,7516
"3786","Hanover","Plymouth County County","MA","Hanover",2012,411,7133,7544
"3787","Hanson","Plymouth County County","MA","Hanson",1990,379,4727,5106
"3788","Hanson","Plymouth County County","MA","Hanson",1991,570,4586,5156
"3789","Hanson","Plymouth County County","MA","Hanson",1992,557,4562,5119
"3790","Hanson","Plymouth County County","MA","Hanson",1993,430,4795,5225
"3791","Hanson","Plymouth County County","MA","Hanson",1994,309,5098,5407
"3792","Hanson","Plymouth County County","MA","Hanson",1995,317,5034,5351
"3793","Hanson","Plymouth County County","MA","Hanson",1996,284,5087,5371
"3794","Hanson","Plymouth County County","MA","Hanson",1997,265,5253,5518
"3795","Hanson","Plymouth County County","MA","Hanson",1998,196,5324,5520
"3796","Hanson","Plymouth County County","MA","Hanson",1999,193,5460,5653
"3797","Hanson","Plymouth County County","MA","Hanson",2000,144,5230,5374
"3798","Hanson","Plymouth County County","MA","Hanson",2001,175,5252,5427
"3799","Hanson","Plymouth County County","MA","Hanson",2002,250,5235,5485
"3800","Hanson","Plymouth County County","MA","Hanson",2003,297,5126,5423
"3801","Hanson","Plymouth County County","MA","Hanson",2004,280,5138,5418
"3802","Hanson","Plymouth County County","MA","Hanson",2005,275,5169,5444
"3803","Hanson","Plymouth County County","MA","Hanson",2006,261,5270,5531
"3804","Hanson","Plymouth County County","MA","Hanson",2007,278,5324,5602
"3805","Hanson","Plymouth County County","MA","Hanson",2008,311,5321,5632
"3806","Hanson","Plymouth County County","MA","Hanson",2009,479,5203,5682
"3807","Hanson","Plymouth County County","MA","Hanson",2010,521,5233,5754
"3808","Hanson","Plymouth County County","MA","Hanson",2011,457,5282,5739
"3809","Hanson","Plymouth County County","MA","Hanson",2012,385,5329,5714
"3810","Hardwick","Worcester County County","MA","Hardwick",1990,92,1092,1184
"3811","Hardwick","Worcester County County","MA","Hardwick",1991,128,1058,1186
"3812","Hardwick","Worcester County County","MA","Hardwick",1992,115,1052,1167
"3813","Hardwick","Worcester County County","MA","Hardwick",1993,124,1068,1192
"3814","Hardwick","Worcester County County","MA","Hardwick",1994,90,1060,1150
"3815","Hardwick","Worcester County County","MA","Hardwick",1995,84,1093,1177
"3816","Hardwick","Worcester County County","MA","Hardwick",1996,64,1088,1152
"3817","Hardwick","Worcester County County","MA","Hardwick",1997,64,1120,1184
"3818","Hardwick","Worcester County County","MA","Hardwick",1998,55,1120,1175
"3819","Hardwick","Worcester County County","MA","Hardwick",1999,59,1127,1186
"3820","Hardwick","Worcester County County","MA","Hardwick",2000,40,1282,1322
"3821","Hardwick","Worcester County County","MA","Hardwick",2001,55,1283,1338
"3822","Hardwick","Worcester County County","MA","Hardwick",2002,72,1273,1345
"3823","Hardwick","Worcester County County","MA","Hardwick",2003,90,1263,1353
"3824","Hardwick","Worcester County County","MA","Hardwick",2004,86,1257,1343
"3825","Hardwick","Worcester County County","MA","Hardwick",2005,72,1248,1320
"3826","Hardwick","Worcester County County","MA","Hardwick",2006,75,1264,1339
"3827","Hardwick","Worcester County County","MA","Hardwick",2007,78,1265,1343
"3828","Hardwick","Worcester County County","MA","Hardwick",2008,82,1235,1317
"3829","Hardwick","Worcester County County","MA","Hardwick",2009,131,1199,1330
"3830","Hardwick","Worcester County County","MA","Hardwick",2010,127,1346,1473
"3831","Hardwick","Worcester County County","MA","Hardwick",2011,127,1357,1484
"3832","Hardwick","Worcester County County","MA","Hardwick",2012,103,1357,1460
"3833","Harvard","Worcester County County","MA","Harvard",1990,140,3586,3726
"3834","Harvard","Worcester County County","MA","Harvard",1991,136,3563,3699
"3835","Harvard","Worcester County County","MA","Harvard",1992,139,3363,3502
"3836","Harvard","Worcester County County","MA","Harvard",1993,155,3175,3330
"3837","Harvard","Worcester County County","MA","Harvard",1994,116,3195,3311
"3838","Harvard","Worcester County County","MA","Harvard",1995,100,3333,3433
"3839","Harvard","Worcester County County","MA","Harvard",1996,61,3388,3449
"3840","Harvard","Worcester County County","MA","Harvard",1997,66,3685,3751
"3841","Harvard","Worcester County County","MA","Harvard",1998,72,3534,3606
"3842","Harvard","Worcester County County","MA","Harvard",1999,76,3590,3666
"3843","Harvard","Worcester County County","MA","Harvard",2000,52,2878,2930
"3844","Harvard","Worcester County County","MA","Harvard",2001,87,2894,2981
"3845","Harvard","Worcester County County","MA","Harvard",2002,151,2860,3011
"3846","Harvard","Worcester County County","MA","Harvard",2003,142,2822,2964
"3847","Harvard","Worcester County County","MA","Harvard",2004,123,2813,2936
"3848","Harvard","Worcester County County","MA","Harvard",2005,106,2837,2943
"3849","Harvard","Worcester County County","MA","Harvard",2006,101,2840,2941
"3850","Harvard","Worcester County County","MA","Harvard",2007,92,2867,2959
"3851","Harvard","Worcester County County","MA","Harvard",2008,111,2825,2936
"3852","Harvard","Worcester County County","MA","Harvard",2009,185,2742,2927
"3853","Harvard","Worcester County County","MA","Harvard",2010,180,2950,3130
"3854","Harvard","Worcester County County","MA","Harvard",2011,156,2971,3127
"3855","Harvard","Worcester County County","MA","Harvard",2012,154,3003,3157
"3856","Harwich","Barnstable County County","MA","Harwich",1990,354,4336,4690
"3857","Harwich","Barnstable County County","MA","Harwich",1991,510,4236,4746
"3858","Harwich","Barnstable County County","MA","Harwich",1992,446,4198,4644
"3859","Harwich","Barnstable County County","MA","Harwich",1993,449,4331,4780
"3860","Harwich","Barnstable County County","MA","Harwich",1994,376,4488,4864
"3861","Harwich","Barnstable County County","MA","Harwich",1995,334,4613,4947
"3862","Harwich","Barnstable County County","MA","Harwich",1996,294,4734,5028
"3863","Harwich","Barnstable County County","MA","Harwich",1997,287,4819,5106
"3864","Harwich","Barnstable County County","MA","Harwich",1998,245,4957,5202
"3865","Harwich","Barnstable County County","MA","Harwich",1999,217,5172,5389
"3866","Harwich","Barnstable County County","MA","Harwich",2000,210,5728,5938
"3867","Harwich","Barnstable County County","MA","Harwich",2001,238,5794,6032
"3868","Harwich","Barnstable County County","MA","Harwich",2002,303,5947,6250
"3869","Harwich","Barnstable County County","MA","Harwich",2003,343,6072,6415
"3870","Harwich","Barnstable County County","MA","Harwich",2004,330,6122,6452
"3871","Harwich","Barnstable County County","MA","Harwich",2005,343,6094,6437
"3872","Harwich","Barnstable County County","MA","Harwich",2006,323,6085,6408
"3873","Harwich","Barnstable County County","MA","Harwich",2007,320,6047,6367
"3874","Harwich","Barnstable County County","MA","Harwich",2008,396,5997,6393
"3875","Harwich","Barnstable County County","MA","Harwich",2009,568,5808,6376
"3876","Harwich","Barnstable County County","MA","Harwich",2010,627,5886,6513
"3877","Harwich","Barnstable County County","MA","Harwich",2011,563,5876,6439
"3878","Harwich","Barnstable County County","MA","Harwich",2012,489,5974,6463
"3879","Hatfield","Hampshire County County","MA","Hatfield",1990,107,1677,1784
"3880","Hatfield","Hampshire County County","MA","Hatfield",1991,130,1608,1738
"3881","Hatfield","Hampshire County County","MA","Hatfield",1992,145,1627,1772
"3882","Hatfield","Hampshire County County","MA","Hatfield",1993,119,1607,1726
"3883","Hatfield","Hampshire County County","MA","Hatfield",1994,112,1608,1720
"3884","Hatfield","Hampshire County County","MA","Hatfield",1995,69,1645,1714
"3885","Hatfield","Hampshire County County","MA","Hatfield",1996,59,1674,1733
"3886","Hatfield","Hampshire County County","MA","Hatfield",1997,56,1706,1762
"3887","Hatfield","Hampshire County County","MA","Hatfield",1998,54,1709,1763
"3888","Hatfield","Hampshire County County","MA","Hatfield",1999,55,1727,1782
"3889","Hatfield","Hampshire County County","MA","Hatfield",2000,46,1977,2023
"3890","Hatfield","Hampshire County County","MA","Hatfield",2001,49,1985,2034
"3891","Hatfield","Hampshire County County","MA","Hatfield",2002,76,1991,2067
"3892","Hatfield","Hampshire County County","MA","Hatfield",2003,90,1976,2066
"3893","Hatfield","Hampshire County County","MA","Hatfield",2004,89,1970,2059
"3894","Hatfield","Hampshire County County","MA","Hatfield",2005,80,1964,2044
"3895","Hatfield","Hampshire County County","MA","Hatfield",2006,76,1964,2040
"3896","Hatfield","Hampshire County County","MA","Hatfield",2007,81,1967,2048
"3897","Hatfield","Hampshire County County","MA","Hatfield",2008,82,1931,2013
"3898","Hatfield","Hampshire County County","MA","Hatfield",2009,118,1855,1973
"3899","Hatfield","Hampshire County County","MA","Hatfield",2010,118,1878,1996
"3900","Hatfield","Hampshire County County","MA","Hatfield",2011,114,1854,1968
"3901","Hatfield","Hampshire County County","MA","Hatfield",2012,110,1855,1965
"3902","Haverhill","Essex County County","MA","Haverhill",1990,1891,24679,26570
"3903","Haverhill","Essex County County","MA","Haverhill",1991,2698,24289,26987
"3904","Haverhill","Essex County County","MA","Haverhill",1992,2613,24545,27158
"3905","Haverhill","Essex County County","MA","Haverhill",1993,2368,24982,27350
"3906","Haverhill","Essex County County","MA","Haverhill",1994,2079,25460,27539
"3907","Haverhill","Essex County County","MA","Haverhill",1995,1700,26091,27791
"3908","Haverhill","Essex County County","MA","Haverhill",1996,1415,26976,28391
"3909","Haverhill","Essex County County","MA","Haverhill",1997,1503,27403,28906
"3910","Haverhill","Essex County County","MA","Haverhill",1998,1278,27881,29159
"3911","Haverhill","Essex County County","MA","Haverhill",1999,1190,28610,29800
"3912","Haverhill","Essex County County","MA","Haverhill",2000,840,30749,31589
"3913","Haverhill","Essex County County","MA","Haverhill",2001,1322,30534,31856
"3914","Haverhill","Essex County County","MA","Haverhill",2002,2038,29624,31662
"3915","Haverhill","Essex County County","MA","Haverhill",2003,2052,29189,31241
"3916","Haverhill","Essex County County","MA","Haverhill",2004,1783,28897,30680
"3917","Haverhill","Essex County County","MA","Haverhill",2005,1630,29018,30648
"3918","Haverhill","Essex County County","MA","Haverhill",2006,1542,29252,30794
"3919","Haverhill","Essex County County","MA","Haverhill",2007,1478,29162,30640
"3920","Haverhill","Essex County County","MA","Haverhill",2008,1852,29391,31243
"3921","Haverhill","Essex County County","MA","Haverhill",2009,2878,28571,31449
"3922","Haverhill","Essex County County","MA","Haverhill",2010,2885,28946,31831
"3923","Haverhill","Essex County County","MA","Haverhill",2011,2600,29316,31916
"3924","Haverhill","Essex County County","MA","Haverhill",2012,2328,29701,32029
"3925","Hawley","Franklin County County","MA","Hawley",1990,6,146,152
"3926","Hawley","Franklin County County","MA","Hawley",1991,11,140,151
"3927","Hawley","Franklin County County","MA","Hawley",1992,9,134,143
"3928","Hawley","Franklin County County","MA","Hawley",1993,10,130,140
"3929","Hawley","Franklin County County","MA","Hawley",1994,8,126,134
"3930","Hawley","Franklin County County","MA","Hawley",1995,11,155,166
"3931","Hawley","Franklin County County","MA","Hawley",1996,7,154,161
"3932","Hawley","Franklin County County","MA","Hawley",1997,7,157,164
"3933","Hawley","Franklin County County","MA","Hawley",1998,6,159,165
"3934","Hawley","Franklin County County","MA","Hawley",1999,4,162,166
"3935","Hawley","Franklin County County","MA","Hawley",2000,4,166,170
"3936","Hawley","Franklin County County","MA","Hawley",2001,5,167,172
"3937","Hawley","Franklin County County","MA","Hawley",2002,9,168,177
"3938","Hawley","Franklin County County","MA","Hawley",2003,11,171,182
"3939","Hawley","Franklin County County","MA","Hawley",2004,7,169,176
"3940","Hawley","Franklin County County","MA","Hawley",2005,7,168,175
"3941","Hawley","Franklin County County","MA","Hawley",2006,7,168,175
"3942","Hawley","Franklin County County","MA","Hawley",2007,7,164,171
"3943","Hawley","Franklin County County","MA","Hawley",2008,8,162,170
"3944","Hawley","Franklin County County","MA","Hawley",2009,10,157,167
"3945","Hawley","Franklin County County","MA","Hawley",2010,12,159,171
"3946","Hawley","Franklin County County","MA","Hawley",2011,12,160,172
"3947","Hawley","Franklin County County","MA","Hawley",2012,11,161,172
"3948","Heath","Franklin County County","MA","Heath",1990,9,335,344
"3949","Heath","Franklin County County","MA","Heath",1991,14,341,355
"3950","Heath","Franklin County County","MA","Heath",1992,13,323,336
"3951","Heath","Franklin County County","MA","Heath",1993,14,329,343
"3952","Heath","Franklin County County","MA","Heath",1994,14,340,354
"3953","Heath","Franklin County County","MA","Heath",1995,12,352,364
"3954","Heath","Franklin County County","MA","Heath",1996,12,354,366
"3955","Heath","Franklin County County","MA","Heath",1997,9,361,370
"3956","Heath","Franklin County County","MA","Heath",1998,11,369,380
"3957","Heath","Franklin County County","MA","Heath",1999,12,377,389
"3958","Heath","Franklin County County","MA","Heath",2000,8,459,467
"3959","Heath","Franklin County County","MA","Heath",2001,10,457,467
"3960","Heath","Franklin County County","MA","Heath",2002,14,463,477
"3961","Heath","Franklin County County","MA","Heath",2003,17,463,480
"3962","Heath","Franklin County County","MA","Heath",2004,16,456,472
"3963","Heath","Franklin County County","MA","Heath",2005,14,454,468
"3964","Heath","Franklin County County","MA","Heath",2006,18,455,473
"3965","Heath","Franklin County County","MA","Heath",2007,17,449,466
"3966","Heath","Franklin County County","MA","Heath",2008,23,443,466
"3967","Heath","Franklin County County","MA","Heath",2009,26,429,455
"3968","Heath","Franklin County County","MA","Heath",2010,29,387,416
"3969","Heath","Franklin County County","MA","Heath",2011,25,388,413
"3970","Heath","Franklin County County","MA","Heath",2012,21,389,410
"3971","Hingham","Plymouth County County","MA","Hingham",1990,448,10063,10511
"3972","Hingham","Plymouth County County","MA","Hingham",1991,621,9761,10382
"3973","Hingham","Plymouth County County","MA","Hingham",1992,630,9647,10277
"3974","Hingham","Plymouth County County","MA","Hingham",1993,489,9796,10285
"3975","Hingham","Plymouth County County","MA","Hingham",1994,439,9982,10421
"3976","Hingham","Plymouth County County","MA","Hingham",1995,357,10137,10494
"3977","Hingham","Plymouth County County","MA","Hingham",1996,333,10353,10686
"3978","Hingham","Plymouth County County","MA","Hingham",1997,296,10628,10924
"3979","Hingham","Plymouth County County","MA","Hingham",1998,221,10803,11024
"3980","Hingham","Plymouth County County","MA","Hingham",1999,215,10938,11153
"3981","Hingham","Plymouth County County","MA","Hingham",2000,206,9969,10175
"3982","Hingham","Plymouth County County","MA","Hingham",2001,272,10005,10277
"3983","Hingham","Plymouth County County","MA","Hingham",2002,411,9877,10288
"3984","Hingham","Plymouth County County","MA","Hingham",2003,450,9798,10248
"3985","Hingham","Plymouth County County","MA","Hingham",2004,411,10210,10621
"3986","Hingham","Plymouth County County","MA","Hingham",2005,363,10468,10831
"3987","Hingham","Plymouth County County","MA","Hingham",2006,385,10393,10778
"3988","Hingham","Plymouth County County","MA","Hingham",2007,366,10821,11187
"3989","Hingham","Plymouth County County","MA","Hingham",2008,452,10864,11316
"3990","Hingham","Plymouth County County","MA","Hingham",2009,698,10827,11525
"3991","Hingham","Plymouth County County","MA","Hingham",2010,673,10446,11119
"3992","Hingham","Plymouth County County","MA","Hingham",2011,557,10548,11105
"3993","Hingham","Plymouth County County","MA","Hingham",2012,532,10664,11196
"3994","Hinsdale","Berkshire County County","MA","Hinsdale",1990,82,938,1020
"3995","Hinsdale","Berkshire County County","MA","Hinsdale",1991,118,904,1022
"3996","Hinsdale","Berkshire County County","MA","Hinsdale",1992,148,901,1049
"3997","Hinsdale","Berkshire County County","MA","Hinsdale",1993,113,909,1022
"3998","Hinsdale","Berkshire County County","MA","Hinsdale",1994,109,905,1014
"3999","Hinsdale","Berkshire County County","MA","Hinsdale",1995,74,850,924
"4000","Hinsdale","Berkshire County County","MA","Hinsdale",1996,75,862,937
"4001","Hinsdale","Berkshire County County","MA","Hinsdale",1997,72,868,940
"4002","Hinsdale","Berkshire County County","MA","Hinsdale",1998,62,865,927
"4003","Hinsdale","Berkshire County County","MA","Hinsdale",1999,67,866,933
"4004","Hinsdale","Berkshire County County","MA","Hinsdale",2000,37,995,1032
"4005","Hinsdale","Berkshire County County","MA","Hinsdale",2001,46,992,1038
"4006","Hinsdale","Berkshire County County","MA","Hinsdale",2002,61,1003,1064
"4007","Hinsdale","Berkshire County County","MA","Hinsdale",2003,61,995,1056
"4008","Hinsdale","Berkshire County County","MA","Hinsdale",2004,50,991,1041
"4009","Hinsdale","Berkshire County County","MA","Hinsdale",2005,46,1002,1048
"4010","Hinsdale","Berkshire County County","MA","Hinsdale",2006,49,1012,1061
"4011","Hinsdale","Berkshire County County","MA","Hinsdale",2007,48,1097,1145
"4012","Hinsdale","Berkshire County County","MA","Hinsdale",2008,75,1076,1151
"4013","Hinsdale","Berkshire County County","MA","Hinsdale",2009,119,1044,1163
"4014","Hinsdale","Berkshire County County","MA","Hinsdale",2010,130,1072,1202
"4015","Hinsdale","Berkshire County County","MA","Hinsdale",2011,115,1082,1197
"4016","Hinsdale","Berkshire County County","MA","Hinsdale",2012,99,1077,1176
"4017","Holbrook","Norfolk County County","MA","Holbrook",1990,382,5711,6093
"4018","Holbrook","Norfolk County County","MA","Holbrook",1991,546,5512,6058
"4019","Holbrook","Norfolk County County","MA","Holbrook",1992,585,5490,6075
"4020","Holbrook","Norfolk County County","MA","Holbrook",1993,503,5550,6053
"4021","Holbrook","Norfolk County County","MA","Holbrook",1994,357,5651,6008
"4022","Holbrook","Norfolk County County","MA","Holbrook",1995,315,5685,6000
"4023","Holbrook","Norfolk County County","MA","Holbrook",1996,271,5786,6057
"4024","Holbrook","Norfolk County County","MA","Holbrook",1997,252,5917,6169
"4025","Holbrook","Norfolk County County","MA","Holbrook",1998,185,5995,6180
"4026","Holbrook","Norfolk County County","MA","Holbrook",1999,181,6058,6239
"4027","Holbrook","Norfolk County County","MA","Holbrook",2000,170,5658,5828
"4028","Holbrook","Norfolk County County","MA","Holbrook",2001,210,5642,5852
"4029","Holbrook","Norfolk County County","MA","Holbrook",2002,315,5558,5873
"4030","Holbrook","Norfolk County County","MA","Holbrook",2003,350,5478,5828
"4031","Holbrook","Norfolk County County","MA","Holbrook",2004,331,5472,5803
"4032","Holbrook","Norfolk County County","MA","Holbrook",2005,322,5499,5821
"4033","Holbrook","Norfolk County County","MA","Holbrook",2006,341,5389,5730
"4034","Holbrook","Norfolk County County","MA","Holbrook",2007,320,5414,5734
"4035","Holbrook","Norfolk County County","MA","Holbrook",2008,341,5407,5748
"4036","Holbrook","Norfolk County County","MA","Holbrook",2009,517,5226,5743
"4037","Holbrook","Norfolk County County","MA","Holbrook",2010,537,5334,5871
"4038","Holbrook","Norfolk County County","MA","Holbrook",2011,470,5394,5864
"4039","Holbrook","Norfolk County County","MA","Holbrook",2012,414,5453,5867
"4040","Holden","Worcester County County","MA","Holden",1990,383,7469,7852
"4041","Holden","Worcester County County","MA","Holden",1991,565,7261,7826
"4042","Holden","Worcester County County","MA","Holden",1992,535,7335,7870
"4043","Holden","Worcester County County","MA","Holden",1993,401,7568,7969
"4044","Holden","Worcester County County","MA","Holden",1994,324,7764,8088
"4045","Holden","Worcester County County","MA","Holden",1995,269,7568,7837
"4046","Holden","Worcester County County","MA","Holden",1996,220,7691,7911
"4047","Holden","Worcester County County","MA","Holden",1997,208,7902,8110
"4048","Holden","Worcester County County","MA","Holden",1998,184,8080,8264
"4049","Holden","Worcester County County","MA","Holden",1999,201,8087,8288
"4050","Holden","Worcester County County","MA","Holden",2000,179,8185,8364
"4051","Holden","Worcester County County","MA","Holden",2001,232,8255,8487
"4052","Holden","Worcester County County","MA","Holden",2002,373,8230,8603
"4053","Holden","Worcester County County","MA","Holden",2003,428,8302,8730
"4054","Holden","Worcester County County","MA","Holden",2004,410,8369,8779
"4055","Holden","Worcester County County","MA","Holden",2005,362,8342,8704
"4056","Holden","Worcester County County","MA","Holden",2006,365,8723,9088
"4057","Holden","Worcester County County","MA","Holden",2007,355,8846,9201
"4058","Holden","Worcester County County","MA","Holden",2008,410,8685,9095
"4059","Holden","Worcester County County","MA","Holden",2009,669,8467,9136
"4060","Holden","Worcester County County","MA","Holden",2010,651,8348,8999
"4061","Holden","Worcester County County","MA","Holden",2011,557,8423,8980
"4062","Holden","Worcester County County","MA","Holden",2012,517,8420,8937
"4063","Holland","Hampden County County","MA","Holland",1990,55,1084,1139
"4064","Holland","Hampden County County","MA","Holland",1991,89,1112,1201
"4065","Holland","Hampden County County","MA","Holland",1992,85,981,1066
"4066","Holland","Hampden County County","MA","Holland",1993,89,1009,1098
"4067","Holland","Hampden County County","MA","Holland",1994,93,1018,1111
"4068","Holland","Hampden County County","MA","Holland",1995,58,987,1045
"4069","Holland","Hampden County County","MA","Holland",1996,56,994,1050
"4070","Holland","Hampden County County","MA","Holland",1997,48,1009,1057
"4071","Holland","Hampden County County","MA","Holland",1998,39,1015,1054
"4072","Holland","Hampden County County","MA","Holland",1999,38,1005,1043
"4073","Holland","Hampden County County","MA","Holland",2000,40,1350,1390
"4074","Holland","Hampden County County","MA","Holland",2001,49,1344,1393
"4075","Holland","Hampden County County","MA","Holland",2002,67,1340,1407
"4076","Holland","Hampden County County","MA","Holland",2003,84,1345,1429
"4077","Holland","Hampden County County","MA","Holland",2004,76,1346,1422
"4078","Holland","Hampden County County","MA","Holland",2005,70,1369,1439
"4079","Holland","Hampden County County","MA","Holland",2006,80,1388,1468
"4080","Holland","Hampden County County","MA","Holland",2007,77,1393,1470
"4081","Holland","Hampden County County","MA","Holland",2008,91,1354,1445
"4082","Holland","Hampden County County","MA","Holland",2009,122,1321,1443
"4083","Holland","Hampden County County","MA","Holland",2010,134,1282,1416
"4084","Holland","Hampden County County","MA","Holland",2011,112,1290,1402
"4085","Holland","Hampden County County","MA","Holland",2012,109,1290,1399
"4086","Holliston","Middlesex County County","MA","Holliston",1990,371,7133,7504
"4087","Holliston","Middlesex County County","MA","Holliston",1991,506,6939,7445
"4088","Holliston","Middlesex County County","MA","Holliston",1992,483,6933,7416
"4089","Holliston","Middlesex County County","MA","Holliston",1993,345,7076,7421
"4090","Holliston","Middlesex County County","MA","Holliston",1994,314,7248,7562
"4091","Holliston","Middlesex County County","MA","Holliston",1995,281,7251,7532
"4092","Holliston","Middlesex County County","MA","Holliston",1996,220,7432,7652
"4093","Holliston","Middlesex County County","MA","Holliston",1997,214,7658,7872
"4094","Holliston","Middlesex County County","MA","Holliston",1998,179,7813,7992
"4095","Holliston","Middlesex County County","MA","Holliston",1999,173,7919,8092
"4096","Holliston","Middlesex County County","MA","Holliston",2000,155,7369,7524
"4097","Holliston","Middlesex County County","MA","Holliston",2001,208,7405,7613
"4098","Holliston","Middlesex County County","MA","Holliston",2002,353,7235,7588
"4099","Holliston","Middlesex County County","MA","Holliston",2003,359,7108,7467
"4100","Holliston","Middlesex County County","MA","Holliston",2004,308,7141,7449
"4101","Holliston","Middlesex County County","MA","Holliston",2005,267,7217,7484
"4102","Holliston","Middlesex County County","MA","Holliston",2006,267,7283,7550
"4103","Holliston","Middlesex County County","MA","Holliston",2007,252,7397,7649
"4104","Holliston","Middlesex County County","MA","Holliston",2008,296,7442,7738
"4105","Holliston","Middlesex County County","MA","Holliston",2009,493,7246,7739
"4106","Holliston","Middlesex County County","MA","Holliston",2010,452,6846,7298
"4107","Holliston","Middlesex County County","MA","Holliston",2011,410,6913,7323
"4108","Holliston","Middlesex County County","MA","Holliston",2012,366,6976,7342
"4109","Holyoke","Hampden County County","MA","Holyoke",1990,1542,16161,17703
"4110","Holyoke","Hampden County County","MA","Holyoke",1991,2117,15354,17471
"4111","Holyoke","Hampden County County","MA","Holyoke",1992,1876,15016,16892
"4112","Holyoke","Hampden County County","MA","Holyoke",1993,1688,14669,16357
"4113","Holyoke","Hampden County County","MA","Holyoke",1994,1508,14518,16026
"4114","Holyoke","Hampden County County","MA","Holyoke",1995,1428,15085,16513
"4115","Holyoke","Hampden County County","MA","Holyoke",1996,1073,15197,16270
"4116","Holyoke","Hampden County County","MA","Holyoke",1997,958,15479,16437
"4117","Holyoke","Hampden County County","MA","Holyoke",1998,952,15470,16422
"4118","Holyoke","Hampden County County","MA","Holyoke",1999,817,15445,16262
"4119","Holyoke","Hampden County County","MA","Holyoke",2000,652,15265,15917
"4120","Holyoke","Hampden County County","MA","Holyoke",2001,854,15297,16151
"4121","Holyoke","Hampden County County","MA","Holyoke",2002,1140,15200,16340
"4122","Holyoke","Hampden County County","MA","Holyoke",2003,1300,15041,16341
"4123","Holyoke","Hampden County County","MA","Holyoke",2004,1211,15037,16248
"4124","Holyoke","Hampden County County","MA","Holyoke",2005,1224,15058,16282
"4125","Holyoke","Hampden County County","MA","Holyoke",2006,1154,15087,16241
"4126","Holyoke","Hampden County County","MA","Holyoke",2007,1082,15119,16201
"4127","Holyoke","Hampden County County","MA","Holyoke",2008,1284,15064,16348
"4128","Holyoke","Hampden County County","MA","Holyoke",2009,1842,14539,16381
"4129","Holyoke","Hampden County County","MA","Holyoke",2010,1835,14389,16224
"4130","Holyoke","Hampden County County","MA","Holyoke",2011,1692,14245,15937
"4131","Holyoke","Hampden County County","MA","Holyoke",2012,1631,14254,15885
"4132","Hopedale","Worcester County County","MA","Hopedale",1990,206,2772,2978
"4133","Hopedale","Worcester County County","MA","Hopedale",1991,238,2670,2908
"4134","Hopedale","Worcester County County","MA","Hopedale",1992,227,2651,2878
"4135","Hopedale","Worcester County County","MA","Hopedale",1993,211,2703,2914
"4136","Hopedale","Worcester County County","MA","Hopedale",1994,143,2743,2886
"4137","Hopedale","Worcester County County","MA","Hopedale",1995,126,2720,2846
"4138","Hopedale","Worcester County County","MA","Hopedale",1996,106,2760,2866
"4139","Hopedale","Worcester County County","MA","Hopedale",1997,110,2826,2936
"4140","Hopedale","Worcester County County","MA","Hopedale",1998,91,2885,2976
"4141","Hopedale","Worcester County County","MA","Hopedale",1999,73,2967,3040
"4142","Hopedale","Worcester County County","MA","Hopedale",2000,73,3164,3237
"4143","Hopedale","Worcester County County","MA","Hopedale",2001,102,3201,3303
"4144","Hopedale","Worcester County County","MA","Hopedale",2002,152,3179,3331
"4145","Hopedale","Worcester County County","MA","Hopedale",2003,176,3163,3339
"4146","Hopedale","Worcester County County","MA","Hopedale",2004,151,3199,3350
"4147","Hopedale","Worcester County County","MA","Hopedale",2005,141,3260,3401
"4148","Hopedale","Worcester County County","MA","Hopedale",2006,137,3270,3407
"4149","Hopedale","Worcester County County","MA","Hopedale",2007,130,3278,3408
"4150","Hopedale","Worcester County County","MA","Hopedale",2008,164,3295,3459
"4151","Hopedale","Worcester County County","MA","Hopedale",2009,249,3195,3444
"4152","Hopedale","Worcester County County","MA","Hopedale",2010,229,2994,3223
"4153","Hopedale","Worcester County County","MA","Hopedale",2011,209,3002,3211
"4154","Hopedale","Worcester County County","MA","Hopedale",2012,182,3030,3212
"4155","Hopkinton","Middlesex County County","MA","Hopkinton",1990,253,4977,5230
"4156","Hopkinton","Middlesex County County","MA","Hopkinton",1991,364,4987,5351
"4157","Hopkinton","Middlesex County County","MA","Hopkinton",1992,364,5106,5470
"4158","Hopkinton","Middlesex County County","MA","Hopkinton",1993,310,5351,5661
"4159","Hopkinton","Middlesex County County","MA","Hopkinton",1994,247,5628,5875
"4160","Hopkinton","Middlesex County County","MA","Hopkinton",1995,242,5517,5759
"4161","Hopkinton","Middlesex County County","MA","Hopkinton",1996,192,5830,6022
"4162","Hopkinton","Middlesex County County","MA","Hopkinton",1997,175,6123,6298
"4163","Hopkinton","Middlesex County County","MA","Hopkinton",1998,151,6331,6482
"4164","Hopkinton","Middlesex County County","MA","Hopkinton",1999,145,6556,6701
"4165","Hopkinton","Middlesex County County","MA","Hopkinton",2000,141,6905,7046
"4166","Hopkinton","Middlesex County County","MA","Hopkinton",2001,219,7056,7275
"4167","Hopkinton","Middlesex County County","MA","Hopkinton",2002,342,6960,7302
"4168","Hopkinton","Middlesex County County","MA","Hopkinton",2003,363,6889,7252
"4169","Hopkinton","Middlesex County County","MA","Hopkinton",2004,302,6945,7247
"4170","Hopkinton","Middlesex County County","MA","Hopkinton",2005,275,7095,7370
"4171","Hopkinton","Middlesex County County","MA","Hopkinton",2006,254,7166,7420
"4172","Hopkinton","Middlesex County County","MA","Hopkinton",2007,241,7323,7564
"4173","Hopkinton","Middlesex County County","MA","Hopkinton",2008,302,7406,7708
"4174","Hopkinton","Middlesex County County","MA","Hopkinton",2009,464,7219,7683
"4175","Hopkinton","Middlesex County County","MA","Hopkinton",2010,496,7277,7773
"4176","Hopkinton","Middlesex County County","MA","Hopkinton",2011,395,7348,7743
"4177","Hopkinton","Middlesex County County","MA","Hopkinton",2012,369,7415,7784
"4178","Hubbardston","Worcester County County","MA","Hubbardston",1990,109,1427,1536
"4179","Hubbardston","Worcester County County","MA","Hubbardston",1991,183,1410,1593
"4180","Hubbardston","Worcester County County","MA","Hubbardston",1992,178,1482,1660
"4181","Hubbardston","Worcester County County","MA","Hubbardston",1993,155,1565,1720
"4182","Hubbardston","Worcester County County","MA","Hubbardston",1994,149,1587,1736
"4183","Hubbardston","Worcester County County","MA","Hubbardston",1995,111,1552,1663
"4184","Hubbardston","Worcester County County","MA","Hubbardston",1996,121,1566,1687
"4185","Hubbardston","Worcester County County","MA","Hubbardston",1997,104,1638,1742
"4186","Hubbardston","Worcester County County","MA","Hubbardston",1998,99,1701,1800
"4187","Hubbardston","Worcester County County","MA","Hubbardston",1999,86,1745,1831
"4188","Hubbardston","Worcester County County","MA","Hubbardston",2000,59,2177,2236
"4189","Hubbardston","Worcester County County","MA","Hubbardston",2001,88,2225,2313
"4190","Hubbardston","Worcester County County","MA","Hubbardston",2002,126,2239,2365
"4191","Hubbardston","Worcester County County","MA","Hubbardston",2003,140,2261,2401
"4192","Hubbardston","Worcester County County","MA","Hubbardston",2004,117,2282,2399
"4193","Hubbardston","Worcester County County","MA","Hubbardston",2005,119,2317,2436
"4194","Hubbardston","Worcester County County","MA","Hubbardston",2006,123,2362,2485
"4195","Hubbardston","Worcester County County","MA","Hubbardston",2007,123,2377,2500
"4196","Hubbardston","Worcester County County","MA","Hubbardston",2008,135,2327,2462
"4197","Hubbardston","Worcester County County","MA","Hubbardston",2009,221,2274,2495
"4198","Hubbardston","Worcester County County","MA","Hubbardston",2010,210,2234,2444
"4199","Hubbardston","Worcester County County","MA","Hubbardston",2011,183,2253,2436
"4200","Hubbardston","Worcester County County","MA","Hubbardston",2012,151,2253,2404
"4201","Hudson","Middlesex County County","MA","Hudson",1990,582,9677,10259
"4202","Hudson","Middlesex County County","MA","Hudson",1991,819,9381,10200
"4203","Hudson","Middlesex County County","MA","Hudson",1992,922,9310,10232
"4204","Hudson","Middlesex County County","MA","Hudson",1993,691,9441,10132
"4205","Hudson","Middlesex County County","MA","Hudson",1994,658,9590,10248
"4206","Hudson","Middlesex County County","MA","Hudson",1995,529,9801,10330
"4207","Hudson","Middlesex County County","MA","Hudson",1996,420,10001,10421
"4208","Hudson","Middlesex County County","MA","Hudson",1997,403,10245,10648
"4209","Hudson","Middlesex County County","MA","Hudson",1998,318,10430,10748
"4210","Hudson","Middlesex County County","MA","Hudson",1999,383,10565,10948
"4211","Hudson","Middlesex County County","MA","Hudson",2000,265,10420,10685
"4212","Hudson","Middlesex County County","MA","Hudson",2001,398,10444,10842
"4213","Hudson","Middlesex County County","MA","Hudson",2002,624,10226,10850
"4214","Hudson","Middlesex County County","MA","Hudson",2003,607,10060,10667
"4215","Hudson","Middlesex County County","MA","Hudson",2004,528,10358,10886
"4216","Hudson","Middlesex County County","MA","Hudson",2005,480,10643,11123
"4217","Hudson","Middlesex County County","MA","Hudson",2006,496,10989,11485
"4218","Hudson","Middlesex County County","MA","Hudson",2007,481,11200,11681
"4219","Hudson","Middlesex County County","MA","Hudson",2008,578,11312,11890
"4220","Hudson","Middlesex County County","MA","Hudson",2009,925,11010,11935
"4221","Hudson","Middlesex County County","MA","Hudson",2010,802,10386,11188
"4222","Hudson","Middlesex County County","MA","Hudson",2011,748,10490,11238
"4223","Hudson","Middlesex County County","MA","Hudson",2012,652,10585,11237
"4224","Hull","Plymouth County County","MA","Hull",1990,407,5386,5793
"4225","Hull","Plymouth County County","MA","Hull",1991,627,5216,5843
"4226","Hull","Plymouth County County","MA","Hull",1992,599,5235,5834
"4227","Hull","Plymouth County County","MA","Hull",1993,478,5350,5828
"4228","Hull","Plymouth County County","MA","Hull",1994,437,5422,5859
"4229","Hull","Plymouth County County","MA","Hull",1995,417,5323,5740
"4230","Hull","Plymouth County County","MA","Hull",1996,314,5422,5736
"4231","Hull","Plymouth County County","MA","Hull",1997,314,5556,5870
"4232","Hull","Plymouth County County","MA","Hull",1998,248,5642,5890
"4233","Hull","Plymouth County County","MA","Hull",1999,237,5703,5940
"4234","Hull","Plymouth County County","MA","Hull",2000,197,6091,6288
"4235","Hull","Plymouth County County","MA","Hull",2001,231,6134,6365
"4236","Hull","Plymouth County County","MA","Hull",2002,349,6096,6445
"4237","Hull","Plymouth County County","MA","Hull",2003,425,5997,6422
"4238","Hull","Plymouth County County","MA","Hull",2004,361,5987,6348
"4239","Hull","Plymouth County County","MA","Hull",2005,305,6029,6334
"4240","Hull","Plymouth County County","MA","Hull",2006,300,5871,6171
"4241","Hull","Plymouth County County","MA","Hull",2007,304,5876,6180
"4242","Hull","Plymouth County County","MA","Hull",2008,364,5859,6223
"4243","Hull","Plymouth County County","MA","Hull",2009,540,5673,6213
"4244","Hull","Plymouth County County","MA","Hull",2010,524,5329,5853
"4245","Hull","Plymouth County County","MA","Hull",2011,440,5381,5821
"4246","Hull","Plymouth County County","MA","Hull",2012,407,5440,5847
"4247","Huntington","Hampshire County County","MA","Huntington",1990,82,972,1054
"4248","Huntington","Hampshire County County","MA","Huntington",1991,115,961,1076
"4249","Huntington","Hampshire County County","MA","Huntington",1992,120,975,1095
"4250","Huntington","Hampshire County County","MA","Huntington",1993,98,1005,1103
"4251","Huntington","Hampshire County County","MA","Huntington",1994,92,1011,1103
"4252","Huntington","Hampshire County County","MA","Huntington",1995,83,1007,1090
"4253","Huntington","Hampshire County County","MA","Huntington",1996,53,1025,1078
"4254","Huntington","Hampshire County County","MA","Huntington",1997,47,1047,1094
"4255","Huntington","Hampshire County County","MA","Huntington",1998,41,1057,1098
"4256","Huntington","Hampshire County County","MA","Huntington",1999,45,1065,1110
"4257","Huntington","Hampshire County County","MA","Huntington",2000,37,1215,1252
"4258","Huntington","Hampshire County County","MA","Huntington",2001,42,1216,1258
"4259","Huntington","Hampshire County County","MA","Huntington",2002,69,1209,1278
"4260","Huntington","Hampshire County County","MA","Huntington",2003,72,1206,1278
"4261","Huntington","Hampshire County County","MA","Huntington",2004,60,1202,1262
"4262","Huntington","Hampshire County County","MA","Huntington",2005,69,1199,1268
"4263","Huntington","Hampshire County County","MA","Huntington",2006,53,1218,1271
"4264","Huntington","Hampshire County County","MA","Huntington",2007,59,1217,1276
"4265","Huntington","Hampshire County County","MA","Huntington",2008,68,1220,1288
"4266","Huntington","Hampshire County County","MA","Huntington",2009,118,1166,1284
"4267","Huntington","Hampshire County County","MA","Huntington",2010,115,1147,1262
"4268","Huntington","Hampshire County County","MA","Huntington",2011,104,1134,1238
"4269","Huntington","Hampshire County County","MA","Huntington",2012,104,1135,1239
"4270","Ipswich","Essex County County","MA","Ipswich",1990,328,6285,6613
"4271","Ipswich","Essex County County","MA","Ipswich",1991,426,6116,6542
"4272","Ipswich","Essex County County","MA","Ipswich",1992,421,6111,6532
"4273","Ipswich","Essex County County","MA","Ipswich",1993,352,6268,6620
"4274","Ipswich","Essex County County","MA","Ipswich",1994,301,6433,6734
"4275","Ipswich","Essex County County","MA","Ipswich",1995,264,6391,6655
"4276","Ipswich","Essex County County","MA","Ipswich",1996,255,6564,6819
"4277","Ipswich","Essex County County","MA","Ipswich",1997,224,6780,7004
"4278","Ipswich","Essex County County","MA","Ipswich",1998,205,6953,7158
"4279","Ipswich","Essex County County","MA","Ipswich",1999,189,7071,7260
"4280","Ipswich","Essex County County","MA","Ipswich",2000,163,7144,7307
"4281","Ipswich","Essex County County","MA","Ipswich",2001,225,7206,7431
"4282","Ipswich","Essex County County","MA","Ipswich",2002,310,7129,7439
"4283","Ipswich","Essex County County","MA","Ipswich",2003,386,7057,7443
"4284","Ipswich","Essex County County","MA","Ipswich",2004,319,7055,7374
"4285","Ipswich","Essex County County","MA","Ipswich",2005,306,7096,7402
"4286","Ipswich","Essex County County","MA","Ipswich",2006,282,7001,7283
"4287","Ipswich","Essex County County","MA","Ipswich",2007,274,7041,7315
"4288","Ipswich","Essex County County","MA","Ipswich",2008,310,7039,7349
"4289","Ipswich","Essex County County","MA","Ipswich",2009,503,6827,7330
"4290","Ipswich","Essex County County","MA","Ipswich",2010,491,6808,7299
"4291","Ipswich","Essex County County","MA","Ipswich",2011,450,6891,7341
"4292","Ipswich","Essex County County","MA","Ipswich",2012,411,6967,7378
"4293","Kingston","Plymouth County County","MA","Kingston",1990,326,4718,5044
"4294","Kingston","Plymouth County County","MA","Kingston",1991,397,4610,5007
"4295","Kingston","Plymouth County County","MA","Kingston",1992,477,4794,5271
"4296","Kingston","Plymouth County County","MA","Kingston",1993,412,5015,5427
"4297","Kingston","Plymouth County County","MA","Kingston",1994,324,5208,5532
"4298","Kingston","Plymouth County County","MA","Kingston",1995,291,5276,5567
"4299","Kingston","Plymouth County County","MA","Kingston",1996,282,5443,5725
"4300","Kingston","Plymouth County County","MA","Kingston",1997,222,5698,5920
"4301","Kingston","Plymouth County County","MA","Kingston",1998,174,5910,6084
"4302","Kingston","Plymouth County County","MA","Kingston",1999,171,6100,6271
"4303","Kingston","Plymouth County County","MA","Kingston",2000,155,5965,6120
"4304","Kingston","Plymouth County County","MA","Kingston",2001,190,6018,6208
"4305","Kingston","Plymouth County County","MA","Kingston",2002,253,5988,6241
"4306","Kingston","Plymouth County County","MA","Kingston",2003,316,5940,6256
"4307","Kingston","Plymouth County County","MA","Kingston",2004,307,5997,6304
"4308","Kingston","Plymouth County County","MA","Kingston",2005,277,6116,6393
"4309","Kingston","Plymouth County County","MA","Kingston",2006,290,6003,6293
"4310","Kingston","Plymouth County County","MA","Kingston",2007,285,6025,6310
"4311","Kingston","Plymouth County County","MA","Kingston",2008,336,6016,6352
"4312","Kingston","Plymouth County County","MA","Kingston",2009,548,5848,6396
"4313","Kingston","Plymouth County County","MA","Kingston",2010,524,6005,6529
"4314","Kingston","Plymouth County County","MA","Kingston",2011,458,6063,6521
"4315","Kingston","Plymouth County County","MA","Kingston",2012,383,6130,6513
"4316","Lakeville","Plymouth County County","MA","Lakeville",1990,204,3844,4048
"4317","Lakeville","Plymouth County County","MA","Lakeville",1991,356,3780,4136
"4318","Lakeville","Plymouth County County","MA","Lakeville",1992,432,3821,4253
"4319","Lakeville","Plymouth County County","MA","Lakeville",1993,315,4079,4394
"4320","Lakeville","Plymouth County County","MA","Lakeville",1994,291,4385,4676
"4321","Lakeville","Plymouth County County","MA","Lakeville",1995,279,4236,4515
"4322","Lakeville","Plymouth County County","MA","Lakeville",1996,225,4311,4536
"4323","Lakeville","Plymouth County County","MA","Lakeville",1997,209,4485,4694
"4324","Lakeville","Plymouth County County","MA","Lakeville",1998,168,4590,4758
"4325","Lakeville","Plymouth County County","MA","Lakeville",1999,173,4732,4905
"4326","Lakeville","Plymouth County County","MA","Lakeville",2000,132,5358,5490
"4327","Lakeville","Plymouth County County","MA","Lakeville",2001,176,5465,5641
"4328","Lakeville","Plymouth County County","MA","Lakeville",2002,246,5529,5775
"4329","Lakeville","Plymouth County County","MA","Lakeville",2003,295,5560,5855
"4330","Lakeville","Plymouth County County","MA","Lakeville",2004,303,5549,5852
"4331","Lakeville","Plymouth County County","MA","Lakeville",2005,268,5704,5972
"4332","Lakeville","Plymouth County County","MA","Lakeville",2006,264,5775,6039
"4333","Lakeville","Plymouth County County","MA","Lakeville",2007,257,5796,6053
"4334","Lakeville","Plymouth County County","MA","Lakeville",2008,324,5749,6073
"4335","Lakeville","Plymouth County County","MA","Lakeville",2009,509,5590,6099
"4336","Lakeville","Plymouth County County","MA","Lakeville",2010,516,5553,6069
"4337","Lakeville","Plymouth County County","MA","Lakeville",2011,441,5634,6075
"4338","Lakeville","Plymouth County County","MA","Lakeville",2012,391,5617,6008
"4339","Lancaster","Worcester County County","MA","Lancaster",1990,168,3357,3525
"4340","Lancaster","Worcester County County","MA","Lancaster",1991,224,3240,3464
"4341","Lancaster","Worcester County County","MA","Lancaster",1992,219,3195,3414
"4342","Lancaster","Worcester County County","MA","Lancaster",1993,175,3233,3408
"4343","Lancaster","Worcester County County","MA","Lancaster",1994,178,3243,3421
"4344","Lancaster","Worcester County County","MA","Lancaster",1995,167,3260,3427
"4345","Lancaster","Worcester County County","MA","Lancaster",1996,124,3338,3462
"4346","Lancaster","Worcester County County","MA","Lancaster",1997,115,3458,3573
"4347","Lancaster","Worcester County County","MA","Lancaster",1998,85,3465,3550
"4348","Lancaster","Worcester County County","MA","Lancaster",1999,93,3531,3624
"4349","Lancaster","Worcester County County","MA","Lancaster",2000,81,2807,2888
"4350","Lancaster","Worcester County County","MA","Lancaster",2001,126,2787,2913
"4351","Lancaster","Worcester County County","MA","Lancaster",2002,183,2797,2980
"4352","Lancaster","Worcester County County","MA","Lancaster",2003,209,2808,3017
"4353","Lancaster","Worcester County County","MA","Lancaster",2004,200,2850,3050
"4354","Lancaster","Worcester County County","MA","Lancaster",2005,166,2887,3053
"4355","Lancaster","Worcester County County","MA","Lancaster",2006,172,2978,3150
"4356","Lancaster","Worcester County County","MA","Lancaster",2007,158,3008,3166
"4357","Lancaster","Worcester County County","MA","Lancaster",2008,174,2908,3082
"4358","Lancaster","Worcester County County","MA","Lancaster",2009,284,2830,3114
"4359","Lancaster","Worcester County County","MA","Lancaster",2010,311,3252,3563
"4360","Lancaster","Worcester County County","MA","Lancaster",2011,258,3279,3537
"4361","Lancaster","Worcester County County","MA","Lancaster",2012,241,3277,3518
"4362","Lanesborough","Berkshire County County","MA","Lanesborough",1990,103,1591,1694
"4363","Lanesborough","Berkshire County County","MA","Lanesborough",1991,176,1522,1698
"4364","Lanesborough","Berkshire County County","MA","Lanesborough",1992,140,1480,1620
"4365","Lanesborough","Berkshire County County","MA","Lanesborough",1993,120,1502,1622
"4366","Lanesborough","Berkshire County County","MA","Lanesborough",1994,123,1472,1595
"4367","Lanesborough","Berkshire County County","MA","Lanesborough",1995,91,1509,1600
"4368","Lanesborough","Berkshire County County","MA","Lanesborough",1996,80,1537,1617
"4369","Lanesborough","Berkshire County County","MA","Lanesborough",1997,76,1556,1632
"4370","Lanesborough","Berkshire County County","MA","Lanesborough",1998,65,1560,1625
"4371","Lanesborough","Berkshire County County","MA","Lanesborough",1999,57,1567,1624
"4372","Lanesborough","Berkshire County County","MA","Lanesborough",2000,41,1695,1736
"4373","Lanesborough","Berkshire County County","MA","Lanesborough",2001,45,1694,1739
"4374","Lanesborough","Berkshire County County","MA","Lanesborough",2002,72,1720,1792
"4375","Lanesborough","Berkshire County County","MA","Lanesborough",2003,79,1711,1790
"4376","Lanesborough","Berkshire County County","MA","Lanesborough",2004,75,1714,1789
"4377","Lanesborough","Berkshire County County","MA","Lanesborough",2005,67,1737,1804
"4378","Lanesborough","Berkshire County County","MA","Lanesborough",2006,68,1757,1825
"4379","Lanesborough","Berkshire County County","MA","Lanesborough",2007,74,1743,1817
"4380","Lanesborough","Berkshire County County","MA","Lanesborough",2008,93,1716,1809
"4381","Lanesborough","Berkshire County County","MA","Lanesborough",2009,136,1661,1797
"4382","Lanesborough","Berkshire County County","MA","Lanesborough",2010,155,1735,1890
"4383","Lanesborough","Berkshire County County","MA","Lanesborough",2011,127,1751,1878
"4384","Lanesborough","Berkshire County County","MA","Lanesborough",2012,121,1743,1864
"4385","Lawrence","Essex County County","MA","Lawrence",1990,3333,24601,27934
"4386","Lawrence","Essex County County","MA","Lawrence",1991,4184,23502,27686
"4387","Lawrence","Essex County County","MA","Lawrence",1992,3982,22833,26815
"4388","Lawrence","Essex County County","MA","Lawrence",1993,3704,22566,26270
"4389","Lawrence","Essex County County","MA","Lawrence",1994,3304,22354,25658
"4390","Lawrence","Essex County County","MA","Lawrence",1995,2869,24854,27723
"4391","Lawrence","Essex County County","MA","Lawrence",1996,2774,25347,28121
"4392","Lawrence","Essex County County","MA","Lawrence",1997,2534,25554,28088
"4393","Lawrence","Essex County County","MA","Lawrence",1998,2475,25850,28325
"4394","Lawrence","Essex County County","MA","Lawrence",1999,2406,26495,28901
"4395","Lawrence","Essex County County","MA","Lawrence",2000,1578,26831,28409
"4396","Lawrence","Essex County County","MA","Lawrence",2001,2567,26733,29300
"4397","Lawrence","Essex County County","MA","Lawrence",2002,3683,26276,29959
"4398","Lawrence","Essex County County","MA","Lawrence",2003,3663,26156,29819
"4399","Lawrence","Essex County County","MA","Lawrence",2004,3269,26086,29355
"4400","Lawrence","Essex County County","MA","Lawrence",2005,2921,26122,29043
"4401","Lawrence","Essex County County","MA","Lawrence",2006,2803,26225,29028
"4402","Lawrence","Essex County County","MA","Lawrence",2007,2616,26325,28941
"4403","Lawrence","Essex County County","MA","Lawrence",2008,3156,26182,29338
"4404","Lawrence","Essex County County","MA","Lawrence",2009,4801,25482,30283
"4405","Lawrence","Essex County County","MA","Lawrence",2010,5087,26657,31744
"4406","Lawrence","Essex County County","MA","Lawrence",2011,5074,27182,32256
"4407","Lawrence","Essex County County","MA","Lawrence",2012,4646,27555,32201
"4408","Lee","Berkshire County County","MA","Lee",1990,189,2948,3137
"4409","Lee","Berkshire County County","MA","Lee",1991,306,2780,3086
"4410","Lee","Berkshire County County","MA","Lee",1992,349,2718,3067
"4411","Lee","Berkshire County County","MA","Lee",1993,274,2776,3050
"4412","Lee","Berkshire County County","MA","Lee",1994,234,2755,2989
"4413","Lee","Berkshire County County","MA","Lee",1995,207,2753,2960
"4414","Lee","Berkshire County County","MA","Lee",1996,153,2794,2947
"4415","Lee","Berkshire County County","MA","Lee",1997,151,2811,2962
"4416","Lee","Berkshire County County","MA","Lee",1998,121,2798,2919
"4417","Lee","Berkshire County County","MA","Lee",1999,110,2805,2915
"4418","Lee","Berkshire County County","MA","Lee",2000,89,3411,3500
"4419","Lee","Berkshire County County","MA","Lee",2001,108,3516,3624
"4420","Lee","Berkshire County County","MA","Lee",2002,149,3600,3749
"4421","Lee","Berkshire County County","MA","Lee",2003,175,3603,3778
"4422","Lee","Berkshire County County","MA","Lee",2004,157,3574,3731
"4423","Lee","Berkshire County County","MA","Lee",2005,131,3640,3771
"4424","Lee","Berkshire County County","MA","Lee",2006,154,3653,3807
"4425","Lee","Berkshire County County","MA","Lee",2007,148,3570,3718
"4426","Lee","Berkshire County County","MA","Lee",2008,192,3554,3746
"4427","Lee","Berkshire County County","MA","Lee",2009,254,3440,3694
"4428","Lee","Berkshire County County","MA","Lee",2010,272,3593,3865
"4429","Lee","Berkshire County County","MA","Lee",2011,207,3612,3819
"4430","Lee","Berkshire County County","MA","Lee",2012,200,3583,3783
"4431","Leicester","Worcester County County","MA","Leicester",1990,353,5297,5650
"4432","Leicester","Worcester County County","MA","Leicester",1991,570,5042,5612
"4433","Leicester","Worcester County County","MA","Leicester",1992,536,5048,5584
"4434","Leicester","Worcester County County","MA","Leicester",1993,415,5125,5540
"4435","Leicester","Worcester County County","MA","Leicester",1994,310,5239,5549
"4436","Leicester","Worcester County County","MA","Leicester",1995,317,5326,5643
"4437","Leicester","Worcester County County","MA","Leicester",1996,268,5413,5681
"4438","Leicester","Worcester County County","MA","Leicester",1997,211,5553,5764
"4439","Leicester","Worcester County County","MA","Leicester",1998,190,5702,5892
"4440","Leicester","Worcester County County","MA","Leicester",1999,217,5701,5918
"4441","Leicester","Worcester County County","MA","Leicester",2000,157,5722,5879
"4442","Leicester","Worcester County County","MA","Leicester",2001,201,5740,5941
"4443","Leicester","Worcester County County","MA","Leicester",2002,321,5733,6054
"4444","Leicester","Worcester County County","MA","Leicester",2003,369,5722,6091
"4445","Leicester","Worcester County County","MA","Leicester",2004,328,5741,6069
"4446","Leicester","Worcester County County","MA","Leicester",2005,326,5756,6082
"4447","Leicester","Worcester County County","MA","Leicester",2006,286,5822,6108
"4448","Leicester","Worcester County County","MA","Leicester",2007,308,5853,6161
"4449","Leicester","Worcester County County","MA","Leicester",2008,351,5715,6066
"4450","Leicester","Worcester County County","MA","Leicester",2009,542,5577,6119
"4451","Leicester","Worcester County County","MA","Leicester",2010,512,5511,6023
"4452","Leicester","Worcester County County","MA","Leicester",2011,451,5560,6011
"4453","Leicester","Worcester County County","MA","Leicester",2012,426,5558,5984
"4454","Lenox","Berkshire County County","MA","Lenox",1990,150,2292,2442
"4455","Lenox","Berkshire County County","MA","Lenox",1991,216,2230,2446
"4456","Lenox","Berkshire County County","MA","Lenox",1992,218,2205,2423
"4457","Lenox","Berkshire County County","MA","Lenox",1993,169,2202,2371
"4458","Lenox","Berkshire County County","MA","Lenox",1994,153,2185,2338
"4459","Lenox","Berkshire County County","MA","Lenox",1995,173,2152,2325
"4460","Lenox","Berkshire County County","MA","Lenox",1996,118,2183,2301
"4461","Lenox","Berkshire County County","MA","Lenox",1997,99,2261,2360
"4462","Lenox","Berkshire County County","MA","Lenox",1998,89,2260,2349
"4463","Lenox","Berkshire County County","MA","Lenox",1999,83,2273,2356
"4464","Lenox","Berkshire County County","MA","Lenox",2000,72,2479,2551
"4465","Lenox","Berkshire County County","MA","Lenox",2001,76,2520,2596
"4466","Lenox","Berkshire County County","MA","Lenox",2002,100,2566,2666
"4467","Lenox","Berkshire County County","MA","Lenox",2003,111,2564,2675
"4468","Lenox","Berkshire County County","MA","Lenox",2004,116,2565,2681
"4469","Lenox","Berkshire County County","MA","Lenox",2005,112,2606,2718
"4470","Lenox","Berkshire County County","MA","Lenox",2006,109,2665,2774
"4471","Lenox","Berkshire County County","MA","Lenox",2007,100,2645,2745
"4472","Lenox","Berkshire County County","MA","Lenox",2008,115,2621,2736
"4473","Lenox","Berkshire County County","MA","Lenox",2009,183,2542,2725
"4474","Lenox","Berkshire County County","MA","Lenox",2010,181,2424,2605
"4475","Lenox","Berkshire County County","MA","Lenox",2011,149,2446,2595
"4476","Lenox","Berkshire County County","MA","Lenox",2012,136,2435,2571
"4477","Leominster","Worcester County County","MA","Leominster",1990,1581,19340,20921
"4478","Leominster","Worcester County County","MA","Leominster",1991,2082,18623,20705
"4479","Leominster","Worcester County County","MA","Leominster",1992,1869,19083,20952
"4480","Leominster","Worcester County County","MA","Leominster",1993,1633,19365,20998
"4481","Leominster","Worcester County County","MA","Leominster",1994,1440,19414,20854
"4482","Leominster","Worcester County County","MA","Leominster",1995,1368,19727,21095
"4483","Leominster","Worcester County County","MA","Leominster",1996,1164,19807,20971
"4484","Leominster","Worcester County County","MA","Leominster",1997,1007,20418,21425
"4485","Leominster","Worcester County County","MA","Leominster",1998,836,20388,21224
"4486","Leominster","Worcester County County","MA","Leominster",1999,868,20410,21278
"4487","Leominster","Worcester County County","MA","Leominster",2000,651,20630,21281
"4488","Leominster","Worcester County County","MA","Leominster",2001,956,20379,21335
"4489","Leominster","Worcester County County","MA","Leominster",2002,1395,20183,21578
"4490","Leominster","Worcester County County","MA","Leominster",2003,1473,19963,21436
"4491","Leominster","Worcester County County","MA","Leominster",2004,1359,19811,21170
"4492","Leominster","Worcester County County","MA","Leominster",2005,1231,19543,20774
"4493","Leominster","Worcester County County","MA","Leominster",2006,1193,19592,20785
"4494","Leominster","Worcester County County","MA","Leominster",2007,1134,19475,20609
"4495","Leominster","Worcester County County","MA","Leominster",2008,1329,19179,20508
"4496","Leominster","Worcester County County","MA","Leominster",2009,2107,18631,20738
"4497","Leominster","Worcester County County","MA","Leominster",2010,2193,18362,20555
"4498","Leominster","Worcester County County","MA","Leominster",2011,1960,18352,20312
"4499","Leominster","Worcester County County","MA","Leominster",2012,1769,18339,20108
"4500","Leverett","Franklin County County","MA","Leverett",1990,24,1035,1059
"4501","Leverett","Franklin County County","MA","Leverett",1991,48,1015,1063
"4502","Leverett","Franklin County County","MA","Leverett",1992,45,991,1036
"4503","Leverett","Franklin County County","MA","Leverett",1993,43,1003,1046
"4504","Leverett","Franklin County County","MA","Leverett",1994,29,1048,1077
"4505","Leverett","Franklin County County","MA","Leverett",1995,23,1072,1095
"4506","Leverett","Franklin County County","MA","Leverett",1996,21,1078,1099
"4507","Leverett","Franklin County County","MA","Leverett",1997,25,1106,1131
"4508","Leverett","Franklin County County","MA","Leverett",1998,21,1134,1155
"4509","Leverett","Franklin County County","MA","Leverett",1999,16,1160,1176
"4510","Leverett","Franklin County County","MA","Leverett",2000,18,936,954
"4511","Leverett","Franklin County County","MA","Leverett",2001,18,964,982
"4512","Leverett","Franklin County County","MA","Leverett",2002,22,968,990
"4513","Leverett","Franklin County County","MA","Leverett",2003,31,988,1019
"4514","Leverett","Franklin County County","MA","Leverett",2004,33,1004,1037
"4515","Leverett","Franklin County County","MA","Leverett",2005,36,1010,1046
"4516","Leverett","Franklin County County","MA","Leverett",2006,37,1025,1062
"4517","Leverett","Franklin County County","MA","Leverett",2007,31,1012,1043
"4518","Leverett","Franklin County County","MA","Leverett",2008,36,991,1027
"4519","Leverett","Franklin County County","MA","Leverett",2009,53,968,1021
"4520","Leverett","Franklin County County","MA","Leverett",2010,54,979,1033
"4521","Leverett","Franklin County County","MA","Leverett",2011,53,989,1042
"4522","Leverett","Franklin County County","MA","Leverett",2012,45,998,1043
"4523","Lexington","Middlesex County County","MA","Lexington",1990,505,15201,15706
"4524","Lexington","Middlesex County County","MA","Lexington",1991,745,14711,15456
"4525","Lexington","Middlesex County County","MA","Lexington",1992,728,14579,15307
"4526","Lexington","Middlesex County County","MA","Lexington",1993,607,14718,15325
"4527","Lexington","Middlesex County County","MA","Lexington",1994,541,14935,15476
"4528","Lexington","Middlesex County County","MA","Lexington",1995,435,15217,15652
"4529","Lexington","Middlesex County County","MA","Lexington",1996,350,15526,15876
"4530","Lexington","Middlesex County County","MA","Lexington",1997,323,15914,16237
"4531","Lexington","Middlesex County County","MA","Lexington",1998,263,16132,16395
"4532","Lexington","Middlesex County County","MA","Lexington",1999,287,16248,16535
"4533","Lexington","Middlesex County County","MA","Lexington",2000,280,15129,15409
"4534","Lexington","Middlesex County County","MA","Lexington",2001,451,15117,15568
"4535","Lexington","Middlesex County County","MA","Lexington",2002,651,14856,15507
"4536","Lexington","Middlesex County County","MA","Lexington",2003,684,14629,15313
"4537","Lexington","Middlesex County County","MA","Lexington",2004,569,14581,15150
"4538","Lexington","Middlesex County County","MA","Lexington",2005,508,14660,15168
"4539","Lexington","Middlesex County County","MA","Lexington",2006,495,14483,14978
"4540","Lexington","Middlesex County County","MA","Lexington",2007,462,14612,15074
"4541","Lexington","Middlesex County County","MA","Lexington",2008,556,14631,15187
"4542","Lexington","Middlesex County County","MA","Lexington",2009,882,14294,15176
"4543","Lexington","Middlesex County County","MA","Lexington",2010,884,14729,15613
"4544","Lexington","Middlesex County County","MA","Lexington",2011,738,14945,15683
"4545","Lexington","Middlesex County County","MA","Lexington",2012,680,15108,15788
"4546","Leyden","Franklin County County","MA","Leyden",1990,27,355,382
"4547","Leyden","Franklin County County","MA","Leyden",1991,45,361,406
"4548","Leyden","Franklin County County","MA","Leyden",1992,22,350,372
"4549","Leyden","Franklin County County","MA","Leyden",1993,31,372,403
"4550","Leyden","Franklin County County","MA","Leyden",1994,18,390,408
"4551","Leyden","Franklin County County","MA","Leyden",1995,15,371,386
"4552","Leyden","Franklin County County","MA","Leyden",1996,20,379,399
"4553","Leyden","Franklin County County","MA","Leyden",1997,14,394,408
"4554","Leyden","Franklin County County","MA","Leyden",1998,15,402,417
"4555","Leyden","Franklin County County","MA","Leyden",1999,10,411,421
"4556","Leyden","Franklin County County","MA","Leyden",2000,12,459,471
"4557","Leyden","Franklin County County","MA","Leyden",2001,14,461,475
"4558","Leyden","Franklin County County","MA","Leyden",2002,16,474,490
"4559","Leyden","Franklin County County","MA","Leyden",2003,20,477,497
"4560","Leyden","Franklin County County","MA","Leyden",2004,21,474,495
"4561","Leyden","Franklin County County","MA","Leyden",2005,15,478,493
"4562","Leyden","Franklin County County","MA","Leyden",2006,22,478,500
"4563","Leyden","Franklin County County","MA","Leyden",2007,20,470,490
"4564","Leyden","Franklin County County","MA","Leyden",2008,25,461,486
"4565","Leyden","Franklin County County","MA","Leyden",2009,29,453,482
"4566","Leyden","Franklin County County","MA","Leyden",2010,25,405,430
"4567","Leyden","Franklin County County","MA","Leyden",2011,16,406,422
"4568","Leyden","Franklin County County","MA","Leyden",2012,17,407,424
"4569","Lincoln","Middlesex County County","MA","Lincoln",1990,67,3248,3315
"4570","Lincoln","Middlesex County County","MA","Lincoln",1991,106,3130,3236
"4571","Lincoln","Middlesex County County","MA","Lincoln",1992,101,3163,3264
"4572","Lincoln","Middlesex County County","MA","Lincoln",1993,90,3275,3365
"4573","Lincoln","Middlesex County County","MA","Lincoln",1994,79,3400,3479
"4574","Lincoln","Middlesex County County","MA","Lincoln",1995,68,3264,3332
"4575","Lincoln","Middlesex County County","MA","Lincoln",1996,51,3341,3392
"4576","Lincoln","Middlesex County County","MA","Lincoln",1997,39,3425,3464
"4577","Lincoln","Middlesex County County","MA","Lincoln",1998,42,3480,3522
"4578","Lincoln","Middlesex County County","MA","Lincoln",1999,45,3508,3553
"4579","Lincoln","Middlesex County County","MA","Lincoln",2000,55,3343,3398
"4580","Lincoln","Middlesex County County","MA","Lincoln",2001,82,3339,3421
"4581","Lincoln","Middlesex County County","MA","Lincoln",2002,114,3275,3389
"4582","Lincoln","Middlesex County County","MA","Lincoln",2003,121,3210,3331
"4583","Lincoln","Middlesex County County","MA","Lincoln",2004,109,3193,3302
"4584","Lincoln","Middlesex County County","MA","Lincoln",2005,100,3199,3299
"4585","Lincoln","Middlesex County County","MA","Lincoln",2006,95,3168,3263
"4586","Lincoln","Middlesex County County","MA","Lincoln",2007,95,3379,3474
"4587","Lincoln","Middlesex County County","MA","Lincoln",2008,107,3419,3526
"4588","Lincoln","Middlesex County County","MA","Lincoln",2009,177,3331,3508
"4589","Lincoln","Middlesex County County","MA","Lincoln",2010,147,2486,2633
"4590","Lincoln","Middlesex County County","MA","Lincoln",2011,134,2523,2657
"4591","Lincoln","Middlesex County County","MA","Lincoln",2012,130,2551,2681
"4592","Littleton","Middlesex County County","MA","Littleton",1990,178,3827,4005
"4593","Littleton","Middlesex County County","MA","Littleton",1991,255,3732,3987
"4594","Littleton","Middlesex County County","MA","Littleton",1992,260,3738,3998
"4595","Littleton","Middlesex County County","MA","Littleton",1993,242,3849,4091
"4596","Littleton","Middlesex County County","MA","Littleton",1994,213,3995,4208
"4597","Littleton","Middlesex County County","MA","Littleton",1995,174,4082,4256
"4598","Littleton","Middlesex County County","MA","Littleton",1996,129,4190,4319
"4599","Littleton","Middlesex County County","MA","Littleton",1997,122,4342,4464
"4600","Littleton","Middlesex County County","MA","Littleton",1998,94,4547,4641
"4601","Littleton","Middlesex County County","MA","Littleton",1999,104,4640,4744
"4602","Littleton","Middlesex County County","MA","Littleton",2000,90,4459,4549
"4603","Littleton","Middlesex County County","MA","Littleton",2001,159,4529,4688
"4604","Littleton","Middlesex County County","MA","Littleton",2002,249,4494,4743
"4605","Littleton","Middlesex County County","MA","Littleton",2003,244,4471,4715
"4606","Littleton","Middlesex County County","MA","Littleton",2004,195,4477,4672
"4607","Littleton","Middlesex County County","MA","Littleton",2005,192,4531,4723
"4608","Littleton","Middlesex County County","MA","Littleton",2006,181,4492,4673
"4609","Littleton","Middlesex County County","MA","Littleton",2007,168,4554,4722
"4610","Littleton","Middlesex County County","MA","Littleton",2008,196,4565,4761
"4611","Littleton","Middlesex County County","MA","Littleton",2009,311,4517,4828
"4612","Littleton","Middlesex County County","MA","Littleton",2010,320,4560,4880
"4613","Littleton","Middlesex County County","MA","Littleton",2011,279,4626,4905
"4614","Littleton","Middlesex County County","MA","Littleton",2012,247,4677,4924
"4615","Longmeadow","Hampden County County","MA","Longmeadow",1990,301,7607,7908
"4616","Longmeadow","Hampden County County","MA","Longmeadow",1991,384,7365,7749
"4617","Longmeadow","Hampden County County","MA","Longmeadow",1992,365,7366,7731
"4618","Longmeadow","Hampden County County","MA","Longmeadow",1993,346,7358,7704
"4619","Longmeadow","Hampden County County","MA","Longmeadow",1994,328,7425,7753
"4620","Longmeadow","Hampden County County","MA","Longmeadow",1995,279,7169,7448
"4621","Longmeadow","Hampden County County","MA","Longmeadow",1996,230,7229,7459
"4622","Longmeadow","Hampden County County","MA","Longmeadow",1997,197,7366,7563
"4623","Longmeadow","Hampden County County","MA","Longmeadow",1998,169,7386,7555
"4624","Longmeadow","Hampden County County","MA","Longmeadow",1999,162,7384,7546
"4625","Longmeadow","Hampden County County","MA","Longmeadow",2000,171,7755,7926
"4626","Longmeadow","Hampden County County","MA","Longmeadow",2001,198,7750,7948
"4627","Longmeadow","Hampden County County","MA","Longmeadow",2002,259,7709,7968
"4628","Longmeadow","Hampden County County","MA","Longmeadow",2003,304,7620,7924
"4629","Longmeadow","Hampden County County","MA","Longmeadow",2004,281,7598,7879
"4630","Longmeadow","Hampden County County","MA","Longmeadow",2005,271,7597,7868
"4631","Longmeadow","Hampden County County","MA","Longmeadow",2006,277,7606,7883
"4632","Longmeadow","Hampden County County","MA","Longmeadow",2007,255,7546,7801
"4633","Longmeadow","Hampden County County","MA","Longmeadow",2008,286,7485,7771
"4634","Longmeadow","Hampden County County","MA","Longmeadow",2009,444,7224,7668
"4635","Longmeadow","Hampden County County","MA","Longmeadow",2010,466,7375,7841
"4636","Longmeadow","Hampden County County","MA","Longmeadow",2011,389,7301,7690
"4637","Longmeadow","Hampden County County","MA","Longmeadow",2012,369,7306,7675
"4638","Lowell","Middlesex County County","MA","Lowell",1990,4492,47682,52174
"4639","Lowell","Middlesex County County","MA","Lowell",1991,6158,44970,51128
"4640","Lowell","Middlesex County County","MA","Lowell",1992,6500,43525,50025
"4641","Lowell","Middlesex County County","MA","Lowell",1993,5076,42549,47625
"4642","Lowell","Middlesex County County","MA","Lowell",1994,3977,42059,46036
"4643","Lowell","Middlesex County County","MA","Lowell",1995,3270,44598,47868
"4644","Lowell","Middlesex County County","MA","Lowell",1996,2488,45812,48300
"4645","Lowell","Middlesex County County","MA","Lowell",1997,2600,47490,50090
"4646","Lowell","Middlesex County County","MA","Lowell",1998,2301,48476,50777
"4647","Lowell","Middlesex County County","MA","Lowell",1999,2250,49646,51896
"4648","Lowell","Middlesex County County","MA","Lowell",2000,1608,49514,51122
"4649","Lowell","Middlesex County County","MA","Lowell",2001,2777,49469,52246
"4650","Lowell","Middlesex County County","MA","Lowell",2002,4010,48309,52319
"4651","Lowell","Middlesex County County","MA","Lowell",2003,4142,47359,51501
"4652","Lowell","Middlesex County County","MA","Lowell",2004,3552,46814,50366
"4653","Lowell","Middlesex County County","MA","Lowell",2005,3233,46901,50134
"4654","Lowell","Middlesex County County","MA","Lowell",2006,2961,46907,49868
"4655","Lowell","Middlesex County County","MA","Lowell",2007,2779,47017,49796
"4656","Lowell","Middlesex County County","MA","Lowell",2008,3492,46937,50429
"4657","Lowell","Middlesex County County","MA","Lowell",2009,5539,45918,51457
"4658","Lowell","Middlesex County County","MA","Lowell",2010,5414,47197,52611
"4659","Lowell","Middlesex County County","MA","Lowell",2011,4942,47684,52626
"4660","Lowell","Middlesex County County","MA","Lowell",2012,4610,48210,52820
"4661","Ludlow","Hampden County County","MA","Ludlow",1990,734,9917,10651
"4662","Ludlow","Hampden County County","MA","Ludlow",1991,1042,9683,10725
"4663","Ludlow","Hampden County County","MA","Ludlow",1992,1052,9753,10805
"4664","Ludlow","Hampden County County","MA","Ludlow",1993,1029,9890,10919
"4665","Ludlow","Hampden County County","MA","Ludlow",1994,958,9973,10931
"4666","Ludlow","Hampden County County","MA","Ludlow",1995,715,9586,10301
"4667","Ludlow","Hampden County County","MA","Ludlow",1996,582,9752,10334
"4668","Ludlow","Hampden County County","MA","Ludlow",1997,600,10050,10650
"4669","Ludlow","Hampden County County","MA","Ludlow",1998,506,10144,10650
"4670","Ludlow","Hampden County County","MA","Ludlow",1999,450,10230,10680
"4671","Ludlow","Hampden County County","MA","Ludlow",2000,364,10369,10733
"4672","Ludlow","Hampden County County","MA","Ludlow",2001,457,10500,10957
"4673","Ludlow","Hampden County County","MA","Ludlow",2002,599,10507,11106
"4674","Ludlow","Hampden County County","MA","Ludlow",2003,745,10447,11192
"4675","Ludlow","Hampden County County","MA","Ludlow",2004,683,10497,11180
"4676","Ludlow","Hampden County County","MA","Ludlow",2005,645,10542,11187
"4677","Ludlow","Hampden County County","MA","Ludlow",2006,694,10617,11311
"4678","Ludlow","Hampden County County","MA","Ludlow",2007,625,10700,11325
"4679","Ludlow","Hampden County County","MA","Ludlow",2008,769,10772,11541
"4680","Ludlow","Hampden County County","MA","Ludlow",2009,1039,10168,11207
"4681","Ludlow","Hampden County County","MA","Ludlow",2010,1034,9706,10740
"4682","Ludlow","Hampden County County","MA","Ludlow",2011,1025,9608,10633
"4683","Ludlow","Hampden County County","MA","Ludlow",2012,911,9614,10525
"4684","Lunenburg","Worcester County County","MA","Lunenburg",1990,294,4815,5109
"4685","Lunenburg","Worcester County County","MA","Lunenburg",1991,443,4702,5145
"4686","Lunenburg","Worcester County County","MA","Lunenburg",1992,379,4797,5176
"4687","Lunenburg","Worcester County County","MA","Lunenburg",1993,365,4923,5288
"4688","Lunenburg","Worcester County County","MA","Lunenburg",1994,293,5004,5297
"4689","Lunenburg","Worcester County County","MA","Lunenburg",1995,259,4861,5120
"4690","Lunenburg","Worcester County County","MA","Lunenburg",1996,236,4877,5113
"4691","Lunenburg","Worcester County County","MA","Lunenburg",1997,217,5007,5224
"4692","Lunenburg","Worcester County County","MA","Lunenburg",1998,155,4937,5092
"4693","Lunenburg","Worcester County County","MA","Lunenburg",1999,176,4955,5131
"4694","Lunenburg","Worcester County County","MA","Lunenburg",2000,144,5089,5233
"4695","Lunenburg","Worcester County County","MA","Lunenburg",2001,186,5092,5278
"4696","Lunenburg","Worcester County County","MA","Lunenburg",2002,308,5089,5397
"4697","Lunenburg","Worcester County County","MA","Lunenburg",2003,336,5083,5419
"4698","Lunenburg","Worcester County County","MA","Lunenburg",2004,313,5096,5409
"4699","Lunenburg","Worcester County County","MA","Lunenburg",2005,274,5062,5336
"4700","Lunenburg","Worcester County County","MA","Lunenburg",2006,269,5099,5368
"4701","Lunenburg","Worcester County County","MA","Lunenburg",2007,266,5088,5354
"4702","Lunenburg","Worcester County County","MA","Lunenburg",2008,308,5019,5327
"4703","Lunenburg","Worcester County County","MA","Lunenburg",2009,480,4834,5314
"4704","Lunenburg","Worcester County County","MA","Lunenburg",2010,473,4908,5381
"4705","Lunenburg","Worcester County County","MA","Lunenburg",2011,439,4906,5345
"4706","Lunenburg","Worcester County County","MA","Lunenburg",2012,418,4903,5321
"4707","Lynn","Essex County County","MA","Lynn",1990,3065,35836,38901
"4708","Lynn","Essex County County","MA","Lynn",1991,3918,34226,38144
"4709","Lynn","Essex County County","MA","Lynn",1992,4191,33513,37704
"4710","Lynn","Essex County County","MA","Lynn",1993,2942,33663,36605
"4711","Lynn","Essex County County","MA","Lynn",1994,2702,33925,36627
"4712","Lynn","Essex County County","MA","Lynn",1995,2314,35174,37488
"4713","Lynn","Essex County County","MA","Lynn",1996,2013,35817,37830
"4714","Lynn","Essex County County","MA","Lynn",1997,1881,36774,38655
"4715","Lynn","Essex County County","MA","Lynn",1998,1594,37337,38931
"4716","Lynn","Essex County County","MA","Lynn",1999,1628,37553,39181
"4717","Lynn","Essex County County","MA","Lynn",2000,1355,40582,41937
"4718","Lynn","Essex County County","MA","Lynn",2001,1841,40651,42492
"4719","Lynn","Essex County County","MA","Lynn",2002,2676,40169,42845
"4720","Lynn","Essex County County","MA","Lynn",2003,3165,39714,42879
"4721","Lynn","Essex County County","MA","Lynn",2004,2784,39330,42114
"4722","Lynn","Essex County County","MA","Lynn",2005,2579,39095,41674
"4723","Lynn","Essex County County","MA","Lynn",2006,2487,39212,41699
"4724","Lynn","Essex County County","MA","Lynn",2007,2263,38969,41232
"4725","Lynn","Essex County County","MA","Lynn",2008,2660,38947,41607
"4726","Lynn","Essex County County","MA","Lynn",2009,3994,38032,42026
"4727","Lynn","Essex County County","MA","Lynn",2010,4009,39332,43341
"4728","Lynn","Essex County County","MA","Lynn",2011,3640,39788,43428
"4729","Lynn","Essex County County","MA","Lynn",2012,3438,40094,43532
"4730","Lynnfield","Essex County County","MA","Lynnfield",1990,235,5750,5985
"4731","Lynnfield","Essex County County","MA","Lynnfield",1991,318,5556,5874
"4732","Lynnfield","Essex County County","MA","Lynnfield",1992,397,5520,5917
"4733","Lynnfield","Essex County County","MA","Lynnfield",1993,331,5634,5965
"4734","Lynnfield","Essex County County","MA","Lynnfield",1994,254,5762,6016
"4735","Lynnfield","Essex County County","MA","Lynnfield",1995,225,5760,5985
"4736","Lynnfield","Essex County County","MA","Lynnfield",1996,158,5883,6041
"4737","Lynnfield","Essex County County","MA","Lynnfield",1997,161,6045,6206
"4738","Lynnfield","Essex County County","MA","Lynnfield",1998,130,6190,6320
"4739","Lynnfield","Essex County County","MA","Lynnfield",1999,132,6251,6383
"4740","Lynnfield","Essex County County","MA","Lynnfield",2000,122,5671,5793
"4741","Lynnfield","Essex County County","MA","Lynnfield",2001,166,5679,5845
"4742","Lynnfield","Essex County County","MA","Lynnfield",2002,247,5597,5844
"4743","Lynnfield","Essex County County","MA","Lynnfield",2003,295,5520,5815
"4744","Lynnfield","Essex County County","MA","Lynnfield",2004,265,5494,5759
"4745","Lynnfield","Essex County County","MA","Lynnfield",2005,228,5512,5740
"4746","Lynnfield","Essex County County","MA","Lynnfield",2006,216,5335,5551
"4747","Lynnfield","Essex County County","MA","Lynnfield",2007,205,5379,5584
"4748","Lynnfield","Essex County County","MA","Lynnfield",2008,259,5406,5665
"4749","Lynnfield","Essex County County","MA","Lynnfield",2009,400,5481,5881
"4750","Lynnfield","Essex County County","MA","Lynnfield",2010,382,5362,5744
"4751","Lynnfield","Essex County County","MA","Lynnfield",2011,313,5427,5740
"4752","Lynnfield","Essex County County","MA","Lynnfield",2012,282,5487,5769
"4753","Malden","Middlesex County County","MA","Malden",1990,1886,28567,30453
"4754","Malden","Middlesex County County","MA","Malden",1991,2612,27480,30092
"4755","Malden","Middlesex County County","MA","Malden",1992,2649,27163,29812
"4756","Malden","Middlesex County County","MA","Malden",1993,2059,26729,28788
"4757","Malden","Middlesex County County","MA","Malden",1994,1749,26909,28658
"4758","Malden","Middlesex County County","MA","Malden",1995,1717,27683,29400
"4759","Malden","Middlesex County County","MA","Malden",1996,1299,28120,29419
"4760","Malden","Middlesex County County","MA","Malden",1997,1230,28764,29994
"4761","Malden","Middlesex County County","MA","Malden",1998,1006,29065,30071
"4762","Malden","Middlesex County County","MA","Malden",1999,1032,29194,30226
"4763","Malden","Middlesex County County","MA","Malden",2000,808,30867,31675
"4764","Malden","Middlesex County County","MA","Malden",2001,1165,30679,31844
"4765","Malden","Middlesex County County","MA","Malden",2002,1681,29984,31665
"4766","Malden","Middlesex County County","MA","Malden",2003,1940,29383,31323
"4767","Malden","Middlesex County County","MA","Malden",2004,1621,29196,30817
"4768","Malden","Middlesex County County","MA","Malden",2005,1471,29789,31260
"4769","Malden","Middlesex County County","MA","Malden",2006,1435,29257,30692
"4770","Malden","Middlesex County County","MA","Malden",2007,1348,29459,30807
"4771","Malden","Middlesex County County","MA","Malden",2008,1668,29389,31057
"4772","Malden","Middlesex County County","MA","Malden",2009,2494,28566,31060
"4773","Malden","Middlesex County County","MA","Malden",2010,2592,30702,33294
"4774","Malden","Middlesex County County","MA","Malden",2011,2245,31155,33400
"4775","Malden","Middlesex County County","MA","Malden",2012,1985,31496,33481
"4776","Manchester-by-the-Sea","Essex County County","MA","Manchester-by-the-Sea",1990,112,2782,2894
"4777","Manchester-by-the-Sea","Essex County County","MA","Manchester-by-the-Sea",1991,165,2723,2888
"4778","Manchester-by-the-Sea","Essex County County","MA","Manchester-by-the-Sea",1992,178,2728,2906
"4779","Manchester-by-the-Sea","Essex County County","MA","Manchester-by-the-Sea",1993,137,2752,2889
"4780","Manchester-by-the-Sea","Essex County County","MA","Manchester-by-the-Sea",1994,101,2815,2916
"4781","Manchester-by-the-Sea","Essex County County","MA","Manchester-by-the-Sea",1995,86,2779,2865
"4782","Manchester-by-the-Sea","Essex County County","MA","Manchester-by-the-Sea",1996,82,2836,2918
"4783","Manchester-by-the-Sea","Essex County County","MA","Manchester-by-the-Sea",1997,84,2928,3012
"4784","Manchester-by-the-Sea","Essex County County","MA","Manchester-by-the-Sea",1998,63,3019,3082
"4785","Manchester-by-the-Sea","Essex County County","MA","Manchester-by-the-Sea",1999,58,3048,3106
"4786","Manchester-by-the-Sea","Essex County County","MA","Manchester-by-the-Sea",2000,57,2714,2771
"4787","Manchester-by-the-Sea","Essex County County","MA","Manchester-by-the-Sea",2001,81,2722,2803
"4788","Manchester-by-the-Sea","Essex County County","MA","Manchester-by-the-Sea",2002,122,2683,2805
"4789","Manchester-by-the-Sea","Essex County County","MA","Manchester-by-the-Sea",2003,135,2664,2799
"4790","Manchester-by-the-Sea","Essex County County","MA","Manchester-by-the-Sea",2004,120,2676,2796
"4791","Manchester-by-the-Sea","Essex County County","MA","Manchester-by-the-Sea",2005,93,2689,2782
"4792","Manchester-by-the-Sea","Essex County County","MA","Manchester-by-the-Sea",2006,99,2575,2674
"4793","Manchester-by-the-Sea","Essex County County","MA","Manchester-by-the-Sea",2007,90,2584,2674
"4794","Manchester-by-the-Sea","Essex County County","MA","Manchester-by-the-Sea",2008,107,2578,2685
"4795","Manchester-by-the-Sea","Essex County County","MA","Manchester-by-the-Sea",2009,173,2502,2675
"4796","Manchester-by-the-Sea","Essex County County","MA","Manchester-by-the-Sea",2010,180,2507,2687
"4797","Manchester-by-the-Sea","Essex County County","MA","Manchester-by-the-Sea",2011,144,2538,2682
"4798","Manchester-by-the-Sea","Essex County County","MA","Manchester-by-the-Sea",2012,153,2566,2719
"4799","Mansfield","Bristol County County","MA","Mansfield",1990,664,9252,9916
"4800","Mansfield","Bristol County County","MA","Mansfield",1991,729,9251,9980
"4801","Mansfield","Bristol County County","MA","Mansfield",1992,812,9539,10351
"4802","Mansfield","Bristol County County","MA","Mansfield",1993,643,10099,10742
"4803","Mansfield","Bristol County County","MA","Mansfield",1994,595,10482,11077
"4804","Mansfield","Bristol County County","MA","Mansfield",1995,548,10218,10766
"4805","Mansfield","Bristol County County","MA","Mansfield",1996,397,10513,10910
"4806","Mansfield","Bristol County County","MA","Mansfield",1997,388,10851,11239
"4807","Mansfield","Bristol County County","MA","Mansfield",1998,315,11227,11542
"4808","Mansfield","Bristol County County","MA","Mansfield",1999,289,11509,11798
"4809","Mansfield","Bristol County County","MA","Mansfield",2000,299,11973,12272
"4810","Mansfield","Bristol County County","MA","Mansfield",2001,413,12024,12437
"4811","Mansfield","Bristol County County","MA","Mansfield",2002,620,11918,12538
"4812","Mansfield","Bristol County County","MA","Mansfield",2003,676,11834,12510
"4813","Mansfield","Bristol County County","MA","Mansfield",2004,566,11791,12357
"4814","Mansfield","Bristol County County","MA","Mansfield",2005,507,11911,12418
"4815","Mansfield","Bristol County County","MA","Mansfield",2006,518,11728,12246
"4816","Mansfield","Bristol County County","MA","Mansfield",2007,476,12013,12489
"4817","Mansfield","Bristol County County","MA","Mansfield",2008,592,12208,12800
"4818","Mansfield","Bristol County County","MA","Mansfield",2009,914,11797,12711
"4819","Mansfield","Bristol County County","MA","Mansfield",2010,916,11640,12556
"4820","Mansfield","Bristol County County","MA","Mansfield",2011,814,11704,12518
"4821","Mansfield","Bristol County County","MA","Mansfield",2012,728,11833,12561
"4822","Marblehead","Essex County County","MA","Marblehead",1990,491,11280,11771
"4823","Marblehead","Essex County County","MA","Marblehead",1991,699,11060,11759
"4824","Marblehead","Essex County County","MA","Marblehead",1992,663,11060,11723
"4825","Marblehead","Essex County County","MA","Marblehead",1993,541,11256,11797
"4826","Marblehead","Essex County County","MA","Marblehead",1994,443,11479,11922
"4827","Marblehead","Essex County County","MA","Marblehead",1995,382,11132,11514
"4828","Marblehead","Essex County County","MA","Marblehead",1996,281,11341,11622
"4829","Marblehead","Essex County County","MA","Marblehead",1997,266,11623,11889
"4830","Marblehead","Essex County County","MA","Marblehead",1998,246,11791,12037
"4831","Marblehead","Essex County County","MA","Marblehead",1999,227,11885,12112
"4832","Marblehead","Essex County County","MA","Marblehead",2000,220,11089,11309
"4833","Marblehead","Essex County County","MA","Marblehead",2001,339,11101,11440
"4834","Marblehead","Essex County County","MA","Marblehead",2002,505,10958,11463
"4835","Marblehead","Essex County County","MA","Marblehead",2003,496,10820,11316
"4836","Marblehead","Essex County County","MA","Marblehead",2004,441,10693,11134
"4837","Marblehead","Essex County County","MA","Marblehead",2005,405,10674,11079
"4838","Marblehead","Essex County County","MA","Marblehead",2006,382,10768,11150
"4839","Marblehead","Essex County County","MA","Marblehead",2007,361,10705,11066
"4840","Marblehead","Essex County County","MA","Marblehead",2008,435,10673,11108
"4841","Marblehead","Essex County County","MA","Marblehead",2009,693,10360,11053
"4842","Marblehead","Essex County County","MA","Marblehead",2010,639,10301,10940
"4843","Marblehead","Essex County County","MA","Marblehead",2011,550,10421,10971
"4844","Marblehead","Essex County County","MA","Marblehead",2012,556,10501,11057
"4845","Marion","Plymouth County County","MA","Marion",1990,152,2140,2292
"4846","Marion","Plymouth County County","MA","Marion",1991,199,2139,2338
"4847","Marion","Plymouth County County","MA","Marion",1992,188,2133,2321
"4848","Marion","Plymouth County County","MA","Marion",1993,151,2224,2375
"4849","Marion","Plymouth County County","MA","Marion",1994,156,2324,2480
"4850","Marion","Plymouth County County","MA","Marion",1995,144,2270,2414
"4851","Marion","Plymouth County County","MA","Marion",1996,135,2301,2436
"4852","Marion","Plymouth County County","MA","Marion",1997,121,2415,2536
"4853","Marion","Plymouth County County","MA","Marion",1998,82,2459,2541
"4854","Marion","Plymouth County County","MA","Marion",1999,96,2511,2607
"4855","Marion","Plymouth County County","MA","Marion",2000,64,2817,2881
"4856","Marion","Plymouth County County","MA","Marion",2001,74,2863,2937
"4857","Marion","Plymouth County County","MA","Marion",2002,115,2927,3042
"4858","Marion","Plymouth County County","MA","Marion",2003,128,2978,3106
"4859","Marion","Plymouth County County","MA","Marion",2004,119,3023,3142
"4860","Marion","Plymouth County County","MA","Marion",2005,107,3041,3148
"4861","Marion","Plymouth County County","MA","Marion",2006,116,3051,3167
"4862","Marion","Plymouth County County","MA","Marion",2007,106,3029,3135
"4863","Marion","Plymouth County County","MA","Marion",2008,139,2985,3124
"4864","Marion","Plymouth County County","MA","Marion",2009,191,2921,3112
"4865","Marion","Plymouth County County","MA","Marion",2010,195,2805,3000
"4866","Marion","Plymouth County County","MA","Marion",2011,188,2816,3004
"4867","Marion","Plymouth County County","MA","Marion",2012,159,2863,3022
"4868","Marlborough","Middlesex County County","MA","Marlborough",1990,1092,18008,19100
"4869","Marlborough","Middlesex County County","MA","Marlborough",1991,1511,17543,19054
"4870","Marlborough","Middlesex County County","MA","Marlborough",1992,1541,17478,19019
"4871","Marlborough","Middlesex County County","MA","Marlborough",1993,1289,17887,19176
"4872","Marlborough","Middlesex County County","MA","Marlborough",1994,1059,18453,19512
"4873","Marlborough","Middlesex County County","MA","Marlborough",1995,990,18331,19321
"4874","Marlborough","Middlesex County County","MA","Marlborough",1996,716,18764,19480
"4875","Marlborough","Middlesex County County","MA","Marlborough",1997,661,19307,19968
"4876","Marlborough","Middlesex County County","MA","Marlborough",1998,571,19632,20203
"4877","Marlborough","Middlesex County County","MA","Marlborough",1999,623,19829,20452
"4878","Marlborough","Middlesex County County","MA","Marlborough",2000,492,21229,21721
"4879","Marlborough","Middlesex County County","MA","Marlborough",2001,730,21900,22630
"4880","Marlborough","Middlesex County County","MA","Marlborough",2002,1164,21488,22652
"4881","Marlborough","Middlesex County County","MA","Marlborough",2003,1218,21032,22250
"4882","Marlborough","Middlesex County County","MA","Marlborough",2004,944,21068,22012
"4883","Marlborough","Middlesex County County","MA","Marlborough",2005,895,21257,22152
"4884","Marlborough","Middlesex County County","MA","Marlborough",2006,853,21732,22585
"4885","Marlborough","Middlesex County County","MA","Marlborough",2007,819,22000,22819
"4886","Marlborough","Middlesex County County","MA","Marlborough",2008,979,22123,23102
"4887","Marlborough","Middlesex County County","MA","Marlborough",2009,1522,21393,22915
"4888","Marlborough","Middlesex County County","MA","Marlborough",2010,1521,21194,22715
"4889","Marlborough","Middlesex County County","MA","Marlborough",2011,1263,21398,22661
"4890","Marlborough","Middlesex County County","MA","Marlborough",2012,1233,21593,22826
"4891","Marshfield","Plymouth County County","MA","Marshfield",1990,796,11489,12285
"4892","Marshfield","Plymouth County County","MA","Marshfield",1991,1071,11306,12377
"4893","Marshfield","Plymouth County County","MA","Marshfield",1992,1111,11338,12449
"4894","Marshfield","Plymouth County County","MA","Marshfield",1993,940,11649,12589
"4895","Marshfield","Plymouth County County","MA","Marshfield",1994,738,12075,12813
"4896","Marshfield","Plymouth County County","MA","Marshfield",1995,660,11940,12600
"4897","Marshfield","Plymouth County County","MA","Marshfield",1996,598,12273,12871
"4898","Marshfield","Plymouth County County","MA","Marshfield",1997,489,12694,13183
"4899","Marshfield","Plymouth County County","MA","Marshfield",1998,433,13031,13464
"4900","Marshfield","Plymouth County County","MA","Marshfield",1999,405,13310,13715
"4901","Marshfield","Plymouth County County","MA","Marshfield",2000,317,13296,13613
"4902","Marshfield","Plymouth County County","MA","Marshfield",2001,402,13342,13744
"4903","Marshfield","Plymouth County County","MA","Marshfield",2002,584,13225,13809
"4904","Marshfield","Plymouth County County","MA","Marshfield",2003,660,13039,13699
"4905","Marshfield","Plymouth County County","MA","Marshfield",2004,633,13029,13662
"4906","Marshfield","Plymouth County County","MA","Marshfield",2005,565,13207,13772
"4907","Marshfield","Plymouth County County","MA","Marshfield",2006,567,12872,13439
"4908","Marshfield","Plymouth County County","MA","Marshfield",2007,595,12935,13530
"4909","Marshfield","Plymouth County County","MA","Marshfield",2008,682,13001,13683
"4910","Marshfield","Plymouth County County","MA","Marshfield",2009,1024,12601,13625
"4911","Marshfield","Plymouth County County","MA","Marshfield",2010,1072,12916,13988
"4912","Marshfield","Plymouth County County","MA","Marshfield",2011,910,13043,13953
"4913","Marshfield","Plymouth County County","MA","Marshfield",2012,823,13186,14009
"4914","Mashpee","Barnstable County County","MA","Mashpee",1990,272,4048,4320
"4915","Mashpee","Barnstable County County","MA","Mashpee",1991,448,4051,4499
"4916","Mashpee","Barnstable County County","MA","Mashpee",1992,522,4123,4645
"4917","Mashpee","Barnstable County County","MA","Mashpee",1993,461,4408,4869
"4918","Mashpee","Barnstable County County","MA","Mashpee",1994,398,4610,5008
"4919","Mashpee","Barnstable County County","MA","Mashpee",1995,346,4311,4657
"4920","Mashpee","Barnstable County County","MA","Mashpee",1996,333,4455,4788
"4921","Mashpee","Barnstable County County","MA","Mashpee",1997,337,4538,4875
"4922","Mashpee","Barnstable County County","MA","Mashpee",1998,285,4727,5012
"4923","Mashpee","Barnstable County County","MA","Mashpee",1999,251,5005,5256
"4924","Mashpee","Barnstable County County","MA","Mashpee",2000,213,6692,6905
"4925","Mashpee","Barnstable County County","MA","Mashpee",2001,245,6924,7169
"4926","Mashpee","Barnstable County County","MA","Mashpee",2002,320,7220,7540
"4927","Mashpee","Barnstable County County","MA","Mashpee",2003,379,7454,7833
"4928","Mashpee","Barnstable County County","MA","Mashpee",2004,366,7595,7961
"4929","Mashpee","Barnstable County County","MA","Mashpee",2005,356,7629,7985
"4930","Mashpee","Barnstable County County","MA","Mashpee",2006,365,7737,8102
"4931","Mashpee","Barnstable County County","MA","Mashpee",2007,368,7737,8105
"4932","Mashpee","Barnstable County County","MA","Mashpee",2008,444,7709,8153
"4933","Mashpee","Barnstable County County","MA","Mashpee",2009,645,7568,8213
"4934","Mashpee","Barnstable County County","MA","Mashpee",2010,700,7482,8182
"4935","Mashpee","Barnstable County County","MA","Mashpee",2011,601,7470,8071
"4936","Mashpee","Barnstable County County","MA","Mashpee",2012,558,7595,8153
"4937","Mattapoisett","Plymouth County County","MA","Mattapoisett",1990,181,3097,3278
"4938","Mattapoisett","Plymouth County County","MA","Mattapoisett",1991,287,2993,3280
"4939","Mattapoisett","Plymouth County County","MA","Mattapoisett",1992,293,2980,3273
"4940","Mattapoisett","Plymouth County County","MA","Mattapoisett",1993,225,3084,3309
"4941","Mattapoisett","Plymouth County County","MA","Mattapoisett",1994,188,3121,3309
"4942","Mattapoisett","Plymouth County County","MA","Mattapoisett",1995,185,3190,3375
"4943","Mattapoisett","Plymouth County County","MA","Mattapoisett",1996,164,3201,3365
"4944","Mattapoisett","Plymouth County County","MA","Mattapoisett",1997,132,3311,3443
"4945","Mattapoisett","Plymouth County County","MA","Mattapoisett",1998,105,3372,3477
"4946","Mattapoisett","Plymouth County County","MA","Mattapoisett",1999,113,3421,3534
"4947","Mattapoisett","Plymouth County County","MA","Mattapoisett",2000,87,3257,3344
"4948","Mattapoisett","Plymouth County County","MA","Mattapoisett",2001,104,3240,3344
"4949","Mattapoisett","Plymouth County County","MA","Mattapoisett",2002,137,3267,3404
"4950","Mattapoisett","Plymouth County County","MA","Mattapoisett",2003,156,3228,3384
"4951","Mattapoisett","Plymouth County County","MA","Mattapoisett",2004,160,3247,3407
"4952","Mattapoisett","Plymouth County County","MA","Mattapoisett",2005,139,3305,3444
"4953","Mattapoisett","Plymouth County County","MA","Mattapoisett",2006,146,3358,3504
"4954","Mattapoisett","Plymouth County County","MA","Mattapoisett",2007,131,3355,3486
"4955","Mattapoisett","Plymouth County County","MA","Mattapoisett",2008,161,3275,3436
"4956","Mattapoisett","Plymouth County County","MA","Mattapoisett",2009,234,3212,3446
"4957","Mattapoisett","Plymouth County County","MA","Mattapoisett",2010,254,2938,3192
"4958","Mattapoisett","Plymouth County County","MA","Mattapoisett",2011,246,2981,3227
"4959","Mattapoisett","Plymouth County County","MA","Mattapoisett",2012,218,3017,3235
"4960","Maynard","Middlesex County County","MA","Maynard",1990,296,5696,5992
"4961","Maynard","Middlesex County County","MA","Maynard",1991,410,5508,5918
"4962","Maynard","Middlesex County County","MA","Maynard",1992,416,5529,5945
"4963","Maynard","Middlesex County County","MA","Maynard",1993,364,5597,5961
"4964","Maynard","Middlesex County County","MA","Maynard",1994,326,5644,5970
"4965","Maynard","Middlesex County County","MA","Maynard",1995,283,5670,5953
"4966","Maynard","Middlesex County County","MA","Maynard",1996,220,5788,6008
"4967","Maynard","Middlesex County County","MA","Maynard",1997,206,5925,6131
"4968","Maynard","Middlesex County County","MA","Maynard",1998,162,6014,6176
"4969","Maynard","Middlesex County County","MA","Maynard",1999,177,6072,6249
"4970","Maynard","Middlesex County County","MA","Maynard",2000,146,6123,6269
"4971","Maynard","Middlesex County County","MA","Maynard",2001,221,6089,6310
"4972","Maynard","Middlesex County County","MA","Maynard",2002,333,5972,6305
"4973","Maynard","Middlesex County County","MA","Maynard",2003,328,5848,6176
"4974","Maynard","Middlesex County County","MA","Maynard",2004,286,5832,6118
"4975","Maynard","Middlesex County County","MA","Maynard",2005,256,5841,6097
"4976","Maynard","Middlesex County County","MA","Maynard",2006,259,5793,6052
"4977","Maynard","Middlesex County County","MA","Maynard",2007,228,5869,6097
"4978","Maynard","Middlesex County County","MA","Maynard",2008,266,5905,6171
"4979","Maynard","Middlesex County County","MA","Maynard",2009,414,5790,6204
"4980","Maynard","Middlesex County County","MA","Maynard",2010,418,5589,6007
"4981","Maynard","Middlesex County County","MA","Maynard",2011,390,5672,6062
"4982","Maynard","Middlesex County County","MA","Maynard",2012,331,5734,6065
"4983","Medfield","Norfolk County County","MA","Medfield",1990,247,5626,5873
"4984","Medfield","Norfolk County County","MA","Medfield",1991,314,5501,5815
"4985","Medfield","Norfolk County County","MA","Medfield",1992,323,5504,5827
"4986","Medfield","Norfolk County County","MA","Medfield",1993,268,5709,5977
"4987","Medfield","Norfolk County County","MA","Medfield",1994,199,5982,6181
"4988","Medfield","Norfolk County County","MA","Medfield",1995,193,5952,6145
"4989","Medfield","Norfolk County County","MA","Medfield",1996,159,6139,6298
"4990","Medfield","Norfolk County County","MA","Medfield",1997,142,6354,6496
"4991","Medfield","Norfolk County County","MA","Medfield",1998,108,6480,6588
"4992","Medfield","Norfolk County County","MA","Medfield",1999,120,6563,6683
"4993","Medfield","Norfolk County County","MA","Medfield",2000,124,5959,6083
"4994","Medfield","Norfolk County County","MA","Medfield",2001,164,5990,6154
"4995","Medfield","Norfolk County County","MA","Medfield",2002,246,5880,6126
"4996","Medfield","Norfolk County County","MA","Medfield",2003,276,5786,6062
"4997","Medfield","Norfolk County County","MA","Medfield",2004,233,5783,6016
"4998","Medfield","Norfolk County County","MA","Medfield",2005,203,5817,6020
"4999","Medfield","Norfolk County County","MA","Medfield",2006,219,5654,5873
"5000","Medfield","Norfolk County County","MA","Medfield",2007,197,5703,5900
"5001","Medfield","Norfolk County County","MA","Medfield",2008,252,5709,5961
"5002","Medfield","Norfolk County County","MA","Medfield",2009,376,5517,5893
"5003","Medfield","Norfolk County County","MA","Medfield",2010,386,5489,5875
"5004","Medfield","Norfolk County County","MA","Medfield",2011,309,5551,5860
"5005","Medfield","Norfolk County County","MA","Medfield",2012,298,5612,5910
"5006","Medford","Middlesex County County","MA","Medford",1990,1724,30306,32030
"5007","Medford","Middlesex County County","MA","Medford",1991,2365,29279,31644
"5008","Medford","Middlesex County County","MA","Medford",1992,2406,28760,31166
"5009","Medford","Middlesex County County","MA","Medford",1993,1853,28711,30564
"5010","Medford","Middlesex County County","MA","Medford",1994,1649,28827,30476
"5011","Medford","Middlesex County County","MA","Medford",1995,1485,29411,30896
"5012","Medford","Middlesex County County","MA","Medford",1996,1226,29860,31086
"5013","Medford","Middlesex County County","MA","Medford",1997,1127,30526,31653
"5014","Medford","Middlesex County County","MA","Medford",1998,844,30700,31544
"5015","Medford","Middlesex County County","MA","Medford",1999,835,30795,31630
"5016","Medford","Middlesex County County","MA","Medford",2000,736,29882,30618
"5017","Medford","Middlesex County County","MA","Medford",2001,1032,29659,30691
"5018","Medford","Middlesex County County","MA","Medford",2002,1503,28812,30315
"5019","Medford","Middlesex County County","MA","Medford",2003,1676,28206,29882
"5020","Medford","Middlesex County County","MA","Medford",2004,1452,27974,29426
"5021","Medford","Middlesex County County","MA","Medford",2005,1291,27984,29275
"5022","Medford","Middlesex County County","MA","Medford",2006,1317,28808,30125
"5023","Medford","Middlesex County County","MA","Medford",2007,1220,28908,30128
"5024","Medford","Middlesex County County","MA","Medford",2008,1464,28800,30264
"5025","Medford","Middlesex County County","MA","Medford",2009,2287,27729,30016
"5026","Medford","Middlesex County County","MA","Medford",2010,2259,28446,30705
"5027","Medford","Middlesex County County","MA","Medford",2011,1858,28856,30714
"5028","Medford","Middlesex County County","MA","Medford",2012,1738,29172,30910
"5029","Medway","Norfolk County County","MA","Medway",1990,379,5218,5597
"5030","Medway","Norfolk County County","MA","Medway",1991,462,5183,5645
"5031","Medway","Norfolk County County","MA","Medway",1992,478,5254,5732
"5032","Medway","Norfolk County County","MA","Medway",1993,329,5501,5830
"5033","Medway","Norfolk County County","MA","Medway",1994,272,5755,6027
"5034","Medway","Norfolk County County","MA","Medway",1995,252,5789,6041
"5035","Medway","Norfolk County County","MA","Medway",1996,186,5989,6175
"5036","Medway","Norfolk County County","MA","Medway",1997,175,6213,6388
"5037","Medway","Norfolk County County","MA","Medway",1998,148,6401,6549
"5038","Medway","Norfolk County County","MA","Medway",1999,157,6517,6674
"5039","Medway","Norfolk County County","MA","Medway",2000,137,6885,7022
"5040","Medway","Norfolk County County","MA","Medway",2001,207,6942,7149
"5041","Medway","Norfolk County County","MA","Medway",2002,312,6938,7250
"5042","Medway","Norfolk County County","MA","Medway",2003,331,6854,7185
"5043","Medway","Norfolk County County","MA","Medway",2004,258,6843,7101
"5044","Medway","Norfolk County County","MA","Medway",2005,272,6873,7145
"5045","Medway","Norfolk County County","MA","Medway",2006,277,6794,7071
"5046","Medway","Norfolk County County","MA","Medway",2007,244,6838,7082
"5047","Medway","Norfolk County County","MA","Medway",2008,334,6827,7161
"5048","Medway","Norfolk County County","MA","Medway",2009,504,6612,7116
"5049","Medway","Norfolk County County","MA","Medway",2010,487,6626,7113
"5050","Medway","Norfolk County County","MA","Medway",2011,437,6701,7138
"5051","Medway","Norfolk County County","MA","Medway",2012,358,6775,7133
"5052","Melrose","Middlesex County County","MA","Melrose",1990,720,14789,15509
"5053","Melrose","Middlesex County County","MA","Melrose",1991,999,14182,15181
"5054","Melrose","Middlesex County County","MA","Melrose",1992,1058,13940,14998
"5055","Melrose","Middlesex County County","MA","Melrose",1993,781,13868,14649
"5056","Melrose","Middlesex County County","MA","Melrose",1994,654,14025,14679
"5057","Melrose","Middlesex County County","MA","Melrose",1995,600,14272,14872
"5058","Melrose","Middlesex County County","MA","Melrose",1996,537,14500,15037
"5059","Melrose","Middlesex County County","MA","Melrose",1997,485,14836,15321
"5060","Melrose","Middlesex County County","MA","Melrose",1998,368,14963,15331
"5061","Melrose","Middlesex County County","MA","Melrose",1999,376,15021,15397
"5062","Melrose","Middlesex County County","MA","Melrose",2000,330,15170,15500
"5063","Melrose","Middlesex County County","MA","Melrose",2001,459,15057,15516
"5064","Melrose","Middlesex County County","MA","Melrose",2002,721,14695,15416
"5065","Melrose","Middlesex County County","MA","Melrose",2003,749,14394,15143
"5066","Melrose","Middlesex County County","MA","Melrose",2004,673,14288,14961
"5067","Melrose","Middlesex County County","MA","Melrose",2005,582,14348,14930
"5068","Melrose","Middlesex County County","MA","Melrose",2006,557,14322,14879
"5069","Melrose","Middlesex County County","MA","Melrose",2007,505,14456,14961
"5070","Melrose","Middlesex County County","MA","Melrose",2008,647,14425,15072
"5071","Melrose","Middlesex County County","MA","Melrose",2009,1056,14069,15125
"5072","Melrose","Middlesex County County","MA","Melrose",2010,987,14223,15210
"5073","Melrose","Middlesex County County","MA","Melrose",2011,838,14433,15271
"5074","Melrose","Middlesex County County","MA","Melrose",2012,742,14591,15333
"5075","Mendon","Worcester County County","MA","Mendon",1990,142,2138,2280
"5076","Mendon","Worcester County County","MA","Mendon",1991,202,2141,2343
"5077","Mendon","Worcester County County","MA","Mendon",1992,178,2184,2362
"5078","Mendon","Worcester County County","MA","Mendon",1993,146,2272,2418
"5079","Mendon","Worcester County County","MA","Mendon",1994,127,2369,2496
"5080","Mendon","Worcester County County","MA","Mendon",1995,124,2252,2376
"5081","Mendon","Worcester County County","MA","Mendon",1996,102,2333,2435
"5082","Mendon","Worcester County County","MA","Mendon",1997,86,2462,2548
"5083","Mendon","Worcester County County","MA","Mendon",1998,62,2568,2630
"5084","Mendon","Worcester County County","MA","Mendon",1999,64,2693,2757
"5085","Mendon","Worcester County County","MA","Mendon",2000,67,3020,3087
"5086","Mendon","Worcester County County","MA","Mendon",2001,90,3096,3186
"5087","Mendon","Worcester County County","MA","Mendon",2002,155,3091,3246
"5088","Mendon","Worcester County County","MA","Mendon",2003,150,3093,3243
"5089","Mendon","Worcester County County","MA","Mendon",2004,137,3139,3276
"5090","Mendon","Worcester County County","MA","Mendon",2005,120,3184,3304
"5091","Mendon","Worcester County County","MA","Mendon",2006,123,3210,3333
"5092","Mendon","Worcester County County","MA","Mendon",2007,121,3249,3370
"5093","Mendon","Worcester County County","MA","Mendon",2008,142,3276,3418
"5094","Mendon","Worcester County County","MA","Mendon",2009,215,3089,3304
"5095","Mendon","Worcester County County","MA","Mendon",2010,220,3133,3353
"5096","Mendon","Worcester County County","MA","Mendon",2011,196,3143,3339
"5097","Mendon","Worcester County County","MA","Mendon",2012,173,3172,3345
"5098","Merrimac","Essex County County","MA","Merrimac",1990,191,2696,2887
"5099","Merrimac","Essex County County","MA","Merrimac",1991,262,2665,2927
"5100","Merrimac","Essex County County","MA","Merrimac",1992,246,2781,3027
"5101","Merrimac","Essex County County","MA","Merrimac",1993,211,2863,3074
"5102","Merrimac","Essex County County","MA","Merrimac",1994,201,3020,3221
"5103","Merrimac","Essex County County","MA","Merrimac",1995,172,2947,3119
"5104","Merrimac","Essex County County","MA","Merrimac",1996,134,3068,3202
"5105","Merrimac","Essex County County","MA","Merrimac",1997,133,3149,3282
"5106","Merrimac","Essex County County","MA","Merrimac",1998,113,3274,3387
"5107","Merrimac","Essex County County","MA","Merrimac",1999,102,3408,3510
"5108","Merrimac","Essex County County","MA","Merrimac",2000,79,3478,3557
"5109","Merrimac","Essex County County","MA","Merrimac",2001,121,3466,3587
"5110","Merrimac","Essex County County","MA","Merrimac",2002,193,3381,3574
"5111","Merrimac","Essex County County","MA","Merrimac",2003,181,3309,3490
"5112","Merrimac","Essex County County","MA","Merrimac",2004,163,3277,3440
"5113","Merrimac","Essex County County","MA","Merrimac",2005,146,3325,3471
"5114","Merrimac","Essex County County","MA","Merrimac",2006,136,3373,3509
"5115","Merrimac","Essex County County","MA","Merrimac",2007,134,3395,3529
"5116","Merrimac","Essex County County","MA","Merrimac",2008,168,3387,3555
"5117","Merrimac","Essex County County","MA","Merrimac",2009,266,3329,3595
"5118","Merrimac","Essex County County","MA","Merrimac",2010,267,3271,3538
"5119","Merrimac","Essex County County","MA","Merrimac",2011,221,3314,3535
"5120","Merrimac","Essex County County","MA","Merrimac",2012,211,3357,3568
"5121","Methuen","Essex County County","MA","Methuen",1990,1498,18572,20070
"5122","Methuen","Essex County County","MA","Methuen",1991,2122,18270,20392
"5123","Methuen","Essex County County","MA","Methuen",1992,2205,18521,20726
"5124","Methuen","Essex County County","MA","Methuen",1993,2069,18805,20874
"5125","Methuen","Essex County County","MA","Methuen",1994,1870,19079,20949
"5126","Methuen","Essex County County","MA","Methuen",1995,1511,19322,20833
"5127","Methuen","Essex County County","MA","Methuen",1996,1348,19875,21223
"5128","Methuen","Essex County County","MA","Methuen",1997,1254,20168,21422
"5129","Methuen","Essex County County","MA","Methuen",1998,1085,20652,21737
"5130","Methuen","Essex County County","MA","Methuen",1999,1072,21148,22220
"5131","Methuen","Essex County County","MA","Methuen",2000,737,21702,22439
"5132","Methuen","Essex County County","MA","Methuen",2001,1062,21817,22879
"5133","Methuen","Essex County County","MA","Methuen",2002,1708,21574,23282
"5134","Methuen","Essex County County","MA","Methuen",2003,1779,21585,23364
"5135","Methuen","Essex County County","MA","Methuen",2004,1558,21627,23185
"5136","Methuen","Essex County County","MA","Methuen",2005,1401,21708,23109
"5137","Methuen","Essex County County","MA","Methuen",2006,1339,21821,23160
"5138","Methuen","Essex County County","MA","Methuen",2007,1248,21951,23199
"5139","Methuen","Essex County County","MA","Methuen",2008,1532,21886,23418
"5140","Methuen","Essex County County","MA","Methuen",2009,2418,21278,23696
"5141","Methuen","Essex County County","MA","Methuen",2010,2429,21910,24339
"5142","Methuen","Essex County County","MA","Methuen",2011,2124,22342,24466
"5143","Methuen","Essex County County","MA","Methuen",2012,2091,22649,24740
"5144","Middleborough","Plymouth County County","MA","Middleborough",1990,885,8609,9494
"5145","Middleborough","Plymouth County County","MA","Middleborough",1991,1203,8255,9458
"5146","Middleborough","Plymouth County County","MA","Middleborough",1992,1217,8207,9424
"5147","Middleborough","Plymouth County County","MA","Middleborough",1993,1031,8565,9596
"5148","Middleborough","Plymouth County County","MA","Middleborough",1994,792,9099,9891
"5149","Middleborough","Plymouth County County","MA","Middleborough",1995,691,9319,10010
"5150","Middleborough","Plymouth County County","MA","Middleborough",1996,583,9463,10046
"5151","Middleborough","Plymouth County County","MA","Middleborough",1997,580,9816,10396
"5152","Middleborough","Plymouth County County","MA","Middleborough",1998,448,9935,10383
"5153","Middleborough","Plymouth County County","MA","Middleborough",1999,438,10136,10574
"5154","Middleborough","Plymouth County County","MA","Middleborough",2000,331,10721,11052
"5155","Middleborough","Plymouth County County","MA","Middleborough",2001,389,10777,11166
"5156","Middleborough","Plymouth County County","MA","Middleborough",2002,587,10776,11363
"5157","Middleborough","Plymouth County County","MA","Middleborough",2003,651,10621,11272
"5158","Middleborough","Plymouth County County","MA","Middleborough",2004,594,10699,11293
"5159","Middleborough","Plymouth County County","MA","Middleborough",2005,609,10771,11380
"5160","Middleborough","Plymouth County County","MA","Middleborough",2006,652,10967,11619
"5161","Middleborough","Plymouth County County","MA","Middleborough",2007,657,11086,11743
"5162","Middleborough","Plymouth County County","MA","Middleborough",2008,785,10942,11727
"5163","Middleborough","Plymouth County County","MA","Middleborough",2009,1136,10702,11838
"5164","Middleborough","Plymouth County County","MA","Middleborough",2010,1230,11562,12792
"5165","Middleborough","Plymouth County County","MA","Middleborough",2011,1090,11670,12760
"5166","Middleborough","Plymouth County County","MA","Middleborough",2012,938,11773,12711
"5167","Middlefield","Hampshire County County","MA","Middlefield",1990,8,200,208
"5168","Middlefield","Hampshire County County","MA","Middlefield",1991,21,194,215
"5169","Middlefield","Hampshire County County","MA","Middlefield",1992,20,213,233
"5170","Middlefield","Hampshire County County","MA","Middlefield",1993,14,228,242
"5171","Middlefield","Hampshire County County","MA","Middlefield",1994,11,247,258
"5172","Middlefield","Hampshire County County","MA","Middlefield",1995,8,260,268
"5173","Middlefield","Hampshire County County","MA","Middlefield",1996,11,256,267
"5174","Middlefield","Hampshire County County","MA","Middlefield",1997,9,258,267
"5175","Middlefield","Hampshire County County","MA","Middlefield",1998,5,271,276
"5176","Middlefield","Hampshire County County","MA","Middlefield",1999,8,293,301
"5177","Middlefield","Hampshire County County","MA","Middlefield",2000,6,314,320
"5178","Middlefield","Hampshire County County","MA","Middlefield",2001,7,315,322
"5179","Middlefield","Hampshire County County","MA","Middlefield",2002,9,312,321
"5180","Middlefield","Hampshire County County","MA","Middlefield",2003,11,310,321
"5181","Middlefield","Hampshire County County","MA","Middlefield",2004,12,309,321
"5182","Middlefield","Hampshire County County","MA","Middlefield",2005,12,312,324
"5183","Middlefield","Hampshire County County","MA","Middlefield",2006,12,315,327
"5184","Middlefield","Hampshire County County","MA","Middlefield",2007,9,316,325
"5185","Middlefield","Hampshire County County","MA","Middlefield",2008,11,316,327
"5186","Middlefield","Hampshire County County","MA","Middlefield",2009,24,302,326
"5187","Middlefield","Hampshire County County","MA","Middlefield",2010,19,284,303
"5188","Middlefield","Hampshire County County","MA","Middlefield",2011,19,281,300
"5189","Middlefield","Hampshire County County","MA","Middlefield",2012,15,281,296
"5190",NA,"Middlesex County County","MA","Middlesex County County",1990,41332,760223,801555
"5191",NA,"Middlesex County County","MA","Middlesex County County",1991,56563,733455,790018
"5192",NA,"Middlesex County County","MA","Middlesex County County",1992,58947,727818,786765
"5193",NA,"Middlesex County County","MA","Middlesex County County",1993,47421,733455,780876
"5194",NA,"Middlesex County County","MA","Middlesex County County",1994,40160,744089,784249
"5195",NA,"Middlesex County County","MA","Middlesex County County",1995,34657,752160,786817
"5196",NA,"Middlesex County County","MA","Middlesex County County",1996,27516,769545,797061
"5197",NA,"Middlesex County County","MA","Middlesex County County",1997,24947,792324,817271
"5198",NA,"Middlesex County County","MA","Middlesex County County",1998,20679,805836,826515
"5199",NA,"Middlesex County County","MA","Middlesex County County",1999,21279,816516,837795
"5200",NA,"Middlesex County County","MA","Middlesex County County",2000,18181,803616,821797
"5201",NA,"Middlesex County County","MA","Middlesex County County",2001,27298,803298,830596
"5202",NA,"Middlesex County County","MA","Middlesex County County",2002,41306,786821,828127
"5203",NA,"Middlesex County County","MA","Middlesex County County",2003,43489,773934,817423
"5204",NA,"Middlesex County County","MA","Middlesex County County",2004,36384,771860,808244
"5205",NA,"Middlesex County County","MA","Middlesex County County",2005,32895,777022,809917
"5206",NA,"Middlesex County County","MA","Middlesex County County",2006,32051,780347,812398
"5207",NA,"Middlesex County County","MA","Middlesex County County",2007,30027,788302,818329
"5208",NA,"Middlesex County County","MA","Middlesex County County",2008,36189,791149,827338
"5209",NA,"Middlesex County County","MA","Middlesex County County",2009,57234,769491,826725
"5210",NA,"Middlesex County County","MA","Middlesex County County",2010,56430,776213,832643
"5211",NA,"Middlesex County County","MA","Middlesex County County",2011,48531,786142,834673
"5212",NA,"Middlesex County County","MA","Middlesex County County",2012,44620,794517,839137
"5213","Middleton","Essex County County","MA","Middleton",1990,162,2698,2860
"5214","Middleton","Essex County County","MA","Middleton",1991,194,2652,2846
"5215","Middleton","Essex County County","MA","Middleton",1992,242,2700,2942
"5216","Middleton","Essex County County","MA","Middleton",1993,215,2751,2966
"5217","Middleton","Essex County County","MA","Middleton",1994,182,2887,3069
"5218","Middleton","Essex County County","MA","Middleton",1995,119,2954,3073
"5219","Middleton","Essex County County","MA","Middleton",1996,119,3095,3214
"5220","Middleton","Essex County County","MA","Middleton",1997,125,3271,3396
"5221","Middleton","Essex County County","MA","Middleton",1998,113,3420,3533
"5222","Middleton","Essex County County","MA","Middleton",1999,97,3549,3646
"5223","Middleton","Essex County County","MA","Middleton",2000,88,3567,3655
"5224","Middleton","Essex County County","MA","Middleton",2001,128,3873,4001
"5225","Middleton","Essex County County","MA","Middleton",2002,177,3870,4047
"5226","Middleton","Essex County County","MA","Middleton",2003,195,3898,4093
"5227","Middleton","Essex County County","MA","Middleton",2004,206,3948,4154
"5228","Middleton","Essex County County","MA","Middleton",2005,186,4063,4249
"5229","Middleton","Essex County County","MA","Middleton",2006,164,3827,3991
"5230","Middleton","Essex County County","MA","Middleton",2007,165,3896,4061
"5231","Middleton","Essex County County","MA","Middleton",2008,207,3963,4170
"5232","Middleton","Essex County County","MA","Middleton",2009,324,3864,4188
"5233","Middleton","Essex County County","MA","Middleton",2010,349,3814,4163
"5234","Middleton","Essex County County","MA","Middleton",2011,290,3857,4147
"5235","Middleton","Essex County County","MA","Middleton",2012,250,3899,4149
"5236","Milford","Worcester County County","MA","Milford",1990,1006,12910,13916
"5237","Milford","Worcester County County","MA","Milford",1991,1337,12400,13737
"5238","Milford","Worcester County County","MA","Milford",1992,1231,12243,13474
"5239","Milford","Worcester County County","MA","Milford",1993,924,12342,13266
"5240","Milford","Worcester County County","MA","Milford",1994,815,12588,13403
"5241","Milford","Worcester County County","MA","Milford",1995,840,12705,13545
"5242","Milford","Worcester County County","MA","Milford",1996,651,12911,13562
"5243","Milford","Worcester County County","MA","Milford",1997,625,13269,13894
"5244","Milford","Worcester County County","MA","Milford",1998,522,13559,14081
"5245","Milford","Worcester County County","MA","Milford",1999,492,13847,14339
"5246","Milford","Worcester County County","MA","Milford",2000,378,14409,14787
"5247","Milford","Worcester County County","MA","Milford",2001,518,14506,15024
"5248","Milford","Worcester County County","MA","Milford",2002,844,14292,15136
"5249","Milford","Worcester County County","MA","Milford",2003,918,14105,15023
"5250","Milford","Worcester County County","MA","Milford",2004,773,14203,14976
"5251","Milford","Worcester County County","MA","Milford",2005,674,14482,15156
"5252","Milford","Worcester County County","MA","Milford",2006,679,14567,15246
"5253","Milford","Worcester County County","MA","Milford",2007,655,14606,15261
"5254","Milford","Worcester County County","MA","Milford",2008,804,14730,15534
"5255","Milford","Worcester County County","MA","Milford",2009,1200,14223,15423
"5256","Milford","Worcester County County","MA","Milford",2010,1190,14288,15478
"5257","Milford","Worcester County County","MA","Milford",2011,991,14328,15319
"5258","Milford","Worcester County County","MA","Milford",2012,915,14459,15374
"5259","Millbury","Worcester County County","MA","Millbury",1990,461,6315,6776
"5260","Millbury","Worcester County County","MA","Millbury",1991,680,6110,6790
"5261","Millbury","Worcester County County","MA","Millbury",1992,657,6100,6757
"5262","Millbury","Worcester County County","MA","Millbury",1993,494,6299,6793
"5263","Millbury","Worcester County County","MA","Millbury",1994,347,6358,6705
"5264","Millbury","Worcester County County","MA","Millbury",1995,345,6361,6706
"5265","Millbury","Worcester County County","MA","Millbury",1996,292,6429,6721
"5266","Millbury","Worcester County County","MA","Millbury",1997,271,6570,6841
"5267","Millbury","Worcester County County","MA","Millbury",1998,216,6653,6869
"5268","Millbury","Worcester County County","MA","Millbury",1999,225,6623,6848
"5269","Millbury","Worcester County County","MA","Millbury",2000,174,7054,7228
"5270","Millbury","Worcester County County","MA","Millbury",2001,262,7108,7370
"5271","Millbury","Worcester County County","MA","Millbury",2002,368,7074,7442
"5272","Millbury","Worcester County County","MA","Millbury",2003,398,7079,7477
"5273","Millbury","Worcester County County","MA","Millbury",2004,359,7104,7463
"5274","Millbury","Worcester County County","MA","Millbury",2005,349,7127,7476
"5275","Millbury","Worcester County County","MA","Millbury",2006,349,7226,7575
"5276","Millbury","Worcester County County","MA","Millbury",2007,346,7217,7563
"5277","Millbury","Worcester County County","MA","Millbury",2008,417,7060,7477
"5278","Millbury","Worcester County County","MA","Millbury",2009,628,6859,7487
"5279","Millbury","Worcester County County","MA","Millbury",2010,619,6722,7341
"5280","Millbury","Worcester County County","MA","Millbury",2011,564,6782,7346
"5281","Millbury","Worcester County County","MA","Millbury",2012,502,6779,7281
"5282","Millis","Norfolk County County","MA","Millis",1990,244,4274,4518
"5283","Millis","Norfolk County County","MA","Millis",1991,318,4223,4541
"5284","Millis","Norfolk County County","MA","Millis",1992,299,4248,4547
"5285","Millis","Norfolk County County","MA","Millis",1993,244,4301,4545
"5286","Millis","Norfolk County County","MA","Millis",1994,212,4394,4606
"5287","Millis","Norfolk County County","MA","Millis",1995,190,4386,4576
"5288","Millis","Norfolk County County","MA","Millis",1996,163,4509,4672
"5289","Millis","Norfolk County County","MA","Millis",1997,127,4666,4793
"5290","Millis","Norfolk County County","MA","Millis",1998,120,4729,4849
"5291","Millis","Norfolk County County","MA","Millis",1999,124,4762,4886
"5292","Millis","Norfolk County County","MA","Millis",2000,99,4425,4524
"5293","Millis","Norfolk County County","MA","Millis",2001,137,4438,4575
"5294","Millis","Norfolk County County","MA","Millis",2002,207,4370,4577
"5295","Millis","Norfolk County County","MA","Millis",2003,240,4316,4556
"5296","Millis","Norfolk County County","MA","Millis",2004,197,4306,4503
"5297","Millis","Norfolk County County","MA","Millis",2005,180,4333,4513
"5298","Millis","Norfolk County County","MA","Millis",2006,184,4273,4457
"5299","Millis","Norfolk County County","MA","Millis",2007,186,4302,4488
"5300","Millis","Norfolk County County","MA","Millis",2008,219,4315,4534
"5301","Millis","Norfolk County County","MA","Millis",2009,336,4168,4504
"5302","Millis","Norfolk County County","MA","Millis",2010,329,4158,4487
"5303","Millis","Norfolk County County","MA","Millis",2011,288,4204,4492
"5304","Millis","Norfolk County County","MA","Millis",2012,259,4250,4509
"5305","Millville","Worcester County County","MA","Millville",1990,88,1172,1260
"5306","Millville","Worcester County County","MA","Millville",1991,126,1145,1271
"5307","Millville","Worcester County County","MA","Millville",1992,120,1210,1330
"5308","Millville","Worcester County County","MA","Millville",1993,125,1251,1376
"5309","Millville","Worcester County County","MA","Millville",1994,70,1307,1377
"5310","Millville","Worcester County County","MA","Millville",1995,95,1235,1330
"5311","Millville","Worcester County County","MA","Millville",1996,78,1271,1349
"5312","Millville","Worcester County County","MA","Millville",1997,66,1322,1388
"5313","Millville","Worcester County County","MA","Millville",1998,58,1369,1427
"5314","Millville","Worcester County County","MA","Millville",1999,53,1400,1453
"5315","Millville","Worcester County County","MA","Millville",2000,49,1467,1516
"5316","Millville","Worcester County County","MA","Millville",2001,68,1476,1544
"5317","Millville","Worcester County County","MA","Millville",2002,108,1515,1623
"5318","Millville","Worcester County County","MA","Millville",2003,103,1552,1655
"5319","Millville","Worcester County County","MA","Millville",2004,86,1562,1648
"5320","Millville","Worcester County County","MA","Millville",2005,79,1577,1656
"5321","Millville","Worcester County County","MA","Millville",2006,93,1598,1691
"5322","Millville","Worcester County County","MA","Millville",2007,84,1537,1621
"5323","Millville","Worcester County County","MA","Millville",2008,105,1521,1626
"5324","Millville","Worcester County County","MA","Millville",2009,181,1508,1689
"5325","Millville","Worcester County County","MA","Millville",2010,200,1621,1821
"5326","Millville","Worcester County County","MA","Millville",2011,166,1635,1801
"5327","Millville","Worcester County County","MA","Millville",2012,161,1638,1799
"5328","Milton","Norfolk County County","MA","Milton",1990,508,12720,13228
"5329","Milton","Norfolk County County","MA","Milton",1991,697,12260,12957
"5330","Milton","Norfolk County County","MA","Milton",1992,670,12247,12917
"5331","Milton","Norfolk County County","MA","Milton",1993,653,12535,13188
"5332","Milton","Norfolk County County","MA","Milton",1994,529,12501,13030
"5333","Milton","Norfolk County County","MA","Milton",1995,488,12627,13115
"5334","Milton","Norfolk County County","MA","Milton",1996,402,12832,13234
"5335","Milton","Norfolk County County","MA","Milton",1997,327,13095,13422
"5336","Milton","Norfolk County County","MA","Milton",1998,284,13260,13544
"5337","Milton","Norfolk County County","MA","Milton",1999,268,13288,13556
"5338","Milton","Norfolk County County","MA","Milton",2000,301,13460,13761
"5339","Milton","Norfolk County County","MA","Milton",2001,370,13384,13754
"5340","Milton","Norfolk County County","MA","Milton",2002,571,13105,13676
"5341","Milton","Norfolk County County","MA","Milton",2003,603,12845,13448
"5342","Milton","Norfolk County County","MA","Milton",2004,562,12862,13424
"5343","Milton","Norfolk County County","MA","Milton",2005,522,13084,13606
"5344","Milton","Norfolk County County","MA","Milton",2006,558,13190,13748
"5345","Milton","Norfolk County County","MA","Milton",2007,492,13144,13636
"5346","Milton","Norfolk County County","MA","Milton",2008,588,13054,13642
"5347","Milton","Norfolk County County","MA","Milton",2009,950,12559,13509
"5348","Milton","Norfolk County County","MA","Milton",2010,934,13145,14079
"5349","Milton","Norfolk County County","MA","Milton",2011,774,13288,14062
"5350","Milton","Norfolk County County","MA","Milton",2012,712,13434,14146
"5351","Monroe","Franklin County County","MA","Monroe",1990,3,67,70
"5352","Monroe","Franklin County County","MA","Monroe",1991,4,68,72
"5353","Monroe","Franklin County County","MA","Monroe",1992,9,69,78
"5354","Monroe","Franklin County County","MA","Monroe",1993,7,59,66
"5355","Monroe","Franklin County County","MA","Monroe",1994,6,48,54
"5356","Monroe","Franklin County County","MA","Monroe",1995,3,68,71
"5357","Monroe","Franklin County County","MA","Monroe",1996,3,68,71
"5358","Monroe","Franklin County County","MA","Monroe",1997,4,68,72
"5359","Monroe","Franklin County County","MA","Monroe",1998,3,70,73
"5360","Monroe","Franklin County County","MA","Monroe",1999,5,72,77
"5361","Monroe","Franklin County County","MA","Monroe",2000,3,22,25
"5362","Monroe","Franklin County County","MA","Monroe",2001,3,23,26
"5363","Monroe","Franklin County County","MA","Monroe",2002,3,23,26
"5364","Monroe","Franklin County County","MA","Monroe",2003,4,23,27
"5365","Monroe","Franklin County County","MA","Monroe",2004,3,23,26
"5366","Monroe","Franklin County County","MA","Monroe",2005,2,24,26
"5367","Monroe","Franklin County County","MA","Monroe",2006,2,24,26
"5368","Monroe","Franklin County County","MA","Monroe",2007,3,24,27
"5369","Monroe","Franklin County County","MA","Monroe",2008,2,24,26
"5370","Monroe","Franklin County County","MA","Monroe",2009,4,22,26
"5371","Monroe","Franklin County County","MA","Monroe",2010,5,28,33
"5372","Monroe","Franklin County County","MA","Monroe",2011,3,28,31
"5373","Monroe","Franklin County County","MA","Monroe",2012,6,28,34
"5374","Monson","Hampden County County","MA","Monson",1990,245,3623,3868
"5375","Monson","Hampden County County","MA","Monson",1991,320,3557,3877
"5376","Monson","Hampden County County","MA","Monson",1992,328,3615,3943
"5377","Monson","Hampden County County","MA","Monson",1993,363,3673,4036
"5378","Monson","Hampden County County","MA","Monson",1994,300,3692,3992
"5379","Monson","Hampden County County","MA","Monson",1995,258,3569,3827
"5380","Monson","Hampden County County","MA","Monson",1996,168,3629,3797
"5381","Monson","Hampden County County","MA","Monson",1997,166,3727,3893
"5382","Monson","Hampden County County","MA","Monson",1998,137,3777,3914
"5383","Monson","Hampden County County","MA","Monson",1999,144,3819,3963
"5384","Monson","Hampden County County","MA","Monson",2000,123,4338,4461
"5385","Monson","Hampden County County","MA","Monson",2001,170,4375,4545
"5386","Monson","Hampden County County","MA","Monson",2002,242,4388,4630
"5387","Monson","Hampden County County","MA","Monson",2003,268,4377,4645
"5388","Monson","Hampden County County","MA","Monson",2004,247,4408,4655
"5389","Monson","Hampden County County","MA","Monson",2005,223,4466,4689
"5390","Monson","Hampden County County","MA","Monson",2006,241,4511,4752
"5391","Monson","Hampden County County","MA","Monson",2007,226,4521,4747
"5392","Monson","Hampden County County","MA","Monson",2008,270,4565,4835
"5393","Monson","Hampden County County","MA","Monson",2009,389,4408,4797
"5394","Monson","Hampden County County","MA","Monson",2010,410,4176,4586
"5395","Monson","Hampden County County","MA","Monson",2011,357,4135,4492
"5396","Monson","Hampden County County","MA","Monson",2012,323,4137,4460
"5397","Montague","Franklin County County","MA","Montague",1990,206,4018,4224
"5398","Montague","Franklin County County","MA","Montague",1991,343,3970,4313
"5399","Montague","Franklin County County","MA","Montague",1992,416,3923,4339
"5400","Montague","Franklin County County","MA","Montague",1993,300,3908,4208
"5401","Montague","Franklin County County","MA","Montague",1994,257,4040,4297
"5402","Montague","Franklin County County","MA","Montague",1995,285,4073,4358
"5403","Montague","Franklin County County","MA","Montague",1996,209,4083,4292
"5404","Montague","Franklin County County","MA","Montague",1997,194,4166,4360
"5405","Montague","Franklin County County","MA","Montague",1998,166,4261,4427
"5406","Montague","Franklin County County","MA","Montague",1999,146,4334,4480
"5407","Montague","Franklin County County","MA","Montague",2000,126,4235,4361
"5408","Montague","Franklin County County","MA","Montague",2001,151,4212,4363
"5409","Montague","Franklin County County","MA","Montague",2002,207,4260,4467
"5410","Montague","Franklin County County","MA","Montague",2003,217,4254,4471
"5411","Montague","Franklin County County","MA","Montague",2004,208,4175,4383
"5412","Montague","Franklin County County","MA","Montague",2005,217,4150,4367
"5413","Montague","Franklin County County","MA","Montague",2006,218,4153,4371
"5414","Montague","Franklin County County","MA","Montague",2007,215,4112,4327
"5415","Montague","Franklin County County","MA","Montague",2008,243,4039,4282
"5416","Montague","Franklin County County","MA","Montague",2009,381,3857,4238
"5417","Montague","Franklin County County","MA","Montague",2010,399,4053,4452
"5418","Montague","Franklin County County","MA","Montague",2011,362,4060,4422
"5419","Montague","Franklin County County","MA","Montague",2012,333,4071,4404
"5420","Monterey","Berkshire County County","MA","Monterey",1990,14,390,404
"5421","Monterey","Berkshire County County","MA","Monterey",1991,27,382,409
"5422","Monterey","Berkshire County County","MA","Monterey",1992,17,380,397
"5423","Monterey","Berkshire County County","MA","Monterey",1993,17,392,409
"5424","Monterey","Berkshire County County","MA","Monterey",1994,23,393,416
"5425","Monterey","Berkshire County County","MA","Monterey",1995,29,416,445
"5426","Monterey","Berkshire County County","MA","Monterey",1996,17,425,442
"5427","Monterey","Berkshire County County","MA","Monterey",1997,12,438,450
"5428","Monterey","Berkshire County County","MA","Monterey",1998,9,423,432
"5429","Monterey","Berkshire County County","MA","Monterey",1999,8,422,430
"5430","Monterey","Berkshire County County","MA","Monterey",2000,13,529,542
"5431","Monterey","Berkshire County County","MA","Monterey",2001,13,549,562
"5432","Monterey","Berkshire County County","MA","Monterey",2002,17,569,586
"5433","Monterey","Berkshire County County","MA","Monterey",2003,19,574,593
"5434","Monterey","Berkshire County County","MA","Monterey",2004,15,573,588
"5435","Monterey","Berkshire County County","MA","Monterey",2005,18,587,605
"5436","Monterey","Berkshire County County","MA","Monterey",2006,17,593,610
"5437","Monterey","Berkshire County County","MA","Monterey",2007,15,584,599
"5438","Monterey","Berkshire County County","MA","Monterey",2008,20,580,600
"5439","Monterey","Berkshire County County","MA","Monterey",2009,28,569,597
"5440","Monterey","Berkshire County County","MA","Monterey",2010,22,574,596
"5441","Monterey","Berkshire County County","MA","Monterey",2011,24,578,602
"5442","Monterey","Berkshire County County","MA","Monterey",2012,22,574,596
"5443","Montgomery","Hampden County County","MA","Montgomery",1990,11,414,425
"5444","Montgomery","Hampden County County","MA","Montgomery",1991,24,412,436
"5445","Montgomery","Hampden County County","MA","Montgomery",1992,20,407,427
"5446","Montgomery","Hampden County County","MA","Montgomery",1993,14,407,421
"5447","Montgomery","Hampden County County","MA","Montgomery",1994,21,432,453
"5448","Montgomery","Hampden County County","MA","Montgomery",1995,19,408,427
"5449","Montgomery","Hampden County County","MA","Montgomery",1996,12,421,433
"5450","Montgomery","Hampden County County","MA","Montgomery",1997,22,439,461
"5451","Montgomery","Hampden County County","MA","Montgomery",1998,30,398,428
"5452","Montgomery","Hampden County County","MA","Montgomery",1999,13,411,424
"5453","Montgomery","Hampden County County","MA","Montgomery",2000,9,383,392
"5454","Montgomery","Hampden County County","MA","Montgomery",2001,12,398,410
"5455","Montgomery","Hampden County County","MA","Montgomery",2002,14,409,423
"5456","Montgomery","Hampden County County","MA","Montgomery",2003,20,415,435
"5457","Montgomery","Hampden County County","MA","Montgomery",2004,18,420,438
"5458","Montgomery","Hampden County County","MA","Montgomery",2005,18,426,444
"5459","Montgomery","Hampden County County","MA","Montgomery",2006,23,434,457
"5460","Montgomery","Hampden County County","MA","Montgomery",2007,18,436,454
"5461","Montgomery","Hampden County County","MA","Montgomery",2008,14,411,425
"5462","Montgomery","Hampden County County","MA","Montgomery",2009,31,397,428
"5463","Montgomery","Hampden County County","MA","Montgomery",2010,37,459,496
"5464","Montgomery","Hampden County County","MA","Montgomery",2011,29,454,483
"5465","Montgomery","Hampden County County","MA","Montgomery",2012,28,454,482
"5466","Mount Washington","Berkshire County County","MA","Mount Washington",1990,5,66,71
"5467","Mount Washington","Berkshire County County","MA","Mount Washington",1991,4,60,64
"5468","Mount Washington","Berkshire County County","MA","Mount Washington",1992,1,64,65
"5469","Mount Washington","Berkshire County County","MA","Mount Washington",1993,1,75,76
"5470","Mount Washington","Berkshire County County","MA","Mount Washington",1994,1,82,83
"5471","Mount Washington","Berkshire County County","MA","Mount Washington",1995,3,71,74
"5472","Mount Washington","Berkshire County County","MA","Mount Washington",1996,1,72,73
"5473","Mount Washington","Berkshire County County","MA","Mount Washington",1997,2,73,75
"5474","Mount Washington","Berkshire County County","MA","Mount Washington",1998,1,74,75
"5475","Mount Washington","Berkshire County County","MA","Mount Washington",1999,3,73,76
"5476","Mount Washington","Berkshire County County","MA","Mount Washington",2000,2,86,88
"5477","Mount Washington","Berkshire County County","MA","Mount Washington",2001,2,89,91
"5478","Mount Washington","Berkshire County County","MA","Mount Washington",2002,3,92,95
"5479","Mount Washington","Berkshire County County","MA","Mount Washington",2003,4,93,97
"5480","Mount Washington","Berkshire County County","MA","Mount Washington",2004,2,94,96
"5481","Mount Washington","Berkshire County County","MA","Mount Washington",2005,4,97,101
"5482","Mount Washington","Berkshire County County","MA","Mount Washington",2006,2,100,102
"5483","Mount Washington","Berkshire County County","MA","Mount Washington",2007,1,98,99
"5484","Mount Washington","Berkshire County County","MA","Mount Washington",2008,1,98,99
"5485","Mount Washington","Berkshire County County","MA","Mount Washington",2009,3,94,97
"5486","Mount Washington","Berkshire County County","MA","Mount Washington",2010,4,117,121
"5487","Mount Washington","Berkshire County County","MA","Mount Washington",2011,4,117,121
"5488","Mount Washington","Berkshire County County","MA","Mount Washington",2012,3,116,119
"5489","Nahant","Essex County County","MA","Nahant",1990,92,2005,2097
"5490","Nahant","Essex County County","MA","Nahant",1991,149,1921,2070
"5491","Nahant","Essex County County","MA","Nahant",1992,144,1891,2035
"5492","Nahant","Essex County County","MA","Nahant",1993,140,1907,2047
"5493","Nahant","Essex County County","MA","Nahant",1994,110,1924,2034
"5494","Nahant","Essex County County","MA","Nahant",1995,84,1963,2047
"5495","Nahant","Essex County County","MA","Nahant",1996,93,1995,2088
"5496","Nahant","Essex County County","MA","Nahant",1997,76,2040,2116
"5497","Nahant","Essex County County","MA","Nahant",1998,59,2057,2116
"5498","Nahant","Essex County County","MA","Nahant",1999,61,2069,2130
"5499","Nahant","Essex County County","MA","Nahant",2000,43,1993,2036
"5500","Nahant","Essex County County","MA","Nahant",2001,67,1992,2059
"5501","Nahant","Essex County County","MA","Nahant",2002,108,1964,2072
"5502","Nahant","Essex County County","MA","Nahant",2003,108,1937,2045
"5503","Nahant","Essex County County","MA","Nahant",2004,88,1916,2004
"5504","Nahant","Essex County County","MA","Nahant",2005,81,1905,1986
"5505","Nahant","Essex County County","MA","Nahant",2006,88,1908,1996
"5506","Nahant","Essex County County","MA","Nahant",2007,87,1896,1983
"5507","Nahant","Essex County County","MA","Nahant",2008,94,1887,1981
"5508","Nahant","Essex County County","MA","Nahant",2009,142,1899,2041
"5509","Nahant","Essex County County","MA","Nahant",2010,135,1788,1923
"5510","Nahant","Essex County County","MA","Nahant",2011,137,1809,1946
"5511","Nahant","Essex County County","MA","Nahant",2012,112,1823,1935
"5512","Nantucket","Nantucket County County","MA","Nantucket",1990,153,4606,4759
"5513","Nantucket","Nantucket County County","MA","Nantucket",1991,269,4588,4857
"5514","Nantucket","Nantucket County County","MA","Nantucket",1992,235,4721,4956
"5515","Nantucket","Nantucket County County","MA","Nantucket",1993,207,5093,5300
"5516","Nantucket","Nantucket County County","MA","Nantucket",1994,152,5409,5561
"5517","Nantucket","Nantucket County County","MA","Nantucket",1995,151,5540,5691
"5518","Nantucket","Nantucket County County","MA","Nantucket",1996,139,5685,5824
"5519","Nantucket","Nantucket County County","MA","Nantucket",1997,141,5957,6098
"5520","Nantucket","Nantucket County County","MA","Nantucket",1998,113,6355,6468
"5521","Nantucket","Nantucket County County","MA","Nantucket",1999,115,6489,6604
"5522","Nantucket","Nantucket County County","MA","Nantucket",2000,108,7181,7289
"5523","Nantucket","Nantucket County County","MA","Nantucket",2001,116,7002,7118
"5524","Nantucket","Nantucket County County","MA","Nantucket",2002,145,7324,7469
"5525","Nantucket","Nantucket County County","MA","Nantucket",2003,195,7496,7691
"5526","Nantucket","Nantucket County County","MA","Nantucket",2004,197,7643,7840
"5527","Nantucket","Nantucket County County","MA","Nantucket",2005,198,7940,8138
"5528","Nantucket","Nantucket County County","MA","Nantucket",2006,194,8218,8412
"5529","Nantucket","Nantucket County County","MA","Nantucket",2007,199,8343,8542
"5530","Nantucket","Nantucket County County","MA","Nantucket",2008,277,8153,8430
"5531","Nantucket","Nantucket County County","MA","Nantucket",2009,530,7278,7808
"5532","Nantucket","Nantucket County County","MA","Nantucket",2010,586,7228,7814
"5533","Nantucket","Nantucket County County","MA","Nantucket",2011,526,7304,7830
"5534","Nantucket","Nantucket County County","MA","Nantucket",2012,487,7695,8182
"5535","Natick","Middlesex County County","MA","Natick",1990,819,17659,18478
"5536","Natick","Middlesex County County","MA","Natick",1991,1112,17033,18145
"5537","Natick","Middlesex County County","MA","Natick",1992,1106,16942,18048
"5538","Natick","Middlesex County County","MA","Natick",1993,853,17255,18108
"5539","Natick","Middlesex County County","MA","Natick",1994,727,17504,18231
"5540","Natick","Middlesex County County","MA","Natick",1995,675,17896,18571
"5541","Natick","Middlesex County County","MA","Natick",1996,537,18250,18787
"5542","Natick","Middlesex County County","MA","Natick",1997,497,18721,19218
"5543","Natick","Middlesex County County","MA","Natick",1998,370,19039,19409
"5544","Natick","Middlesex County County","MA","Natick",1999,383,19208,19591
"5545","Natick","Middlesex County County","MA","Natick",2000,356,18500,18856
"5546","Natick","Middlesex County County","MA","Natick",2001,515,18491,19006
"5547","Natick","Middlesex County County","MA","Natick",2002,771,18058,18829
"5548","Natick","Middlesex County County","MA","Natick",2003,837,17720,18557
"5549","Natick","Middlesex County County","MA","Natick",2004,691,17768,18459
"5550","Natick","Middlesex County County","MA","Natick",2005,621,17953,18574
"5551","Natick","Middlesex County County","MA","Natick",2006,646,18023,18669
"5552","Natick","Middlesex County County","MA","Natick",2007,575,18295,18870
"5553","Natick","Middlesex County County","MA","Natick",2008,692,18407,19099
"5554","Natick","Middlesex County County","MA","Natick",2009,1097,17804,18901
"5555","Natick","Middlesex County County","MA","Natick",2010,1082,17988,19070
"5556","Natick","Middlesex County County","MA","Natick",2011,898,18163,19061
"5557","Natick","Middlesex County County","MA","Natick",2012,830,18329,19159
"5558","Needham","Norfolk County County","MA","Needham",1990,536,14039,14575
"5559","Needham","Norfolk County County","MA","Needham",1991,691,13497,14188
"5560","Needham","Norfolk County County","MA","Needham",1992,694,13553,14247
"5561","Needham","Norfolk County County","MA","Needham",1993,558,13802,14360
"5562","Needham","Norfolk County County","MA","Needham",1994,513,14043,14556
"5563","Needham","Norfolk County County","MA","Needham",1995,477,14018,14495
"5564","Needham","Norfolk County County","MA","Needham",1996,325,14283,14608
"5565","Needham","Norfolk County County","MA","Needham",1997,285,14637,14922
"5566","Needham","Norfolk County County","MA","Needham",1998,251,14811,15062
"5567","Needham","Norfolk County County","MA","Needham",1999,240,14899,15139
"5568","Needham","Norfolk County County","MA","Needham",2000,284,14120,14404
"5569","Needham","Norfolk County County","MA","Needham",2001,396,14114,14510
"5570","Needham","Norfolk County County","MA","Needham",2002,597,13891,14488
"5571","Needham","Norfolk County County","MA","Needham",2003,619,13673,14292
"5572","Needham","Norfolk County County","MA","Needham",2004,537,13639,14176
"5573","Needham","Norfolk County County","MA","Needham",2005,484,13697,14181
"5574","Needham","Norfolk County County","MA","Needham",2006,465,13632,14097
"5575","Needham","Norfolk County County","MA","Needham",2007,432,13726,14158
"5576","Needham","Norfolk County County","MA","Needham",2008,530,13777,14307
"5577","Needham","Norfolk County County","MA","Needham",2009,855,13348,14203
"5578","Needham","Norfolk County County","MA","Needham",2010,790,13486,14276
"5579","Needham","Norfolk County County","MA","Needham",2011,689,13636,14325
"5580","Needham","Norfolk County County","MA","Needham",2012,638,13786,14424
"5581","New Ashford","Berkshire County County","MA","New Ashford",1990,5,116,121
"5582","New Ashford","Berkshire County County","MA","New Ashford",1991,9,109,118
"5583","New Ashford","Berkshire County County","MA","New Ashford",1992,11,113,124
"5584","New Ashford","Berkshire County County","MA","New Ashford",1993,9,111,120
"5585","New Ashford","Berkshire County County","MA","New Ashford",1994,12,111,123
"5586","New Ashford","Berkshire County County","MA","New Ashford",1995,4,111,115
"5587","New Ashford","Berkshire County County","MA","New Ashford",1996,4,111,115
"5588","New Ashford","Berkshire County County","MA","New Ashford",1997,6,115,121
"5589","New Ashford","Berkshire County County","MA","New Ashford",1998,7,120,127
"5590","New Ashford","Berkshire County County","MA","New Ashford",1999,4,126,130
"5591","New Ashford","Berkshire County County","MA","New Ashford",2000,7,147,154
"5592","New Ashford","Berkshire County County","MA","New Ashford",2001,5,148,153
"5593","New Ashford","Berkshire County County","MA","New Ashford",2002,7,150,157
"5594","New Ashford","Berkshire County County","MA","New Ashford",2003,7,148,155
"5595","New Ashford","Berkshire County County","MA","New Ashford",2004,6,148,154
"5596","New Ashford","Berkshire County County","MA","New Ashford",2005,7,152,159
"5597","New Ashford","Berkshire County County","MA","New Ashford",2006,6,156,162
"5598","New Ashford","Berkshire County County","MA","New Ashford",2007,6,157,163
"5599","New Ashford","Berkshire County County","MA","New Ashford",2008,6,155,161
"5600","New Ashford","Berkshire County County","MA","New Ashford",2009,7,151,158
"5601","New Ashford","Berkshire County County","MA","New Ashford",2010,6,133,139
"5602","New Ashford","Berkshire County County","MA","New Ashford",2011,8,136,144
"5603","New Ashford","Berkshire County County","MA","New Ashford",2012,7,135,142
"5604","New Bedford","Bristol County County","MA","New Bedford",1990,5669,39663,45332
"5605","New Bedford","Bristol County County","MA","New Bedford",1991,7278,37870,45148
"5606","New Bedford","Bristol County County","MA","New Bedford",1992,6718,37225,43943
"5607","New Bedford","Bristol County County","MA","New Bedford",1993,5878,37664,43542
"5608","New Bedford","Bristol County County","MA","New Bedford",1994,5664,37847,43511
"5609","New Bedford","Bristol County County","MA","New Bedford",1995,5314,38114,43428
"5610","New Bedford","Bristol County County","MA","New Bedford",1996,4709,37641,42350
"5611","New Bedford","Bristol County County","MA","New Bedford",1997,4040,38419,42459
"5612","New Bedford","Bristol County County","MA","New Bedford",1998,3507,37871,41378
"5613","New Bedford","Bristol County County","MA","New Bedford",1999,3191,37947,41138
"5614","New Bedford","Bristol County County","MA","New Bedford",2000,2306,39621,41927
"5615","New Bedford","Bristol County County","MA","New Bedford",2001,2838,39116,41954
"5616","New Bedford","Bristol County County","MA","New Bedford",2002,3644,39243,42887
"5617","New Bedford","Bristol County County","MA","New Bedford",2003,4012,38297,42309
"5618","New Bedford","Bristol County County","MA","New Bedford",2004,3618,38425,42043
"5619","New Bedford","Bristol County County","MA","New Bedford",2005,3466,38692,42158
"5620","New Bedford","Bristol County County","MA","New Bedford",2006,3374,39122,42496
"5621","New Bedford","Bristol County County","MA","New Bedford",2007,3250,38939,42189
"5622","New Bedford","Bristol County County","MA","New Bedford",2008,3965,37718,41683
"5623","New Bedford","Bristol County County","MA","New Bedford",2009,5837,36552,42389
"5624","New Bedford","Bristol County County","MA","New Bedford",2010,6126,37630,43756
"5625","New Bedford","Bristol County County","MA","New Bedford",2011,5592,38020,43612
"5626","New Bedford","Bristol County County","MA","New Bedford",2012,5492,38469,43961
"5627","New Braintree","Worcester County County","MA","New Braintree",1990,31,433,464
"5628","New Braintree","Worcester County County","MA","New Braintree",1991,45,419,464
"5629","New Braintree","Worcester County County","MA","New Braintree",1992,39,424,463
"5630","New Braintree","Worcester County County","MA","New Braintree",1993,23,450,473
"5631","New Braintree","Worcester County County","MA","New Braintree",1994,23,449,472
"5632","New Braintree","Worcester County County","MA","New Braintree",1995,22,429,451
"5633","New Braintree","Worcester County County","MA","New Braintree",1996,19,425,444
"5634","New Braintree","Worcester County County","MA","New Braintree",1997,22,437,459
"5635","New Braintree","Worcester County County","MA","New Braintree",1998,20,444,464
"5636","New Braintree","Worcester County County","MA","New Braintree",1999,14,449,463
"5637","New Braintree","Worcester County County","MA","New Braintree",2000,13,527,540
"5638","New Braintree","Worcester County County","MA","New Braintree",2001,14,542,556
"5639","New Braintree","Worcester County County","MA","New Braintree",2002,25,552,577
"5640","New Braintree","Worcester County County","MA","New Braintree",2003,29,568,597
"5641","New Braintree","Worcester County County","MA","New Braintree",2004,27,581,608
"5642","New Braintree","Worcester County County","MA","New Braintree",2005,36,594,630
"5643","New Braintree","Worcester County County","MA","New Braintree",2006,36,603,639
"5644","New Braintree","Worcester County County","MA","New Braintree",2007,36,613,649
"5645","New Braintree","Worcester County County","MA","New Braintree",2008,35,604,639
"5646","New Braintree","Worcester County County","MA","New Braintree",2009,54,589,643
"5647","New Braintree","Worcester County County","MA","New Braintree",2010,56,520,576
"5648","New Braintree","Worcester County County","MA","New Braintree",2011,41,524,565
"5649","New Braintree","Worcester County County","MA","New Braintree",2012,42,523,565
"5650","New Marlborough","Berkshire County County","MA","New Marlborough",1990,8,592,600
"5651","New Marlborough","Berkshire County County","MA","New Marlborough",1991,14,583,597
"5652","New Marlborough","Berkshire County County","MA","New Marlborough",1992,20,565,585
"5653","New Marlborough","Berkshire County County","MA","New Marlborough",1993,16,596,612
"5654","New Marlborough","Berkshire County County","MA","New Marlborough",1994,18,578,596
"5655","New Marlborough","Berkshire County County","MA","New Marlborough",1995,18,649,667
"5656","New Marlborough","Berkshire County County","MA","New Marlborough",1996,14,665,679
"5657","New Marlborough","Berkshire County County","MA","New Marlborough",1997,11,681,692
"5658","New Marlborough","Berkshire County County","MA","New Marlborough",1998,10,676,686
"5659","New Marlborough","Berkshire County County","MA","New Marlborough",1999,12,671,683
"5660","New Marlborough","Berkshire County County","MA","New Marlborough",2000,17,805,822
"5661","New Marlborough","Berkshire County County","MA","New Marlborough",2001,22,839,861
"5662","New Marlborough","Berkshire County County","MA","New Marlborough",2002,30,860,890
"5663","New Marlborough","Berkshire County County","MA","New Marlborough",2003,30,861,891
"5664","New Marlborough","Berkshire County County","MA","New Marlborough",2004,27,866,893
"5665","New Marlborough","Berkshire County County","MA","New Marlborough",2005,29,890,919
"5666","New Marlborough","Berkshire County County","MA","New Marlborough",2006,29,901,930
"5667","New Marlborough","Berkshire County County","MA","New Marlborough",2007,30,883,913
"5668","New Marlborough","Berkshire County County","MA","New Marlborough",2008,38,877,915
"5669","New Marlborough","Berkshire County County","MA","New Marlborough",2009,55,852,907
"5670","New Marlborough","Berkshire County County","MA","New Marlborough",2010,62,861,923
"5671","New Marlborough","Berkshire County County","MA","New Marlborough",2011,46,865,911
"5672","New Marlborough","Berkshire County County","MA","New Marlborough",2012,50,858,908
"5673","New Salem","Franklin County County","MA","New Salem",1990,24,426,450
"5674","New Salem","Franklin County County","MA","New Salem",1991,37,417,454
"5675","New Salem","Franklin County County","MA","New Salem",1992,30,390,420
"5676","New Salem","Franklin County County","MA","New Salem",1993,19,386,405
"5677","New Salem","Franklin County County","MA","New Salem",1994,37,387,424
"5678","New Salem","Franklin County County","MA","New Salem",1995,34,407,441
"5679","New Salem","Franklin County County","MA","New Salem",1996,20,404,424
"5680","New Salem","Franklin County County","MA","New Salem",1997,17,410,427
"5681","New Salem","Franklin County County","MA","New Salem",1998,18,407,425
"5682","New Salem","Franklin County County","MA","New Salem",1999,18,403,421
"5683","New Salem","Franklin County County","MA","New Salem",2000,13,546,559
"5684","New Salem","Franklin County County","MA","New Salem",2001,15,540,555
"5685","New Salem","Franklin County County","MA","New Salem",2002,19,548,567
"5686","New Salem","Franklin County County","MA","New Salem",2003,24,546,570
"5687","New Salem","Franklin County County","MA","New Salem",2004,17,543,560
"5688","New Salem","Franklin County County","MA","New Salem",2005,29,538,567
"5689","New Salem","Franklin County County","MA","New Salem",2006,23,531,554
"5690","New Salem","Franklin County County","MA","New Salem",2007,22,534,556
"5691","New Salem","Franklin County County","MA","New Salem",2008,28,539,567
"5692","New Salem","Franklin County County","MA","New Salem",2009,43,498,541
"5693","New Salem","Franklin County County","MA","New Salem",2010,40,511,551
"5694","New Salem","Franklin County County","MA","New Salem",2011,36,511,547
"5695","New Salem","Franklin County County","MA","New Salem",2012,33,512,545
"5696","Newbury","Essex County County","MA","Newbury",1990,152,2966,3118
"5697","Newbury","Essex County County","MA","Newbury",1991,212,2930,3142
"5698","Newbury","Essex County County","MA","Newbury",1992,208,3025,3233
"5699","Newbury","Essex County County","MA","Newbury",1993,191,3141,3332
"5700","Newbury","Essex County County","MA","Newbury",1994,172,3283,3455
"5701","Newbury","Essex County County","MA","Newbury",1995,133,3074,3207
"5702","Newbury","Essex County County","MA","Newbury",1996,105,3159,3264
"5703","Newbury","Essex County County","MA","Newbury",1997,105,3272,3377
"5704","Newbury","Essex County County","MA","Newbury",1998,102,3357,3459
"5705","Newbury","Essex County County","MA","Newbury",1999,93,3405,3498
"5706","Newbury","Essex County County","MA","Newbury",2000,83,3673,3756
"5707","Newbury","Essex County County","MA","Newbury",2001,118,3699,3817
"5708","Newbury","Essex County County","MA","Newbury",2002,166,3663,3829
"5709","Newbury","Essex County County","MA","Newbury",2003,191,3611,3802
"5710","Newbury","Essex County County","MA","Newbury",2004,176,3611,3787
"5711","Newbury","Essex County County","MA","Newbury",2005,156,3714,3870
"5712","Newbury","Essex County County","MA","Newbury",2006,147,3548,3695
"5713","Newbury","Essex County County","MA","Newbury",2007,134,3580,3714
"5714","Newbury","Essex County County","MA","Newbury",2008,180,3594,3774
"5715","Newbury","Essex County County","MA","Newbury",2009,259,3498,3757
"5716","Newbury","Essex County County","MA","Newbury",2010,269,3425,3694
"5717","Newbury","Essex County County","MA","Newbury",2011,243,3467,3710
"5718","Newbury","Essex County County","MA","Newbury",2012,227,3505,3732
"5719","Newburyport","Essex County County","MA","Newburyport",1990,577,8914,9491
"5720","Newburyport","Essex County County","MA","Newburyport",1991,694,8613,9307
"5721","Newburyport","Essex County County","MA","Newburyport",1992,693,8617,9310
"5722","Newburyport","Essex County County","MA","Newburyport",1993,577,8735,9312
"5723","Newburyport","Essex County County","MA","Newburyport",1994,483,8962,9445
"5724","Newburyport","Essex County County","MA","Newburyport",1995,425,8852,9277
"5725","Newburyport","Essex County County","MA","Newburyport",1996,346,9044,9390
"5726","Newburyport","Essex County County","MA","Newburyport",1997,300,9325,9625
"5727","Newburyport","Essex County County","MA","Newburyport",1998,245,9501,9746
"5728","Newburyport","Essex County County","MA","Newburyport",1999,257,9613,9870
"5729","Newburyport","Essex County County","MA","Newburyport",2000,220,9663,9883
"5730","Newburyport","Essex County County","MA","Newburyport",2001,334,9696,10030
"5731","Newburyport","Essex County County","MA","Newburyport",2002,511,9632,10143
"5732","Newburyport","Essex County County","MA","Newburyport",2003,548,9485,10033
"5733","Newburyport","Essex County County","MA","Newburyport",2004,440,9472,9912
"5734","Newburyport","Essex County County","MA","Newburyport",2005,393,9504,9897
"5735","Newburyport","Essex County County","MA","Newburyport",2006,386,9371,9757
"5736","Newburyport","Essex County County","MA","Newburyport",2007,344,9418,9762
"5737","Newburyport","Essex County County","MA","Newburyport",2008,412,9450,9862
"5738","Newburyport","Essex County County","MA","Newburyport",2009,655,9162,9817
"5739","Newburyport","Essex County County","MA","Newburyport",2010,695,9206,9901
"5740","Newburyport","Essex County County","MA","Newburyport",2011,579,9318,9897
"5741","Newburyport","Essex County County","MA","Newburyport",2012,520,9421,9941
"5742","Newton","Middlesex County County","MA","Newton",1990,1659,46233,47892
"5743","Newton","Middlesex County County","MA","Newton",1991,2203,45051,47254
"5744","Newton","Middlesex County County","MA","Newton",1992,2386,45104,47490
"5745","Newton","Middlesex County County","MA","Newton",1993,1853,45766,47619
"5746","Newton","Middlesex County County","MA","Newton",1994,1596,46858,48454
"5747","Newton","Middlesex County County","MA","Newton",1995,1501,44470,45971
"5748","Newton","Middlesex County County","MA","Newton",1996,1062,45204,46266
"5749","Newton","Middlesex County County","MA","Newton",1997,1096,46301,47397
"5750","Newton","Middlesex County County","MA","Newton",1998,824,46812,47636
"5751","Newton","Middlesex County County","MA","Newton",1999,813,47091,47904
"5752","Newton","Middlesex County County","MA","Newton",2000,857,46486,47343
"5753","Newton","Middlesex County County","MA","Newton",2001,1290,46216,47506
"5754","Newton","Middlesex County County","MA","Newton",2002,1859,45283,47142
"5755","Newton","Middlesex County County","MA","Newton",2003,1912,44923,46835
"5756","Newton","Middlesex County County","MA","Newton",2004,1621,44738,46359
"5757","Newton","Middlesex County County","MA","Newton",2005,1559,44861,46420
"5758","Newton","Middlesex County County","MA","Newton",2006,1497,44221,45718
"5759","Newton","Middlesex County County","MA","Newton",2007,1366,44712,46078
"5760","Newton","Middlesex County County","MA","Newton",2008,1653,44751,46404
"5761","Newton","Middlesex County County","MA","Newton",2009,2563,43547,46110
"5762","Newton","Middlesex County County","MA","Newton",2010,2593,44490,47083
"5763","Newton","Middlesex County County","MA","Newton",2011,2199,45100,47299
"5764","Newton","Middlesex County County","MA","Newton",2012,2023,45594,47617
"5765","Norfolk","Norfolk County County","MA","Norfolk",1990,224,3977,4201
"5766","Norfolk","Norfolk County County","MA","Norfolk",1991,283,3994,4277
"5767","Norfolk","Norfolk County County","MA","Norfolk",1992,320,4061,4381
"5768","Norfolk","Norfolk County County","MA","Norfolk",1993,220,4200,4420
"5769","Norfolk","Norfolk County County","MA","Norfolk",1994,221,4348,4569
"5770","Norfolk","Norfolk County County","MA","Norfolk",1995,194,4348,4542
"5771","Norfolk","Norfolk County County","MA","Norfolk",1996,150,4452,4602
"5772","Norfolk","Norfolk County County","MA","Norfolk",1997,145,4589,4734
"5773","Norfolk","Norfolk County County","MA","Norfolk",1998,118,4777,4895
"5774","Norfolk","Norfolk County County","MA","Norfolk",1999,115,4835,4950
"5775","Norfolk","Norfolk County County","MA","Norfolk",2000,121,4584,4705
"5776","Norfolk","Norfolk County County","MA","Norfolk",2001,141,4535,4676
"5777","Norfolk","Norfolk County County","MA","Norfolk",2002,232,4441,4673
"5778","Norfolk","Norfolk County County","MA","Norfolk",2003,243,4402,4645
"5779","Norfolk","Norfolk County County","MA","Norfolk",2004,239,4419,4658
"5780","Norfolk","Norfolk County County","MA","Norfolk",2005,198,4464,4662
"5781","Norfolk","Norfolk County County","MA","Norfolk",2006,210,4570,4780
"5782","Norfolk","Norfolk County County","MA","Norfolk",2007,195,4642,4837
"5783","Norfolk","Norfolk County County","MA","Norfolk",2008,235,4697,4932
"5784","Norfolk","Norfolk County County","MA","Norfolk",2009,379,4541,4920
"5785","Norfolk","Norfolk County County","MA","Norfolk",2010,385,4627,5012
"5786","Norfolk","Norfolk County County","MA","Norfolk",2011,324,4674,4998
"5787","Norfolk","Norfolk County County","MA","Norfolk",2012,289,4725,5014
"5788",NA,"Norfolk County County","MA","Norfolk County County",1990,17712,326817,344529
"5789",NA,"Norfolk County County","MA","Norfolk County County",1991,24868,317154,342022
"5790",NA,"Norfolk County County","MA","Norfolk County County",1992,25228,316698,341926
"5791",NA,"Norfolk County County","MA","Norfolk County County",1993,20408,321416,341824
"5792",NA,"Norfolk County County","MA","Norfolk County County",1994,17415,327949,345364
"5793",NA,"Norfolk County County","MA","Norfolk County County",1995,15697,337160,352857
"5794",NA,"Norfolk County County","MA","Norfolk County County",1996,12784,344369,357153
"5795",NA,"Norfolk County County","MA","Norfolk County County",1997,11443,349054,360497
"5796",NA,"Norfolk County County","MA","Norfolk County County",1998,9174,354608,363782
"5797",NA,"Norfolk County County","MA","Norfolk County County",1999,8869,357802,366671
"5798",NA,"Norfolk County County","MA","Norfolk County County",2000,8358,348783,357141
"5799",NA,"Norfolk County County","MA","Norfolk County County",2001,11332,348311,359643
"5800",NA,"Norfolk County County","MA","Norfolk County County",2002,16710,343231,359941
"5801",NA,"Norfolk County County","MA","Norfolk County County",2003,18256,338109,356365
"5802",NA,"Norfolk County County","MA","Norfolk County County",2004,16191,338057,354248
"5803",NA,"Norfolk County County","MA","Norfolk County County",2005,14738,341067,355805
"5804",NA,"Norfolk County County","MA","Norfolk County County",2006,14683,337854,352537
"5805",NA,"Norfolk County County","MA","Norfolk County County",2007,13857,341241,355098
"5806",NA,"Norfolk County County","MA","Norfolk County County",2008,16950,341866,358816
"5807",NA,"Norfolk County County","MA","Norfolk County County",2009,26323,331719,358042
"5808",NA,"Norfolk County County","MA","Norfolk County County",2010,26535,338840,365375
"5809",NA,"Norfolk County County","MA","Norfolk County County",2011,22667,342649,365316
"5810",NA,"Norfolk County County","MA","Norfolk County County",2012,20543,346268,366811
"5811","North Adams","Berkshire County County","MA","North Adams",1990,978,7356,8334
"5812","North Adams","Berkshire County County","MA","North Adams",1991,1223,7044,8267
"5813","North Adams","Berkshire County County","MA","North Adams",1992,1088,6766,7854
"5814","North Adams","Berkshire County County","MA","North Adams",1993,775,7033,7808
"5815","North Adams","Berkshire County County","MA","North Adams",1994,656,7046,7702
"5816","North Adams","Berkshire County County","MA","North Adams",1995,546,6938,7484
"5817","North Adams","Berkshire County County","MA","North Adams",1996,477,7021,7498
"5818","North Adams","Berkshire County County","MA","North Adams",1997,419,7054,7473
"5819","North Adams","Berkshire County County","MA","North Adams",1998,327,7154,7481
"5820","North Adams","Berkshire County County","MA","North Adams",1999,306,7183,7489
"5821","North Adams","Berkshire County County","MA","North Adams",2000,249,6955,7204
"5822","North Adams","Berkshire County County","MA","North Adams",2001,314,6968,7282
"5823","North Adams","Berkshire County County","MA","North Adams",2002,428,6916,7344
"5824","North Adams","Berkshire County County","MA","North Adams",2003,464,6806,7270
"5825","North Adams","Berkshire County County","MA","North Adams",2004,441,6733,7174
"5826","North Adams","Berkshire County County","MA","North Adams",2005,391,6715,7106
"5827","North Adams","Berkshire County County","MA","North Adams",2006,401,6733,7134
"5828","North Adams","Berkshire County County","MA","North Adams",2007,424,6717,7141
"5829","North Adams","Berkshire County County","MA","North Adams",2008,485,6771,7256
"5830","North Adams","Berkshire County County","MA","North Adams",2009,688,6680,7368
"5831","North Adams","Berkshire County County","MA","North Adams",2010,742,6513,7255
"5832","North Adams","Berkshire County County","MA","North Adams",2011,678,6505,7183
"5833","North Adams","Berkshire County County","MA","North Adams",2012,570,6419,6989
"5834","North Andover","Essex County County","MA","North Andover",1990,583,11283,11866
"5835","North Andover","Essex County County","MA","North Andover",1991,847,11259,12106
"5836","North Andover","Essex County County","MA","North Andover",1992,896,11511,12407
"5837","North Andover","Essex County County","MA","North Andover",1993,751,11822,12573
"5838","North Andover","Essex County County","MA","North Andover",1994,682,12181,12863
"5839","North Andover","Essex County County","MA","North Andover",1995,588,11941,12529
"5840","North Andover","Essex County County","MA","North Andover",1996,504,12540,13044
"5841","North Andover","Essex County County","MA","North Andover",1997,521,12818,13339
"5842","North Andover","Essex County County","MA","North Andover",1998,406,14194,14600
"5843","North Andover","Essex County County","MA","North Andover",1999,432,14520,14952
"5844","North Andover","Essex County County","MA","North Andover",2000,309,13397,13706
"5845","North Andover","Essex County County","MA","North Andover",2001,461,13354,13815
"5846","North Andover","Essex County County","MA","North Andover",2002,700,13024,13724
"5847","North Andover","Essex County County","MA","North Andover",2003,707,12735,13442
"5848","North Andover","Essex County County","MA","North Andover",2004,592,12625,13217
"5849","North Andover","Essex County County","MA","North Andover",2005,562,12682,13244
"5850","North Andover","Essex County County","MA","North Andover",2006,547,12818,13365
"5851","North Andover","Essex County County","MA","North Andover",2007,523,13045,13568
"5852","North Andover","Essex County County","MA","North Andover",2008,622,12800,13422
"5853","North Andover","Essex County County","MA","North Andover",2009,1033,12485,13518
"5854","North Andover","Essex County County","MA","North Andover",2010,1016,13071,14087
"5855","North Andover","Essex County County","MA","North Andover",2011,832,13237,14069
"5856","North Andover","Essex County County","MA","North Andover",2012,808,13411,14219
"5857","North Attleborough","Bristol County County","MA","North Attleborough",1990,863,13870,14733
"5858","North Attleborough","Bristol County County","MA","North Attleborough",1991,1340,13385,14725
"5859","North Attleborough","Bristol County County","MA","North Attleborough",1992,1401,13619,15020
"5860","North Attleborough","Bristol County County","MA","North Attleborough",1993,1000,14120,15120
"5861","North Attleborough","Bristol County County","MA","North Attleborough",1994,884,14504,15388
"5862","North Attleborough","Bristol County County","MA","North Attleborough",1995,811,14097,14908
"5863","North Attleborough","Bristol County County","MA","North Attleborough",1996,678,14244,14922
"5864","North Attleborough","Bristol County County","MA","North Attleborough",1997,667,14587,15254
"5865","North Attleborough","Bristol County County","MA","North Attleborough",1998,486,14762,15248
"5866","North Attleborough","Bristol County County","MA","North Attleborough",1999,451,14948,15399
"5867","North Attleborough","Bristol County County","MA","North Attleborough",2000,458,15419,15877
"5868","North Attleborough","Bristol County County","MA","North Attleborough",2001,625,15358,15983
"5869","North Attleborough","Bristol County County","MA","North Attleborough",2002,837,15579,16416
"5870","North Attleborough","Bristol County County","MA","North Attleborough",2003,859,15765,16624
"5871","North Attleborough","Bristol County County","MA","North Attleborough",2004,802,15840,16642
"5872","North Attleborough","Bristol County County","MA","North Attleborough",2005,722,15927,16649
"5873","North Attleborough","Bristol County County","MA","North Attleborough",2006,720,15986,16706
"5874","North Attleborough","Bristol County County","MA","North Attleborough",2007,706,16005,16711
"5875","North Attleborough","Bristol County County","MA","North Attleborough",2008,956,15702,16658
"5876","North Attleborough","Bristol County County","MA","North Attleborough",2009,1635,14984,16619
"5877","North Attleborough","Bristol County County","MA","North Attleborough",2010,1555,15415,16970
"5878","North Attleborough","Bristol County County","MA","North Attleborough",2011,1426,15527,16953
"5879","North Attleborough","Bristol County County","MA","North Attleborough",2012,1292,15552,16844
"5880","North Brookfield","Worcester County County","MA","North Brookfield",1990,156,2345,2501
"5881","North Brookfield","Worcester County County","MA","North Brookfield",1991,220,2313,2533
"5882","North Brookfield","Worcester County County","MA","North Brookfield",1992,228,2305,2533
"5883","North Brookfield","Worcester County County","MA","North Brookfield",1993,173,2362,2535
"5884","North Brookfield","Worcester County County","MA","North Brookfield",1994,111,2372,2483
"5885","North Brookfield","Worcester County County","MA","North Brookfield",1995,101,2372,2473
"5886","North Brookfield","Worcester County County","MA","North Brookfield",1996,96,2405,2501
"5887","North Brookfield","Worcester County County","MA","North Brookfield",1997,82,2459,2541
"5888","North Brookfield","Worcester County County","MA","North Brookfield",1998,75,2504,2579
"5889","North Brookfield","Worcester County County","MA","North Brookfield",1999,77,2492,2569
"5890","North Brookfield","Worcester County County","MA","North Brookfield",2000,64,2396,2460
"5891","North Brookfield","Worcester County County","MA","North Brookfield",2001,88,2402,2490
"5892","North Brookfield","Worcester County County","MA","North Brookfield",2002,111,2390,2501
"5893","North Brookfield","Worcester County County","MA","North Brookfield",2003,136,2384,2520
"5894","North Brookfield","Worcester County County","MA","North Brookfield",2004,144,2375,2519
"5895","North Brookfield","Worcester County County","MA","North Brookfield",2005,118,2367,2485
"5896","North Brookfield","Worcester County County","MA","North Brookfield",2006,134,2477,2611
"5897","North Brookfield","Worcester County County","MA","North Brookfield",2007,124,2490,2614
"5898","North Brookfield","Worcester County County","MA","North Brookfield",2008,158,2439,2597
"5899","North Brookfield","Worcester County County","MA","North Brookfield",2009,225,2373,2598
"5900","North Brookfield","Worcester County County","MA","North Brookfield",2010,211,2203,2414
"5901","North Brookfield","Worcester County County","MA","North Brookfield",2011,188,2222,2410
"5902","North Brookfield","Worcester County County","MA","North Brookfield",2012,180,2221,2401
"5903","North Reading","Middlesex County County","MA","North Reading",1990,403,6607,7010
"5904","North Reading","Middlesex County County","MA","North Reading",1991,527,6443,6970
"5905","North Reading","Middlesex County County","MA","North Reading",1992,546,6478,7024
"5906","North Reading","Middlesex County County","MA","North Reading",1993,410,6694,7104
"5907","North Reading","Middlesex County County","MA","North Reading",1994,360,6918,7278
"5908","North Reading","Middlesex County County","MA","North Reading",1995,327,6900,7227
"5909","North Reading","Middlesex County County","MA","North Reading",1996,248,7138,7386
"5910","North Reading","Middlesex County County","MA","North Reading",1997,212,7389,7601
"5911","North Reading","Middlesex County County","MA","North Reading",1998,193,7537,7730
"5912","North Reading","Middlesex County County","MA","North Reading",1999,198,7679,7877
"5913","North Reading","Middlesex County County","MA","North Reading",2000,169,7723,7892
"5914","North Reading","Middlesex County County","MA","North Reading",2001,236,7727,7963
"5915","North Reading","Middlesex County County","MA","North Reading",2002,358,7593,7951
"5916","North Reading","Middlesex County County","MA","North Reading",2003,397,7499,7896
"5917","North Reading","Middlesex County County","MA","North Reading",2004,337,7501,7838
"5918","North Reading","Middlesex County County","MA","North Reading",2005,309,7563,7872
"5919","North Reading","Middlesex County County","MA","North Reading",2006,292,6720,7012
"5920","North Reading","Middlesex County County","MA","North Reading",2007,260,6630,6890
"5921","North Reading","Middlesex County County","MA","North Reading",2008,365,7758,8123
"5922","North Reading","Middlesex County County","MA","North Reading",2009,587,7491,8078
"5923","North Reading","Middlesex County County","MA","North Reading",2010,596,7821,8417
"5924","North Reading","Middlesex County County","MA","North Reading",2011,502,7937,8439
"5925","North Reading","Middlesex County County","MA","North Reading",2012,467,8025,8492
"5926","Northampton","Hampshire County County","MA","Northampton",1990,825,15580,16405
"5927","Northampton","Hampshire County County","MA","Northampton",1991,1113,15025,16138
"5928","Northampton","Hampshire County County","MA","Northampton",1992,1142,14848,15990
"5929","Northampton","Hampshire County County","MA","Northampton",1993,842,14834,15676
"5930","Northampton","Hampshire County County","MA","Northampton",1994,739,14904,15643
"5931","Northampton","Hampshire County County","MA","Northampton",1995,602,14964,15566
"5932","Northampton","Hampshire County County","MA","Northampton",1996,523,15167,15690
"5933","Northampton","Hampshire County County","MA","Northampton",1997,423,15532,15955
"5934","Northampton","Hampshire County County","MA","Northampton",1998,407,15421,15828
"5935","Northampton","Hampshire County County","MA","Northampton",1999,372,15480,15852
"5936","Northampton","Hampshire County County","MA","Northampton",2000,353,16734,17087
"5937","Northampton","Hampshire County County","MA","Northampton",2001,427,16663,17090
"5938","Northampton","Hampshire County County","MA","Northampton",2002,557,16613,17170
"5939","Northampton","Hampshire County County","MA","Northampton",2003,666,16442,17108
"5940","Northampton","Hampshire County County","MA","Northampton",2004,650,16356,17006
"5941","Northampton","Hampshire County County","MA","Northampton",2005,603,16322,16925
"5942","Northampton","Hampshire County County","MA","Northampton",2006,625,16363,16988
"5943","Northampton","Hampshire County County","MA","Northampton",2007,594,16305,16899
"5944","Northampton","Hampshire County County","MA","Northampton",2008,668,16141,16809
"5945","Northampton","Hampshire County County","MA","Northampton",2009,967,15486,16453
"5946","Northampton","Hampshire County County","MA","Northampton",2010,957,15537,16494
"5947","Northampton","Hampshire County County","MA","Northampton",2011,866,15346,16212
"5948","Northampton","Hampshire County County","MA","Northampton",2012,814,15356,16170
"5949","Northborough","Worcester County County","MA","Northborough",1990,323,6615,6938
"5950","Northborough","Worcester County County","MA","Northborough",1991,489,6432,6921
"5951","Northborough","Worcester County County","MA","Northborough",1992,473,6542,7015
"5952","Northborough","Worcester County County","MA","Northborough",1993,410,6831,7241
"5953","Northborough","Worcester County County","MA","Northborough",1994,348,7064,7412
"5954","Northborough","Worcester County County","MA","Northborough",1995,287,6946,7233
"5955","Northborough","Worcester County County","MA","Northborough",1996,226,7169,7395
"5956","Northborough","Worcester County County","MA","Northborough",1997,224,7448,7672
"5957","Northborough","Worcester County County","MA","Northborough",1998,179,7651,7830
"5958","Northborough","Worcester County County","MA","Northborough",1999,208,7747,7955
"5959","Northborough","Worcester County County","MA","Northborough",2000,161,7732,7893
"5960","Northborough","Worcester County County","MA","Northborough",2001,249,7728,7977
"5961","Northborough","Worcester County County","MA","Northborough",2002,394,7668,8062
"5962","Northborough","Worcester County County","MA","Northborough",2003,401,7618,8019
"5963","Northborough","Worcester County County","MA","Northborough",2004,340,7622,7962
"5964","Northborough","Worcester County County","MA","Northborough",2005,290,7787,8077
"5965","Northborough","Worcester County County","MA","Northborough",2006,283,7784,8067
"5966","Northborough","Worcester County County","MA","Northborough",2007,291,7813,8104
"5967","Northborough","Worcester County County","MA","Northborough",2008,330,7691,8021
"5968","Northborough","Worcester County County","MA","Northborough",2009,575,7525,8100
"5969","Northborough","Worcester County County","MA","Northborough",2010,525,7189,7714
"5970","Northborough","Worcester County County","MA","Northborough",2011,479,7253,7732
"5971","Northborough","Worcester County County","MA","Northborough",2012,431,7250,7681
"5972","Northbridge","Worcester County County","MA","Northbridge",1990,496,6360,6856
"5973","Northbridge","Worcester County County","MA","Northbridge",1991,689,6018,6707
"5974","Northbridge","Worcester County County","MA","Northbridge",1992,620,5954,6574
"5975","Northbridge","Worcester County County","MA","Northbridge",1993,543,6122,6665
"5976","Northbridge","Worcester County County","MA","Northbridge",1994,367,6266,6633
"5977","Northbridge","Worcester County County","MA","Northbridge",1995,355,6416,6771
"5978","Northbridge","Worcester County County","MA","Northbridge",1996,330,6568,6898
"5979","Northbridge","Worcester County County","MA","Northbridge",1997,292,6788,7080
"5980","Northbridge","Worcester County County","MA","Northbridge",1998,260,7022,7282
"5981","Northbridge","Worcester County County","MA","Northbridge",1999,228,7041,7269
"5982","Northbridge","Worcester County County","MA","Northbridge",2000,191,6669,6860
"5983","Northbridge","Worcester County County","MA","Northbridge",2001,272,6679,6951
"5984","Northbridge","Worcester County County","MA","Northbridge",2002,453,6680,7133
"5985","Northbridge","Worcester County County","MA","Northbridge",2003,484,6710,7194
"5986","Northbridge","Worcester County County","MA","Northbridge",2004,429,6772,7201
"5987","Northbridge","Worcester County County","MA","Northbridge",2005,373,6913,7286
"5988","Northbridge","Worcester County County","MA","Northbridge",2006,376,7088,7464
"5989","Northbridge","Worcester County County","MA","Northbridge",2007,418,7126,7544
"5990","Northbridge","Worcester County County","MA","Northbridge",2008,481,7009,7490
"5991","Northbridge","Worcester County County","MA","Northbridge",2009,704,6828,7532
"5992","Northbridge","Worcester County County","MA","Northbridge",2010,731,7312,8043
"5993","Northbridge","Worcester County County","MA","Northbridge",2011,650,7377,8027
"5994","Northbridge","Worcester County County","MA","Northbridge",2012,626,7374,8000
"5995","Northfield","Franklin County County","MA","Northfield",1990,87,1497,1584
"5996","Northfield","Franklin County County","MA","Northfield",1991,95,1531,1626
"5997","Northfield","Franklin County County","MA","Northfield",1992,104,1501,1605
"5998","Northfield","Franklin County County","MA","Northfield",1993,62,1529,1591
"5999","Northfield","Franklin County County","MA","Northfield",1994,57,1631,1688
"6000","Northfield","Franklin County County","MA","Northfield",1995,52,1533,1585
"6001","Northfield","Franklin County County","MA","Northfield",1996,54,1553,1607
"6002","Northfield","Franklin County County","MA","Northfield",1997,48,1600,1648
"6003","Northfield","Franklin County County","MA","Northfield",1998,46,1645,1691
"6004","Northfield","Franklin County County","MA","Northfield",1999,36,1690,1726
"6005","Northfield","Franklin County County","MA","Northfield",2000,36,1687,1723
"6006","Northfield","Franklin County County","MA","Northfield",2001,43,1704,1747
"6007","Northfield","Franklin County County","MA","Northfield",2002,59,1754,1813
"6008","Northfield","Franklin County County","MA","Northfield",2003,78,1786,1864
"6009","Northfield","Franklin County County","MA","Northfield",2004,69,1787,1856
"6010","Northfield","Franklin County County","MA","Northfield",2005,69,1816,1885
"6011","Northfield","Franklin County County","MA","Northfield",2006,68,1853,1921
"6012","Northfield","Franklin County County","MA","Northfield",2007,59,1677,1736
"6013","Northfield","Franklin County County","MA","Northfield",2008,75,1673,1748
"6014","Northfield","Franklin County County","MA","Northfield",2009,113,1629,1742
"6015","Northfield","Franklin County County","MA","Northfield",2010,117,1659,1776
"6016","Northfield","Franklin County County","MA","Northfield",2011,92,1661,1753
"6017","Northfield","Franklin County County","MA","Northfield",2012,76,1666,1742
"6018","Norton","Bristol County County","MA","Norton",1990,588,7742,8330
"6019","Norton","Bristol County County","MA","Norton",1991,697,7741,8438
"6020","Norton","Bristol County County","MA","Norton",1992,699,7878,8577
"6021","Norton","Bristol County County","MA","Norton",1993,536,8068,8604
"6022","Norton","Bristol County County","MA","Norton",1994,511,8356,8867
"6023","Norton","Bristol County County","MA","Norton",1995,415,8276,8691
"6024","Norton","Bristol County County","MA","Norton",1996,398,8512,8910
"6025","Norton","Bristol County County","MA","Norton",1997,365,8814,9179
"6026","Norton","Bristol County County","MA","Norton",1998,278,9024,9302
"6027","Norton","Bristol County County","MA","Norton",1999,289,9225,9514
"6028","Norton","Bristol County County","MA","Norton",2000,244,9412,9656
"6029","Norton","Bristol County County","MA","Norton",2001,336,9468,9804
"6030","Norton","Bristol County County","MA","Norton",2002,501,9516,10017
"6031","Norton","Bristol County County","MA","Norton",2003,541,9665,10206
"6032","Norton","Bristol County County","MA","Norton",2004,516,9679,10195
"6033","Norton","Bristol County County","MA","Norton",2005,521,9858,10379
"6034","Norton","Bristol County County","MA","Norton",2006,529,10018,10547
"6035","Norton","Bristol County County","MA","Norton",2007,504,10095,10599
"6036","Norton","Bristol County County","MA","Norton",2008,604,10062,10666
"6037","Norton","Bristol County County","MA","Norton",2009,915,9742,10657
"6038","Norton","Bristol County County","MA","Norton",2010,938,9562,10500
"6039","Norton","Bristol County County","MA","Norton",2011,763,9660,10423
"6040","Norton","Bristol County County","MA","Norton",2012,725,9631,10356
"6041","Norwell","Plymouth County County","MA","Norwell",1990,260,4918,5178
"6042","Norwell","Plymouth County County","MA","Norwell",1991,323,4782,5105
"6043","Norwell","Plymouth County County","MA","Norwell",1992,347,4835,5182
"6044","Norwell","Plymouth County County","MA","Norwell",1993,236,4905,5141
"6045","Norwell","Plymouth County County","MA","Norwell",1994,191,4978,5169
"6046","Norwell","Plymouth County County","MA","Norwell",1995,197,5010,5207
"6047","Norwell","Plymouth County County","MA","Norwell",1996,168,5141,5309
"6048","Norwell","Plymouth County County","MA","Norwell",1997,135,5326,5461
"6049","Norwell","Plymouth County County","MA","Norwell",1998,119,5493,5612
"6050","Norwell","Plymouth County County","MA","Norwell",1999,111,5606,5717
"6051","Norwell","Plymouth County County","MA","Norwell",2000,95,5054,5149
"6052","Norwell","Plymouth County County","MA","Norwell",2001,141,5129,5270
"6053","Norwell","Plymouth County County","MA","Norwell",2002,197,5107,5304
"6054","Norwell","Plymouth County County","MA","Norwell",2003,223,5102,5325
"6055","Norwell","Plymouth County County","MA","Norwell",2004,196,5150,5346
"6056","Norwell","Plymouth County County","MA","Norwell",2005,201,5208,5409
"6057","Norwell","Plymouth County County","MA","Norwell",2006,197,5080,5277
"6058","Norwell","Plymouth County County","MA","Norwell",2007,194,5111,5305
"6059","Norwell","Plymouth County County","MA","Norwell",2008,232,5106,5338
"6060","Norwell","Plymouth County County","MA","Norwell",2009,356,4941,5297
"6061","Norwell","Plymouth County County","MA","Norwell",2010,324,5097,5421
"6062","Norwell","Plymouth County County","MA","Norwell",2011,316,5146,5462
"6063","Norwell","Plymouth County County","MA","Norwell",2012,242,5202,5444
"6064","Norwood","Norfolk County County","MA","Norwood",1990,971,15464,16435
"6065","Norwood","Norfolk County County","MA","Norwood",1991,1283,15104,16387
"6066","Norwood","Norfolk County County","MA","Norwood",1992,1294,14888,16182
"6067","Norwood","Norfolk County County","MA","Norwood",1993,1002,14971,15973
"6068","Norwood","Norfolk County County","MA","Norwood",1994,869,15152,16021
"6069","Norwood","Norfolk County County","MA","Norwood",1995,784,15448,16232
"6070","Norwood","Norfolk County County","MA","Norwood",1996,565,15708,16273
"6071","Norwood","Norfolk County County","MA","Norwood",1997,548,16046,16594
"6072","Norwood","Norfolk County County","MA","Norwood",1998,431,16221,16652
"6073","Norwood","Norfolk County County","MA","Norwood",1999,431,16290,16721
"6074","Norwood","Norfolk County County","MA","Norwood",2000,372,15583,15955
"6075","Norwood","Norfolk County County","MA","Norwood",2001,481,15520,16001
"6076","Norwood","Norfolk County County","MA","Norwood",2002,759,15334,16093
"6077","Norwood","Norfolk County County","MA","Norwood",2003,790,15067,15857
"6078","Norwood","Norfolk County County","MA","Norwood",2004,720,14989,15709
"6079","Norwood","Norfolk County County","MA","Norwood",2005,655,15105,15760
"6080","Norwood","Norfolk County County","MA","Norwood",2006,627,14840,15467
"6081","Norwood","Norfolk County County","MA","Norwood",2007,609,14956,15565
"6082","Norwood","Norfolk County County","MA","Norwood",2008,746,14927,15673
"6083","Norwood","Norfolk County County","MA","Norwood",2009,1126,14396,15522
"6084","Norwood","Norfolk County County","MA","Norwood",2010,1135,14695,15830
"6085","Norwood","Norfolk County County","MA","Norwood",2011,978,14861,15839
"6086","Norwood","Norfolk County County","MA","Norwood",2012,893,15024,15917
"6087","Oak Bluffs","Dukes County County","MA","Oak Bluffs",1990,83,1674,1757
"6088","Oak Bluffs","Dukes County County","MA","Oak Bluffs",1991,111,1695,1806
"6089","Oak Bluffs","Dukes County County","MA","Oak Bluffs",1992,121,1646,1767
"6090","Oak Bluffs","Dukes County County","MA","Oak Bluffs",1993,129,1680,1809
"6091","Oak Bluffs","Dukes County County","MA","Oak Bluffs",1994,105,1821,1926
"6092","Oak Bluffs","Dukes County County","MA","Oak Bluffs",1995,102,1886,1988
"6093","Oak Bluffs","Dukes County County","MA","Oak Bluffs",1996,93,1965,2058
"6094","Oak Bluffs","Dukes County County","MA","Oak Bluffs",1997,100,2014,2114
"6095","Oak Bluffs","Dukes County County","MA","Oak Bluffs",1998,74,2041,2115
"6096","Oak Bluffs","Dukes County County","MA","Oak Bluffs",1999,66,2070,2136
"6097","Oak Bluffs","Dukes County County","MA","Oak Bluffs",2000,60,2336,2396
"6098","Oak Bluffs","Dukes County County","MA","Oak Bluffs",2001,61,2347,2408
"6099","Oak Bluffs","Dukes County County","MA","Oak Bluffs",2002,81,2430,2511
"6100","Oak Bluffs","Dukes County County","MA","Oak Bluffs",2003,113,2507,2620
"6101","Oak Bluffs","Dukes County County","MA","Oak Bluffs",2004,109,2512,2621
"6102","Oak Bluffs","Dukes County County","MA","Oak Bluffs",2005,95,2464,2559
"6103","Oak Bluffs","Dukes County County","MA","Oak Bluffs",2006,100,2481,2581
"6104","Oak Bluffs","Dukes County County","MA","Oak Bluffs",2007,90,2493,2583
"6105","Oak Bluffs","Dukes County County","MA","Oak Bluffs",2008,108,2490,2598
"6106","Oak Bluffs","Dukes County County","MA","Oak Bluffs",2009,184,2535,2719
"6107","Oak Bluffs","Dukes County County","MA","Oak Bluffs",2010,210,2814,3024
"6108","Oak Bluffs","Dukes County County","MA","Oak Bluffs",2011,221,2835,3056
"6109","Oak Bluffs","Dukes County County","MA","Oak Bluffs",2012,205,2863,3068
"6110","Oakham","Worcester County County","MA","Oakham",1990,46,727,773
"6111","Oakham","Worcester County County","MA","Oakham",1991,95,735,830
"6112","Oakham","Worcester County County","MA","Oakham",1992,70,737,807
"6113","Oakham","Worcester County County","MA","Oakham",1993,68,777,845
"6114","Oakham","Worcester County County","MA","Oakham",1994,48,787,835
"6115","Oakham","Worcester County County","MA","Oakham",1995,43,781,824
"6116","Oakham","Worcester County County","MA","Oakham",1996,40,798,838
"6117","Oakham","Worcester County County","MA","Oakham",1997,36,822,858
"6118","Oakham","Worcester County County","MA","Oakham",1998,37,845,882
"6119","Oakham","Worcester County County","MA","Oakham",1999,30,848,878
"6120","Oakham","Worcester County County","MA","Oakham",2000,23,923,946
"6121","Oakham","Worcester County County","MA","Oakham",2001,34,937,971
"6122","Oakham","Worcester County County","MA","Oakham",2002,47,948,995
"6123","Oakham","Worcester County County","MA","Oakham",2003,64,972,1036
"6124","Oakham","Worcester County County","MA","Oakham",2004,69,997,1066
"6125","Oakham","Worcester County County","MA","Oakham",2005,55,1004,1059
"6126","Oakham","Worcester County County","MA","Oakham",2006,52,1016,1068
"6127","Oakham","Worcester County County","MA","Oakham",2007,49,1022,1071
"6128","Oakham","Worcester County County","MA","Oakham",2008,54,1008,1062
"6129","Oakham","Worcester County County","MA","Oakham",2009,94,982,1076
"6130","Oakham","Worcester County County","MA","Oakham",2010,101,964,1065
"6131","Oakham","Worcester County County","MA","Oakham",2011,79,972,1051
"6132","Oakham","Worcester County County","MA","Oakham",2012,69,972,1041
"6133","Orange","Franklin County County","MA","Orange",1990,332,3223,3555
"6134","Orange","Franklin County County","MA","Orange",1991,478,3042,3520
"6135","Orange","Franklin County County","MA","Orange",1992,449,3088,3537
"6136","Orange","Franklin County County","MA","Orange",1993,351,3124,3475
"6137","Orange","Franklin County County","MA","Orange",1994,273,3110,3383
"6138","Orange","Franklin County County","MA","Orange",1995,228,3069,3297
"6139","Orange","Franklin County County","MA","Orange",1996,194,3052,3246
"6140","Orange","Franklin County County","MA","Orange",1997,213,3088,3301
"6141","Orange","Franklin County County","MA","Orange",1998,173,3110,3283
"6142","Orange","Franklin County County","MA","Orange",1999,144,3088,3232
"6143","Orange","Franklin County County","MA","Orange",2000,112,3710,3822
"6144","Orange","Franklin County County","MA","Orange",2001,151,3623,3774
"6145","Orange","Franklin County County","MA","Orange",2002,195,3627,3822
"6146","Orange","Franklin County County","MA","Orange",2003,227,3565,3792
"6147","Orange","Franklin County County","MA","Orange",2004,215,3503,3718
"6148","Orange","Franklin County County","MA","Orange",2005,200,3513,3713
"6149","Orange","Franklin County County","MA","Orange",2006,186,3528,3714
"6150","Orange","Franklin County County","MA","Orange",2007,193,3537,3730
"6151","Orange","Franklin County County","MA","Orange",2008,256,3527,3783
"6152","Orange","Franklin County County","MA","Orange",2009,404,3375,3779
"6153","Orange","Franklin County County","MA","Orange",2010,411,3409,3820
"6154","Orange","Franklin County County","MA","Orange",2011,344,3402,3746
"6155","Orange","Franklin County County","MA","Orange",2012,339,3413,3752
"6156","Orleans","Barnstable County County","MA","Orleans",1990,146,2703,2849
"6157","Orleans","Barnstable County County","MA","Orleans",1991,294,2568,2862
"6158","Orleans","Barnstable County County","MA","Orleans",1992,235,2525,2760
"6159","Orleans","Barnstable County County","MA","Orleans",1993,236,2565,2801
"6160","Orleans","Barnstable County County","MA","Orleans",1994,226,2623,2849
"6161","Orleans","Barnstable County County","MA","Orleans",1995,169,2788,2957
"6162","Orleans","Barnstable County County","MA","Orleans",1996,162,2855,3017
"6163","Orleans","Barnstable County County","MA","Orleans",1997,169,2895,3064
"6164","Orleans","Barnstable County County","MA","Orleans",1998,137,2942,3079
"6165","Orleans","Barnstable County County","MA","Orleans",1999,110,3052,3162
"6166","Orleans","Barnstable County County","MA","Orleans",2000,103,2775,2878
"6167","Orleans","Barnstable County County","MA","Orleans",2001,119,2799,2918
"6168","Orleans","Barnstable County County","MA","Orleans",2002,138,2845,2983
"6169","Orleans","Barnstable County County","MA","Orleans",2003,164,2902,3066
"6170","Orleans","Barnstable County County","MA","Orleans",2004,148,2931,3079
"6171","Orleans","Barnstable County County","MA","Orleans",2005,137,2940,3077
"6172","Orleans","Barnstable County County","MA","Orleans",2006,154,2941,3095
"6173","Orleans","Barnstable County County","MA","Orleans",2007,137,2920,3057
"6174","Orleans","Barnstable County County","MA","Orleans",2008,160,2895,3055
"6175","Orleans","Barnstable County County","MA","Orleans",2009,223,2808,3031
"6176","Orleans","Barnstable County County","MA","Orleans",2010,244,2681,2925
"6177","Orleans","Barnstable County County","MA","Orleans",2011,237,2677,2914
"6178","Orleans","Barnstable County County","MA","Orleans",2012,193,2722,2915
"6179","Otis","Berkshire County County","MA","Otis",1990,46,546,592
"6180","Otis","Berkshire County County","MA","Otis",1991,54,544,598
"6181","Otis","Berkshire County County","MA","Otis",1992,58,567,625
"6182","Otis","Berkshire County County","MA","Otis",1993,59,575,634
"6183","Otis","Berkshire County County","MA","Otis",1994,44,600,644
"6184","Otis","Berkshire County County","MA","Otis",1995,41,588,629
"6185","Otis","Berkshire County County","MA","Otis",1996,37,600,637
"6186","Otis","Berkshire County County","MA","Otis",1997,29,614,643
"6187","Otis","Berkshire County County","MA","Otis",1998,23,609,632
"6188","Otis","Berkshire County County","MA","Otis",1999,24,607,631
"6189","Otis","Berkshire County County","MA","Otis",2000,25,743,768
"6190","Otis","Berkshire County County","MA","Otis",2001,22,768,790
"6191","Otis","Berkshire County County","MA","Otis",2002,35,796,831
"6192","Otis","Berkshire County County","MA","Otis",2003,41,801,842
"6193","Otis","Berkshire County County","MA","Otis",2004,44,802,846
"6194","Otis","Berkshire County County","MA","Otis",2005,31,823,854
"6195","Otis","Berkshire County County","MA","Otis",2006,39,829,868
"6196","Otis","Berkshire County County","MA","Otis",2007,37,820,857
"6197","Otis","Berkshire County County","MA","Otis",2008,41,823,864
"6198","Otis","Berkshire County County","MA","Otis",2009,61,800,861
"6199","Otis","Berkshire County County","MA","Otis",2010,67,931,998
"6200","Otis","Berkshire County County","MA","Otis",2011,57,936,993
"6201","Otis","Berkshire County County","MA","Otis",2012,56,929,985
"6202","Oxford","Worcester County County","MA","Oxford",1990,495,6221,6716
"6203","Oxford","Worcester County County","MA","Oxford",1991,711,6061,6772
"6204","Oxford","Worcester County County","MA","Oxford",1992,668,6198,6866
"6205","Oxford","Worcester County County","MA","Oxford",1993,486,6371,6857
"6206","Oxford","Worcester County County","MA","Oxford",1994,409,6529,6938
"6207","Oxford","Worcester County County","MA","Oxford",1995,392,6339,6731
"6208","Oxford","Worcester County County","MA","Oxford",1996,315,6469,6784
"6209","Oxford","Worcester County County","MA","Oxford",1997,285,6678,6963
"6210","Oxford","Worcester County County","MA","Oxford",1998,267,6836,7103
"6211","Oxford","Worcester County County","MA","Oxford",1999,221,6839,7060
"6212","Oxford","Worcester County County","MA","Oxford",2000,205,7377,7582
"6213","Oxford","Worcester County County","MA","Oxford",2001,255,7413,7668
"6214","Oxford","Worcester County County","MA","Oxford",2002,394,7375,7769
"6215","Oxford","Worcester County County","MA","Oxford",2003,450,7336,7786
"6216","Oxford","Worcester County County","MA","Oxford",2004,401,7311,7712
"6217","Oxford","Worcester County County","MA","Oxford",2005,378,7279,7657
"6218","Oxford","Worcester County County","MA","Oxford",2006,370,7332,7702
"6219","Oxford","Worcester County County","MA","Oxford",2007,347,7349,7696
"6220","Oxford","Worcester County County","MA","Oxford",2008,435,7198,7633
"6221","Oxford","Worcester County County","MA","Oxford",2009,685,6992,7677
"6222","Oxford","Worcester County County","MA","Oxford",2010,657,6964,7621
"6223","Oxford","Worcester County County","MA","Oxford",2011,574,7026,7600
"6224","Oxford","Worcester County County","MA","Oxford",2012,522,7024,7546
"6225","Palmer","Hampden County County","MA","Palmer",1990,409,5785,6194
"6226","Palmer","Hampden County County","MA","Palmer",1991,590,5591,6181
"6227","Palmer","Hampden County County","MA","Palmer",1992,555,5665,6220
"6228","Palmer","Hampden County County","MA","Palmer",1993,580,5627,6207
"6229","Palmer","Hampden County County","MA","Palmer",1994,554,5647,6201
"6230","Palmer","Hampden County County","MA","Palmer",1995,378,5561,5939
"6231","Palmer","Hampden County County","MA","Palmer",1996,320,5623,5943
"6232","Palmer","Hampden County County","MA","Palmer",1997,308,5747,6055
"6233","Palmer","Hampden County County","MA","Palmer",1998,294,5769,6063
"6234","Palmer","Hampden County County","MA","Palmer",1999,249,5784,6033
"6235","Palmer","Hampden County County","MA","Palmer",2000,209,6548,6757
"6236","Palmer","Hampden County County","MA","Palmer",2001,277,6594,6871
"6237","Palmer","Hampden County County","MA","Palmer",2002,381,6598,6979
"6238","Palmer","Hampden County County","MA","Palmer",2003,443,6574,7017
"6239","Palmer","Hampden County County","MA","Palmer",2004,452,6616,7068
"6240","Palmer","Hampden County County","MA","Palmer",2005,366,6654,7020
"6241","Palmer","Hampden County County","MA","Palmer",2006,402,6699,7101
"6242","Palmer","Hampden County County","MA","Palmer",2007,373,6678,7051
"6243","Palmer","Hampden County County","MA","Palmer",2008,424,6662,7086
"6244","Palmer","Hampden County County","MA","Palmer",2009,624,6442,7066
"6245","Palmer","Hampden County County","MA","Palmer",2010,659,5984,6643
"6246","Palmer","Hampden County County","MA","Palmer",2011,556,5925,6481
"6247","Palmer","Hampden County County","MA","Palmer",2012,522,5928,6450
"6248","Paxton","Worcester County County","MA","Paxton",1990,71,2130,2201
"6249","Paxton","Worcester County County","MA","Paxton",1991,134,2072,2206
"6250","Paxton","Worcester County County","MA","Paxton",1992,139,2119,2258
"6251","Paxton","Worcester County County","MA","Paxton",1993,80,2173,2253
"6252","Paxton","Worcester County County","MA","Paxton",1994,76,2202,2278
"6253","Paxton","Worcester County County","MA","Paxton",1995,69,2140,2209
"6254","Paxton","Worcester County County","MA","Paxton",1996,65,2181,2246
"6255","Paxton","Worcester County County","MA","Paxton",1997,51,2239,2290
"6256","Paxton","Worcester County County","MA","Paxton",1998,52,2385,2437
"6257","Paxton","Worcester County County","MA","Paxton",1999,45,2393,2438
"6258","Paxton","Worcester County County","MA","Paxton",2000,50,2290,2340
"6259","Paxton","Worcester County County","MA","Paxton",2001,66,2297,2363
"6260","Paxton","Worcester County County","MA","Paxton",2002,82,2281,2363
"6261","Paxton","Worcester County County","MA","Paxton",2003,99,2282,2381
"6262","Paxton","Worcester County County","MA","Paxton",2004,82,2284,2366
"6263","Paxton","Worcester County County","MA","Paxton",2005,94,2285,2379
"6264","Paxton","Worcester County County","MA","Paxton",2006,98,2369,2467
"6265","Paxton","Worcester County County","MA","Paxton",2007,94,2397,2491
"6266","Paxton","Worcester County County","MA","Paxton",2008,109,2382,2491
"6267","Paxton","Worcester County County","MA","Paxton",2009,177,2311,2488
"6268","Paxton","Worcester County County","MA","Paxton",2010,191,2307,2498
"6269","Paxton","Worcester County County","MA","Paxton",2011,153,2326,2479
"6270","Paxton","Worcester County County","MA","Paxton",2012,134,2325,2459
"6271","Peabody","Essex County County","MA","Peabody",1990,1643,24859,26502
"6272","Peabody","Essex County County","MA","Peabody",1991,2340,24159,26499
"6273","Peabody","Essex County County","MA","Peabody",1992,2241,24075,26316
"6274","Peabody","Essex County County","MA","Peabody",1993,1746,24373,26119
"6275","Peabody","Essex County County","MA","Peabody",1994,1506,24732,26238
"6276","Peabody","Essex County County","MA","Peabody",1995,1297,25032,26329
"6277","Peabody","Essex County County","MA","Peabody",1996,1034,25578,26612
"6278","Peabody","Essex County County","MA","Peabody",1997,946,26392,27338
"6279","Peabody","Essex County County","MA","Peabody",1998,871,26875,27746
"6280","Peabody","Essex County County","MA","Peabody",1999,814,27145,27959
"6281","Peabody","Essex County County","MA","Peabody",2000,635,25235,25870
"6282","Peabody","Essex County County","MA","Peabody",2001,917,25525,26442
"6283","Peabody","Essex County County","MA","Peabody",2002,1318,25493,26811
"6284","Peabody","Essex County County","MA","Peabody",2003,1451,25237,26688
"6285","Peabody","Essex County County","MA","Peabody",2004,1354,25407,26761
"6286","Peabody","Essex County County","MA","Peabody",2005,1291,25891,27182
"6287","Peabody","Essex County County","MA","Peabody",2006,1334,26458,27792
"6288","Peabody","Essex County County","MA","Peabody",2007,1203,26406,27609
"6289","Peabody","Essex County County","MA","Peabody",2008,1399,26384,27783
"6290","Peabody","Essex County County","MA","Peabody",2009,2189,25793,27982
"6291","Peabody","Essex County County","MA","Peabody",2010,2182,25610,27792
"6292","Peabody","Essex County County","MA","Peabody",2011,1799,25907,27706
"6293","Peabody","Essex County County","MA","Peabody",2012,1774,26106,27880
"6294","Pelham","Hampshire County County","MA","Pelham",1990,23,815,838
"6295","Pelham","Hampshire County County","MA","Pelham",1991,34,769,803
"6296","Pelham","Hampshire County County","MA","Pelham",1992,37,740,777
"6297","Pelham","Hampshire County County","MA","Pelham",1993,23,739,762
"6298","Pelham","Hampshire County County","MA","Pelham",1994,21,779,800
"6299","Pelham","Hampshire County County","MA","Pelham",1995,20,845,865
"6300","Pelham","Hampshire County County","MA","Pelham",1996,21,847,868
"6301","Pelham","Hampshire County County","MA","Pelham",1997,14,867,881
"6302","Pelham","Hampshire County County","MA","Pelham",1998,20,884,904
"6303","Pelham","Hampshire County County","MA","Pelham",1999,21,902,923
"6304","Pelham","Hampshire County County","MA","Pelham",2000,18,782,800
"6305","Pelham","Hampshire County County","MA","Pelham",2001,23,801,824
"6306","Pelham","Hampshire County County","MA","Pelham",2002,29,800,829
"6307","Pelham","Hampshire County County","MA","Pelham",2003,31,814,845
"6308","Pelham","Hampshire County County","MA","Pelham",2004,30,815,845
"6309","Pelham","Hampshire County County","MA","Pelham",2005,31,814,845
"6310","Pelham","Hampshire County County","MA","Pelham",2006,28,817,845
"6311","Pelham","Hampshire County County","MA","Pelham",2007,27,822,849
"6312","Pelham","Hampshire County County","MA","Pelham",2008,21,782,803
"6313","Pelham","Hampshire County County","MA","Pelham",2009,25,761,786
"6314","Pelham","Hampshire County County","MA","Pelham",2010,28,705,733
"6315","Pelham","Hampshire County County","MA","Pelham",2011,36,708,744
"6316","Pelham","Hampshire County County","MA","Pelham",2012,36,714,750
"6317","Pembroke","Plymouth County County","MA","Pembroke",1990,543,7700,8243
"6318","Pembroke","Plymouth County County","MA","Pembroke",1991,756,7560,8316
"6319","Pembroke","Plymouth County County","MA","Pembroke",1992,828,7717,8545
"6320","Pembroke","Plymouth County County","MA","Pembroke",1993,680,7963,8643
"6321","Pembroke","Plymouth County County","MA","Pembroke",1994,520,8287,8807
"6322","Pembroke","Plymouth County County","MA","Pembroke",1995,471,8250,8721
"6323","Pembroke","Plymouth County County","MA","Pembroke",1996,445,8499,8944
"6324","Pembroke","Plymouth County County","MA","Pembroke",1997,374,8869,9243
"6325","Pembroke","Plymouth County County","MA","Pembroke",1998,297,9128,9425
"6326","Pembroke","Plymouth County County","MA","Pembroke",1999,299,9317,9616
"6327","Pembroke","Plymouth County County","MA","Pembroke",2000,229,9235,9464
"6328","Pembroke","Plymouth County County","MA","Pembroke",2001,302,9325,9627
"6329","Pembroke","Plymouth County County","MA","Pembroke",2002,425,9309,9734
"6330","Pembroke","Plymouth County County","MA","Pembroke",2003,515,9260,9775
"6331","Pembroke","Plymouth County County","MA","Pembroke",2004,463,9269,9732
"6332","Pembroke","Plymouth County County","MA","Pembroke",2005,437,9568,10005
"6333","Pembroke","Plymouth County County","MA","Pembroke",2006,446,9673,10119
"6334","Pembroke","Plymouth County County","MA","Pembroke",2007,441,9743,10184
"6335","Pembroke","Plymouth County County","MA","Pembroke",2008,552,9797,10349
"6336","Pembroke","Plymouth County County","MA","Pembroke",2009,834,9510,10344
"6337","Pembroke","Plymouth County County","MA","Pembroke",2010,854,9135,9989
"6338","Pembroke","Plymouth County County","MA","Pembroke",2011,747,9224,9971
"6339","Pembroke","Plymouth County County","MA","Pembroke",2012,659,9325,9984
"6340","Pepperell","Middlesex County County","MA","Pepperell",1990,364,5427,5791
"6341","Pepperell","Middlesex County County","MA","Pepperell",1991,496,5243,5739
"6342","Pepperell","Middlesex County County","MA","Pepperell",1992,454,5284,5738
"6343","Pepperell","Middlesex County County","MA","Pepperell",1993,395,5358,5753
"6344","Pepperell","Middlesex County County","MA","Pepperell",1994,337,5503,5840
"6345","Pepperell","Middlesex County County","MA","Pepperell",1995,287,5334,5621
"6346","Pepperell","Middlesex County County","MA","Pepperell",1996,236,5573,5809
"6347","Pepperell","Middlesex County County","MA","Pepperell",1997,194,5862,6056
"6348","Pepperell","Middlesex County County","MA","Pepperell",1998,194,6084,6278
"6349","Pepperell","Middlesex County County","MA","Pepperell",1999,191,6304,6495
"6350","Pepperell","Middlesex County County","MA","Pepperell",2000,146,6101,6247
"6351","Pepperell","Middlesex County County","MA","Pepperell",2001,219,6117,6336
"6352","Pepperell","Middlesex County County","MA","Pepperell",2002,373,5971,6344
"6353","Pepperell","Middlesex County County","MA","Pepperell",2003,370,6069,6439
"6354","Pepperell","Middlesex County County","MA","Pepperell",2004,308,6139,6447
"6355","Pepperell","Middlesex County County","MA","Pepperell",2005,268,6204,6472
"6356","Pepperell","Middlesex County County","MA","Pepperell",2006,262,6206,6468
"6357","Pepperell","Middlesex County County","MA","Pepperell",2007,244,6212,6456
"6358","Pepperell","Middlesex County County","MA","Pepperell",2008,277,6172,6449
"6359","Pepperell","Middlesex County County","MA","Pepperell",2009,471,5966,6437
"6360","Pepperell","Middlesex County County","MA","Pepperell",2010,485,6058,6543
"6361","Pepperell","Middlesex County County","MA","Pepperell",2011,414,6077,6491
"6362","Pepperell","Middlesex County County","MA","Pepperell",2012,370,6130,6500
"6363","Peru","Berkshire County County","MA","Peru",1990,20,378,398
"6364","Peru","Berkshire County County","MA","Peru",1991,38,360,398
"6365","Peru","Berkshire County County","MA","Peru",1992,36,407,443
"6366","Peru","Berkshire County County","MA","Peru",1993,23,417,440
"6367","Peru","Berkshire County County","MA","Peru",1994,23,467,490
"6368","Peru","Berkshire County County","MA","Peru",1995,21,428,449
"6369","Peru","Berkshire County County","MA","Peru",1996,19,415,434
"6370","Peru","Berkshire County County","MA","Peru",1997,19,421,440
"6371","Peru","Berkshire County County","MA","Peru",1998,20,440,460
"6372","Peru","Berkshire County County","MA","Peru",1999,18,479,497
"6373","Peru","Berkshire County County","MA","Peru",2000,11,445,456
"6374","Peru","Berkshire County County","MA","Peru",2001,11,444,455
"6375","Peru","Berkshire County County","MA","Peru",2002,19,449,468
"6376","Peru","Berkshire County County","MA","Peru",2003,21,450,471
"6377","Peru","Berkshire County County","MA","Peru",2004,24,456,480
"6378","Peru","Berkshire County County","MA","Peru",2005,22,472,494
"6379","Peru","Berkshire County County","MA","Peru",2006,18,487,505
"6380","Peru","Berkshire County County","MA","Peru",2007,25,484,509
"6381","Peru","Berkshire County County","MA","Peru",2008,15,477,492
"6382","Peru","Berkshire County County","MA","Peru",2009,20,462,482
"6383","Peru","Berkshire County County","MA","Peru",2010,24,456,480
"6384","Peru","Berkshire County County","MA","Peru",2011,17,460,477
"6385","Peru","Berkshire County County","MA","Peru",2012,17,458,475
"6386","Petersham","Worcester County County","MA","Petersham",1990,23,556,579
"6387","Petersham","Worcester County County","MA","Petersham",1991,47,520,567
"6388","Petersham","Worcester County County","MA","Petersham",1992,49,521,570
"6389","Petersham","Worcester County County","MA","Petersham",1993,37,531,568
"6390","Petersham","Worcester County County","MA","Petersham",1994,35,548,583
"6391","Petersham","Worcester County County","MA","Petersham",1995,30,533,563
"6392","Petersham","Worcester County County","MA","Petersham",1996,19,529,548
"6393","Petersham","Worcester County County","MA","Petersham",1997,28,542,570
"6394","Petersham","Worcester County County","MA","Petersham",1998,17,535,552
"6395","Petersham","Worcester County County","MA","Petersham",1999,20,537,557
"6396","Petersham","Worcester County County","MA","Petersham",2000,16,615,631
"6397","Petersham","Worcester County County","MA","Petersham",2001,17,617,634
"6398","Petersham","Worcester County County","MA","Petersham",2002,27,615,642
"6399","Petersham","Worcester County County","MA","Petersham",2003,30,627,657
"6400","Petersham","Worcester County County","MA","Petersham",2004,28,635,663
"6401","Petersham","Worcester County County","MA","Petersham",2005,29,643,672
"6402","Petersham","Worcester County County","MA","Petersham",2006,26,653,679
"6403","Petersham","Worcester County County","MA","Petersham",2007,27,657,684
"6404","Petersham","Worcester County County","MA","Petersham",2008,31,650,681
"6405","Petersham","Worcester County County","MA","Petersham",2009,52,635,687
"6406","Petersham","Worcester County County","MA","Petersham",2010,57,591,648
"6407","Petersham","Worcester County County","MA","Petersham",2011,42,596,638
"6408","Petersham","Worcester County County","MA","Petersham",2012,37,596,633
"6409","Phillipston","Worcester County County","MA","Phillipston",1990,48,712,760
"6410","Phillipston","Worcester County County","MA","Phillipston",1991,67,647,714
"6411","Phillipston","Worcester County County","MA","Phillipston",1992,78,661,739
"6412","Phillipston","Worcester County County","MA","Phillipston",1993,60,710,770
"6413","Phillipston","Worcester County County","MA","Phillipston",1994,96,741,837
"6414","Phillipston","Worcester County County","MA","Phillipston",1995,64,714,778
"6415","Phillipston","Worcester County County","MA","Phillipston",1996,59,711,770
"6416","Phillipston","Worcester County County","MA","Phillipston",1997,50,726,776
"6417","Phillipston","Worcester County County","MA","Phillipston",1998,42,636,678
"6418","Phillipston","Worcester County County","MA","Phillipston",1999,49,635,684
"6419","Phillipston","Worcester County County","MA","Phillipston",2000,29,877,906
"6420","Phillipston","Worcester County County","MA","Phillipston",2001,38,866,904
"6421","Phillipston","Worcester County County","MA","Phillipston",2002,60,858,918
"6422","Phillipston","Worcester County County","MA","Phillipston",2003,51,871,922
"6423","Phillipston","Worcester County County","MA","Phillipston",2004,58,885,943
"6424","Phillipston","Worcester County County","MA","Phillipston",2005,62,889,951
"6425","Phillipston","Worcester County County","MA","Phillipston",2006,52,909,961
"6426","Phillipston","Worcester County County","MA","Phillipston",2007,45,917,962
"6427","Phillipston","Worcester County County","MA","Phillipston",2008,60,904,964
"6428","Phillipston","Worcester County County","MA","Phillipston",2009,97,854,951
"6429","Phillipston","Worcester County County","MA","Phillipston",2010,91,821,912
"6430","Phillipston","Worcester County County","MA","Phillipston",2011,76,820,896
"6431","Phillipston","Worcester County County","MA","Phillipston",2012,83,820,903
"6432","Pittsfield","Berkshire County County","MA","Pittsfield",1990,1666,22141,23807
"6433","Pittsfield","Berkshire County County","MA","Pittsfield",1991,2793,20960,23753
"6434","Pittsfield","Berkshire County County","MA","Pittsfield",1992,2725,20401,23126
"6435","Pittsfield","Berkshire County County","MA","Pittsfield",1993,2127,20306,22433
"6436","Pittsfield","Berkshire County County","MA","Pittsfield",1994,1962,19912,21874
"6437","Pittsfield","Berkshire County County","MA","Pittsfield",1995,1543,20085,21628
"6438","Pittsfield","Berkshire County County","MA","Pittsfield",1996,1217,20335,21552
"6439","Pittsfield","Berkshire County County","MA","Pittsfield",1997,1189,20385,21574
"6440","Pittsfield","Berkshire County County","MA","Pittsfield",1998,952,20472,21424
"6441","Pittsfield","Berkshire County County","MA","Pittsfield",1999,945,20523,21468
"6442","Pittsfield","Berkshire County County","MA","Pittsfield",2000,740,22147,22887
"6443","Pittsfield","Berkshire County County","MA","Pittsfield",2001,882,22050,22932
"6444","Pittsfield","Berkshire County County","MA","Pittsfield",2002,1133,22270,23403
"6445","Pittsfield","Berkshire County County","MA","Pittsfield",2003,1240,22007,23247
"6446","Pittsfield","Berkshire County County","MA","Pittsfield",2004,1142,21906,23048
"6447","Pittsfield","Berkshire County County","MA","Pittsfield",2005,1052,22075,23127
"6448","Pittsfield","Berkshire County County","MA","Pittsfield",2006,1049,22374,23423
"6449","Pittsfield","Berkshire County County","MA","Pittsfield",2007,1042,22144,23186
"6450","Pittsfield","Berkshire County County","MA","Pittsfield",2008,1248,21847,23095
"6451","Pittsfield","Berkshire County County","MA","Pittsfield",2009,1889,21135,23024
"6452","Pittsfield","Berkshire County County","MA","Pittsfield",2010,2011,21483,23494
"6453","Pittsfield","Berkshire County County","MA","Pittsfield",2011,1849,21683,23532
"6454","Pittsfield","Berkshire County County","MA","Pittsfield",2012,1749,21585,23334
"6455","Plainfield","Hampshire County County","MA","Plainfield",1990,22,280,302
"6456","Plainfield","Hampshire County County","MA","Plainfield",1991,37,267,304
"6457","Plainfield","Hampshire County County","MA","Plainfield",1992,39,291,330
"6458","Plainfield","Hampshire County County","MA","Plainfield",1993,24,289,313
"6459","Plainfield","Hampshire County County","MA","Plainfield",1994,24,324,348
"6460","Plainfield","Hampshire County County","MA","Plainfield",1995,19,347,366
"6461","Plainfield","Hampshire County County","MA","Plainfield",1996,21,339,360
"6462","Plainfield","Hampshire County County","MA","Plainfield",1997,24,342,366
"6463","Plainfield","Hampshire County County","MA","Plainfield",1998,17,360,377
"6464","Plainfield","Hampshire County County","MA","Plainfield",1999,15,392,407
"6465","Plainfield","Hampshire County County","MA","Plainfield",2000,10,289,299
"6466","Plainfield","Hampshire County County","MA","Plainfield",2001,13,291,304
"6467","Plainfield","Hampshire County County","MA","Plainfield",2002,17,291,308
"6468","Plainfield","Hampshire County County","MA","Plainfield",2003,20,289,309
"6469","Plainfield","Hampshire County County","MA","Plainfield",2004,18,290,308
"6470","Plainfield","Hampshire County County","MA","Plainfield",2005,15,289,304
"6471","Plainfield","Hampshire County County","MA","Plainfield",2006,16,292,308
"6472","Plainfield","Hampshire County County","MA","Plainfield",2007,15,292,307
"6473","Plainfield","Hampshire County County","MA","Plainfield",2008,19,285,304
"6474","Plainfield","Hampshire County County","MA","Plainfield",2009,25,272,297
"6475","Plainfield","Hampshire County County","MA","Plainfield",2010,27,299,326
"6476","Plainfield","Hampshire County County","MA","Plainfield",2011,23,296,319
"6477","Plainfield","Hampshire County County","MA","Plainfield",2012,19,296,315
"6478","Plainville","Norfolk County County","MA","Plainville",1990,189,3776,3965
"6479","Plainville","Norfolk County County","MA","Plainville",1991,377,3694,4071
"6480","Plainville","Norfolk County County","MA","Plainville",1992,357,3668,4025
"6481","Plainville","Norfolk County County","MA","Plainville",1993,245,3820,4065
"6482","Plainville","Norfolk County County","MA","Plainville",1994,235,4004,4239
"6483","Plainville","Norfolk County County","MA","Plainville",1995,203,3889,4092
"6484","Plainville","Norfolk County County","MA","Plainville",1996,155,3985,4140
"6485","Plainville","Norfolk County County","MA","Plainville",1997,153,4104,4257
"6486","Plainville","Norfolk County County","MA","Plainville",1998,117,4228,4345
"6487","Plainville","Norfolk County County","MA","Plainville",1999,120,4312,4432
"6488","Plainville","Norfolk County County","MA","Plainville",2000,130,4418,4548
"6489","Plainville","Norfolk County County","MA","Plainville",2001,172,4418,4590
"6490","Plainville","Norfolk County County","MA","Plainville",2002,251,4464,4715
"6491","Plainville","Norfolk County County","MA","Plainville",2003,238,4516,4754
"6492","Plainville","Norfolk County County","MA","Plainville",2004,235,4512,4747
"6493","Plainville","Norfolk County County","MA","Plainville",2005,219,4596,4815
"6494","Plainville","Norfolk County County","MA","Plainville",2006,239,4695,4934
"6495","Plainville","Norfolk County County","MA","Plainville",2007,214,4823,5037
"6496","Plainville","Norfolk County County","MA","Plainville",2008,275,4690,4965
"6497","Plainville","Norfolk County County","MA","Plainville",2009,497,4527,5024
"6498","Plainville","Norfolk County County","MA","Plainville",2010,502,4489,4991
"6499","Plainville","Norfolk County County","MA","Plainville",2011,419,4550,4969
"6500","Plainville","Norfolk County County","MA","Plainville",2012,414,4557,4971
"6501","Plymouth","Plymouth County County","MA","Plymouth",1990,1730,21973,23703
"6502","Plymouth","Plymouth County County","MA","Plymouth",1991,2251,21636,23887
"6503","Plymouth","Plymouth County County","MA","Plymouth",1992,2343,21712,24055
"6504","Plymouth","Plymouth County County","MA","Plymouth",1993,2082,22291,24373
"6505","Plymouth","Plymouth County County","MA","Plymouth",1994,1716,22990,24706
"6506","Plymouth","Plymouth County County","MA","Plymouth",1995,1511,22710,24221
"6507","Plymouth","Plymouth County County","MA","Plymouth",1996,1398,23273,24671
"6508","Plymouth","Plymouth County County","MA","Plymouth",1997,1280,24105,25385
"6509","Plymouth","Plymouth County County","MA","Plymouth",1998,1040,24839,25879
"6510","Plymouth","Plymouth County County","MA","Plymouth",1999,900,25458,26358
"6511","Plymouth","Plymouth County County","MA","Plymouth",2000,798,26811,27609
"6512","Plymouth","Plymouth County County","MA","Plymouth",2001,969,27153,28122
"6513","Plymouth","Plymouth County County","MA","Plymouth",2002,1397,27073,28470
"6514","Plymouth","Plymouth County County","MA","Plymouth",2003,1607,26949,28556
"6515","Plymouth","Plymouth County County","MA","Plymouth",2004,1504,27141,28645
"6516","Plymouth","Plymouth County County","MA","Plymouth",2005,1436,27590,29026
"6517","Plymouth","Plymouth County County","MA","Plymouth",2006,1485,27782,29267
"6518","Plymouth","Plymouth County County","MA","Plymouth",2007,1500,27993,29493
"6519","Plymouth","Plymouth County County","MA","Plymouth",2008,1778,27987,29765
"6520","Plymouth","Plymouth County County","MA","Plymouth",2009,2658,27248,29906
"6521","Plymouth","Plymouth County County","MA","Plymouth",2010,2730,27475,30205
"6522","Plymouth","Plymouth County County","MA","Plymouth",2011,2310,27739,30049
"6523","Plymouth","Plymouth County County","MA","Plymouth",2012,2037,28043,30080
"6524",NA,"Plymouth County County","MA","Plymouth County County",1990,16591,213304,229895
"6525",NA,"Plymouth County County","MA","Plymouth County County",1991,23024,206112,229136
"6526",NA,"Plymouth County County","MA","Plymouth County County",1992,23072,205069,228141
"6527",NA,"Plymouth County County","MA","Plymouth County County",1993,18655,211148,229803
"6528",NA,"Plymouth County County","MA","Plymouth County County",1994,15324,219713,235037
"6529",NA,"Plymouth County County","MA","Plymouth County County",1995,13857,222783,236640
"6530",NA,"Plymouth County County","MA","Plymouth County County",1996,12338,226755,239093
"6531",NA,"Plymouth County County","MA","Plymouth County County",1997,10979,234614,245593
"6532",NA,"Plymouth County County","MA","Plymouth County County",1998,8806,239095,247901
"6533",NA,"Plymouth County County","MA","Plymouth County County",1999,8417,243802,252219
"6534",NA,"Plymouth County County","MA","Plymouth County County",2000,6852,244511,251363
"6535",NA,"Plymouth County County","MA","Plymouth County County",2001,8853,245526,254379
"6536",NA,"Plymouth County County","MA","Plymouth County County",2002,12531,244480,257011
"6537",NA,"Plymouth County County","MA","Plymouth County County",2003,14335,241944,256279
"6538",NA,"Plymouth County County","MA","Plymouth County County",2004,13478,243072,256550
"6539",NA,"Plymouth County County","MA","Plymouth County County",2005,12553,245802,258355
"6540",NA,"Plymouth County County","MA","Plymouth County County",2006,12630,246134,258764
"6541",NA,"Plymouth County County","MA","Plymouth County County",2007,12468,247825,260293
"6542",NA,"Plymouth County County","MA","Plymouth County County",2008,14829,247395,262224
"6543",NA,"Plymouth County County","MA","Plymouth County County",2009,22505,241335,263840
"6544",NA,"Plymouth County County","MA","Plymouth County County",2010,23297,241283,264580
"6545",NA,"Plymouth County County","MA","Plymouth County County",2011,20344,243563,263907
"6546",NA,"Plymouth County County","MA","Plymouth County County",2012,18274,246026,264300
"6547","Plympton","Plymouth County County","MA","Plympton",1990,96,1271,1367
"6548","Plympton","Plymouth County County","MA","Plympton",1991,130,1268,1398
"6549","Plympton","Plymouth County County","MA","Plympton",1992,144,1231,1375
"6550","Plympton","Plymouth County County","MA","Plympton",1993,135,1314,1449
"6551","Plympton","Plymouth County County","MA","Plympton",1994,108,1406,1514
"6552","Plympton","Plymouth County County","MA","Plympton",1995,92,1406,1498
"6553","Plympton","Plymouth County County","MA","Plympton",1996,85,1423,1508
"6554","Plympton","Plymouth County County","MA","Plympton",1997,57,1472,1529
"6555","Plympton","Plymouth County County","MA","Plympton",1998,53,1500,1553
"6556","Plympton","Plymouth County County","MA","Plympton",1999,51,1531,1582
"6557","Plympton","Plymouth County County","MA","Plympton",2000,42,1521,1563
"6558","Plympton","Plymouth County County","MA","Plympton",2001,47,1520,1567
"6559","Plympton","Plymouth County County","MA","Plympton",2002,62,1512,1574
"6560","Plympton","Plymouth County County","MA","Plympton",2003,91,1490,1581
"6561","Plympton","Plymouth County County","MA","Plympton",2004,85,1500,1585
"6562","Plympton","Plymouth County County","MA","Plympton",2005,76,1520,1596
"6563","Plympton","Plymouth County County","MA","Plympton",2006,82,1530,1612
"6564","Plympton","Plymouth County County","MA","Plympton",2007,82,1556,1638
"6565","Plympton","Plymouth County County","MA","Plympton",2008,97,1552,1649
"6566","Plympton","Plymouth County County","MA","Plympton",2009,133,1507,1640
"6567","Plympton","Plymouth County County","MA","Plympton",2010,136,1516,1652
"6568","Plympton","Plymouth County County","MA","Plympton",2011,121,1532,1653
"6569","Plympton","Plymouth County County","MA","Plympton",2012,112,1545,1657
"6570","Princeton","Worcester County County","MA","Princeton",1990,74,1790,1864
"6571","Princeton","Worcester County County","MA","Princeton",1991,110,1741,1851
"6572","Princeton","Worcester County County","MA","Princeton",1992,99,1759,1858
"6573","Princeton","Worcester County County","MA","Princeton",1993,100,1835,1935
"6574","Princeton","Worcester County County","MA","Princeton",1994,86,1911,1997
"6575","Princeton","Worcester County County","MA","Princeton",1995,90,1837,1927
"6576","Princeton","Worcester County County","MA","Princeton",1996,55,1879,1934
"6577","Princeton","Worcester County County","MA","Princeton",1997,48,1939,1987
"6578","Princeton","Worcester County County","MA","Princeton",1998,43,1989,2032
"6579","Princeton","Worcester County County","MA","Princeton",1999,51,1993,2044
"6580","Princeton","Worcester County County","MA","Princeton",2000,41,1869,1910
"6581","Princeton","Worcester County County","MA","Princeton",2001,53,1879,1932
"6582","Princeton","Worcester County County","MA","Princeton",2002,87,1879,1966
"6583","Princeton","Worcester County County","MA","Princeton",2003,96,1882,1978
"6584","Princeton","Worcester County County","MA","Princeton",2004,92,1878,1970
"6585","Princeton","Worcester County County","MA","Princeton",2005,88,1885,1973
"6586","Princeton","Worcester County County","MA","Princeton",2006,75,1896,1971
"6587","Princeton","Worcester County County","MA","Princeton",2007,68,1895,1963
"6588","Princeton","Worcester County County","MA","Princeton",2008,92,1852,1944
"6589","Princeton","Worcester County County","MA","Princeton",2009,128,1801,1929
"6590","Princeton","Worcester County County","MA","Princeton",2010,123,1748,1871
"6591","Princeton","Worcester County County","MA","Princeton",2011,107,1763,1870
"6592","Princeton","Worcester County County","MA","Princeton",2012,103,1762,1865
"6593","Provincetown","Barnstable County County","MA","Provincetown",1990,712,2516,3228
"6594","Provincetown","Barnstable County County","MA","Provincetown",1991,864,2489,3353
"6595","Provincetown","Barnstable County County","MA","Provincetown",1992,1004,2492,3496
"6596","Provincetown","Barnstable County County","MA","Provincetown",1993,1100,2560,3660
"6597","Provincetown","Barnstable County County","MA","Provincetown",1994,1047,2562,3609
"6598","Provincetown","Barnstable County County","MA","Provincetown",1995,940,2670,3610
"6599","Provincetown","Barnstable County County","MA","Provincetown",1996,816,2667,3483
"6600","Provincetown","Barnstable County County","MA","Provincetown",1997,811,2660,3471
"6601","Provincetown","Barnstable County County","MA","Provincetown",1998,705,2702,3407
"6602","Provincetown","Barnstable County County","MA","Provincetown",1999,632,2751,3383
"6603","Provincetown","Barnstable County County","MA","Provincetown",2000,369,1756,2125
"6604","Provincetown","Barnstable County County","MA","Provincetown",2001,357,1774,2131
"6605","Provincetown","Barnstable County County","MA","Provincetown",2002,392,1794,2186
"6606","Provincetown","Barnstable County County","MA","Provincetown",2003,420,1818,2238
"6607","Provincetown","Barnstable County County","MA","Provincetown",2004,412,1825,2237
"6608","Provincetown","Barnstable County County","MA","Provincetown",2005,401,1824,2225
"6609","Provincetown","Barnstable County County","MA","Provincetown",2006,394,1834,2228
"6610","Provincetown","Barnstable County County","MA","Provincetown",2007,340,1832,2172
"6611","Provincetown","Barnstable County County","MA","Provincetown",2008,354,1822,2176
"6612","Provincetown","Barnstable County County","MA","Provincetown",2009,458,1793,2251
"6613","Provincetown","Barnstable County County","MA","Provincetown",2010,490,1566,2056
"6614","Provincetown","Barnstable County County","MA","Provincetown",2011,518,1563,2081
"6615","Provincetown","Barnstable County County","MA","Provincetown",2012,485,1589,2074
"6616","Quincy","Norfolk County County","MA","Quincy",1990,2899,46343,49242
"6617","Quincy","Norfolk County County","MA","Quincy",1991,4258,44640,48898
"6618","Quincy","Norfolk County County","MA","Quincy",1992,4231,44318,48549
"6619","Quincy","Norfolk County County","MA","Quincy",1993,3478,44636,48114
"6620","Quincy","Norfolk County County","MA","Quincy",1994,2836,44913,47749
"6621","Quincy","Norfolk County County","MA","Quincy",1995,2738,46116,48854
"6622","Quincy","Norfolk County County","MA","Quincy",1996,2220,46910,49130
"6623","Quincy","Norfolk County County","MA","Quincy",1997,1980,48041,50021
"6624","Quincy","Norfolk County County","MA","Quincy",1998,1579,48706,50285
"6625","Quincy","Norfolk County County","MA","Quincy",1999,1495,49068,50563
"6626","Quincy","Norfolk County County","MA","Quincy",2000,1377,49550,50927
"6627","Quincy","Norfolk County County","MA","Quincy",2001,1816,49688,51504
"6628","Quincy","Norfolk County County","MA","Quincy",2002,2662,48904,51566
"6629","Quincy","Norfolk County County","MA","Quincy",2003,3054,48181,51235
"6630","Quincy","Norfolk County County","MA","Quincy",2004,2689,48657,51346
"6631","Quincy","Norfolk County County","MA","Quincy",2005,2409,49345,51754
"6632","Quincy","Norfolk County County","MA","Quincy",2006,2366,48596,50962
"6633","Quincy","Norfolk County County","MA","Quincy",2007,2227,48903,51130
"6634","Quincy","Norfolk County County","MA","Quincy",2008,2752,48871,51623
"6635","Quincy","Norfolk County County","MA","Quincy",2009,4200,47494,51694
"6636","Quincy","Norfolk County County","MA","Quincy",2010,4296,48866,53162
"6637","Quincy","Norfolk County County","MA","Quincy",2011,3680,49414,53094
"6638","Quincy","Norfolk County County","MA","Quincy",2012,3226,49955,53181
"6639","Randolph","Norfolk County County","MA","Randolph",1990,1026,15894,16920
"6640","Randolph","Norfolk County County","MA","Randolph",1991,1498,15483,16981
"6641","Randolph","Norfolk County County","MA","Randolph",1992,1490,15400,16890
"6642","Randolph","Norfolk County County","MA","Randolph",1993,1190,15485,16675
"6643","Randolph","Norfolk County County","MA","Randolph",1994,1074,15574,16648
"6644","Randolph","Norfolk County County","MA","Randolph",1995,946,15934,16880
"6645","Randolph","Norfolk County County","MA","Randolph",1996,820,16210,17030
"6646","Randolph","Norfolk County County","MA","Randolph",1997,701,16580,17281
"6647","Randolph","Norfolk County County","MA","Randolph",1998,607,16794,17401
"6648","Randolph","Norfolk County County","MA","Randolph",1999,566,16879,17445
"6649","Randolph","Norfolk County County","MA","Randolph",2000,466,16662,17128
"6650","Randolph","Norfolk County County","MA","Randolph",2001,653,16592,17245
"6651","Randolph","Norfolk County County","MA","Randolph",2002,995,16286,17281
"6652","Randolph","Norfolk County County","MA","Randolph",2003,1087,16000,17087
"6653","Randolph","Norfolk County County","MA","Randolph",2004,953,15936,16889
"6654","Randolph","Norfolk County County","MA","Randolph",2005,872,15953,16825
"6655","Randolph","Norfolk County County","MA","Randolph",2006,896,15655,16551
"6656","Randolph","Norfolk County County","MA","Randolph",2007,809,15743,16552
"6657","Randolph","Norfolk County County","MA","Randolph",2008,973,15711,16684
"6658","Randolph","Norfolk County County","MA","Randolph",2009,1439,15500,16939
"6659","Randolph","Norfolk County County","MA","Randolph",2010,1564,16286,17850
"6660","Randolph","Norfolk County County","MA","Randolph",2011,1367,16470,17837
"6661","Randolph","Norfolk County County","MA","Randolph",2012,1246,16650,17896
"6662","Raynham","Bristol County County","MA","Raynham",1990,371,5100,5471
"6663","Raynham","Bristol County County","MA","Raynham",1991,544,4904,5448
"6664","Raynham","Bristol County County","MA","Raynham",1992,561,4869,5430
"6665","Raynham","Bristol County County","MA","Raynham",1993,437,5152,5589
"6666","Raynham","Bristol County County","MA","Raynham",1994,420,5480,5900
"6667","Raynham","Bristol County County","MA","Raynham",1995,376,5487,5863
"6668","Raynham","Bristol County County","MA","Raynham",1996,319,5562,5881
"6669","Raynham","Bristol County County","MA","Raynham",1997,283,5756,6039
"6670","Raynham","Bristol County County","MA","Raynham",1998,202,5822,6024
"6671","Raynham","Bristol County County","MA","Raynham",1999,207,5957,6164
"6672","Raynham","Bristol County County","MA","Raynham",2000,150,6592,6742
"6673","Raynham","Bristol County County","MA","Raynham",2001,217,6664,6881
"6674","Raynham","Bristol County County","MA","Raynham",2002,321,6754,7075
"6675","Raynham","Bristol County County","MA","Raynham",2003,362,6854,7216
"6676","Raynham","Bristol County County","MA","Raynham",2004,365,7237,7602
"6677","Raynham","Bristol County County","MA","Raynham",2005,329,7462,7791
"6678","Raynham","Bristol County County","MA","Raynham",2006,333,7648,7981
"6679","Raynham","Bristol County County","MA","Raynham",2007,333,7701,8034
"6680","Raynham","Bristol County County","MA","Raynham",2008,412,7648,8060
"6681","Raynham","Bristol County County","MA","Raynham",2009,624,7354,7978
"6682","Raynham","Bristol County County","MA","Raynham",2010,619,7228,7847
"6683","Raynham","Bristol County County","MA","Raynham",2011,569,7304,7873
"6684","Raynham","Bristol County County","MA","Raynham",2012,477,7282,7759
"6685","Reading","Middlesex County County","MA","Reading",1990,635,12258,12893
"6686","Reading","Middlesex County County","MA","Reading",1991,897,11856,12753
"6687","Reading","Middlesex County County","MA","Reading",1992,904,11803,12707
"6688","Reading","Middlesex County County","MA","Reading",1993,641,11962,12603
"6689","Reading","Middlesex County County","MA","Reading",1994,565,12156,12721
"6690","Reading","Middlesex County County","MA","Reading",1995,473,12266,12739
"6691","Reading","Middlesex County County","MA","Reading",1996,418,12532,12950
"6692","Reading","Middlesex County County","MA","Reading",1997,382,12970,13352
"6693","Reading","Middlesex County County","MA","Reading",1998,308,13226,13534
"6694","Reading","Middlesex County County","MA","Reading",1999,309,13317,13626
"6695","Reading","Middlesex County County","MA","Reading",2000,268,12909,13177
"6696","Reading","Middlesex County County","MA","Reading",2001,393,12840,13233
"6697","Reading","Middlesex County County","MA","Reading",2002,597,12567,13164
"6698","Reading","Middlesex County County","MA","Reading",2003,666,12327,12993
"6699","Reading","Middlesex County County","MA","Reading",2004,537,12247,12784
"6700","Reading","Middlesex County County","MA","Reading",2005,478,12272,12750
"6701","Reading","Middlesex County County","MA","Reading",2006,461,12119,12580
"6702","Reading","Middlesex County County","MA","Reading",2007,425,12209,12634
"6703","Reading","Middlesex County County","MA","Reading",2008,518,12202,12720
"6704","Reading","Middlesex County County","MA","Reading",2009,878,11884,12762
"6705","Reading","Middlesex County County","MA","Reading",2010,820,12699,13519
"6706","Reading","Middlesex County County","MA","Reading",2011,738,12884,13622
"6707","Reading","Middlesex County County","MA","Reading",2012,652,13025,13677
"6708","Rehoboth","Bristol County County","MA","Rehoboth",1990,297,4609,4906
"6709","Rehoboth","Bristol County County","MA","Rehoboth",1991,516,4464,4980
"6710","Rehoboth","Bristol County County","MA","Rehoboth",1992,572,4575,5147
"6711","Rehoboth","Bristol County County","MA","Rehoboth",1993,469,4725,5194
"6712","Rehoboth","Bristol County County","MA","Rehoboth",1994,437,4882,5319
"6713","Rehoboth","Bristol County County","MA","Rehoboth",1995,364,4950,5314
"6714","Rehoboth","Bristol County County","MA","Rehoboth",1996,321,5011,5332
"6715","Rehoboth","Bristol County County","MA","Rehoboth",1997,268,5154,5422
"6716","Rehoboth","Bristol County County","MA","Rehoboth",1998,205,5302,5507
"6717","Rehoboth","Bristol County County","MA","Rehoboth",1999,181,5414,5595
"6718","Rehoboth","Bristol County County","MA","Rehoboth",2000,197,5850,6047
"6719","Rehoboth","Bristol County County","MA","Rehoboth",2001,238,5939,6177
"6720","Rehoboth","Bristol County County","MA","Rehoboth",2002,308,6055,6363
"6721","Rehoboth","Bristol County County","MA","Rehoboth",2003,321,6208,6529
"6722","Rehoboth","Bristol County County","MA","Rehoboth",2004,310,6307,6617
"6723","Rehoboth","Bristol County County","MA","Rehoboth",2005,305,6420,6725
"6724","Rehoboth","Bristol County County","MA","Rehoboth",2006,333,6555,6888
"6725","Rehoboth","Bristol County County","MA","Rehoboth",2007,300,6635,6935
"6726","Rehoboth","Bristol County County","MA","Rehoboth",2008,404,6530,6934
"6727","Rehoboth","Bristol County County","MA","Rehoboth",2009,645,6247,6892
"6728","Rehoboth","Bristol County County","MA","Rehoboth",2010,648,6279,6927
"6729","Rehoboth","Bristol County County","MA","Rehoboth",2011,592,6324,6916
"6730","Rehoboth","Bristol County County","MA","Rehoboth",2012,547,6334,6881
"6731","Revere","Suffolk County County","MA","Revere",1990,1649,20331,21980
"6732","Revere","Suffolk County County","MA","Revere",1991,2346,19788,22134
"6733","Revere","Suffolk County County","MA","Revere",1992,2370,19516,21886
"6734","Revere","Suffolk County County","MA","Revere",1993,1847,19532,21379
"6735","Revere","Suffolk County County","MA","Revere",1994,1601,19470,21071
"6736","Revere","Suffolk County County","MA","Revere",1995,1500,19684,21184
"6737","Revere","Suffolk County County","MA","Revere",1996,1138,19942,21080
"6738","Revere","Suffolk County County","MA","Revere",1997,1098,20330,21428
"6739","Revere","Suffolk County County","MA","Revere",1998,874,20606,21480
"6740","Revere","Suffolk County County","MA","Revere",1999,926,20792,21718
"6741","Revere","Suffolk County County","MA","Revere",2000,749,21873,22622
"6742","Revere","Suffolk County County","MA","Revere",2001,945,21874,22819
"6743","Revere","Suffolk County County","MA","Revere",2002,1433,21377,22810
"6744","Revere","Suffolk County County","MA","Revere",2003,1703,20782,22485
"6745","Revere","Suffolk County County","MA","Revere",2004,1418,20534,21952
"6746","Revere","Suffolk County County","MA","Revere",2005,1324,20616,21940
"6747","Revere","Suffolk County County","MA","Revere",2006,1348,22245,23593
"6748","Revere","Suffolk County County","MA","Revere",2007,1238,22871,24109
"6749","Revere","Suffolk County County","MA","Revere",2008,1499,22744,24243
"6750","Revere","Suffolk County County","MA","Revere",2009,2222,22201,24423
"6751","Revere","Suffolk County County","MA","Revere",2010,2286,22562,24848
"6752","Revere","Suffolk County County","MA","Revere",2011,2035,22966,25001
"6753","Revere","Suffolk County County","MA","Revere",2012,1884,23218,25102
"6754","Richmond","Berkshire County County","MA","Richmond",1990,28,861,889
"6755","Richmond","Berkshire County County","MA","Richmond",1991,44,835,879
"6756","Richmond","Berkshire County County","MA","Richmond",1992,65,826,891
"6757","Richmond","Berkshire County County","MA","Richmond",1993,43,812,855
"6758","Richmond","Berkshire County County","MA","Richmond",1994,31,815,846
"6759","Richmond","Berkshire County County","MA","Richmond",1995,33,793,826
"6760","Richmond","Berkshire County County","MA","Richmond",1996,23,803,826
"6761","Richmond","Berkshire County County","MA","Richmond",1997,25,813,838
"6762","Richmond","Berkshire County County","MA","Richmond",1998,23,820,843
"6763","Richmond","Berkshire County County","MA","Richmond",1999,19,828,847
"6764","Richmond","Berkshire County County","MA","Richmond",2000,15,917,932
"6765","Richmond","Berkshire County County","MA","Richmond",2001,18,921,939
"6766","Richmond","Berkshire County County","MA","Richmond",2002,23,940,963
"6767","Richmond","Berkshire County County","MA","Richmond",2003,34,941,975
"6768","Richmond","Berkshire County County","MA","Richmond",2004,32,951,983
"6769","Richmond","Berkshire County County","MA","Richmond",2005,33,961,994
"6770","Richmond","Berkshire County County","MA","Richmond",2006,26,973,999
"6771","Richmond","Berkshire County County","MA","Richmond",2007,30,967,997
"6772","Richmond","Berkshire County County","MA","Richmond",2008,29,949,978
"6773","Richmond","Berkshire County County","MA","Richmond",2009,48,922,970
"6774","Richmond","Berkshire County County","MA","Richmond",2010,40,835,875
"6775","Richmond","Berkshire County County","MA","Richmond",2011,39,842,881
"6776","Richmond","Berkshire County County","MA","Richmond",2012,28,838,866
"6777","Rochester","Plymouth County County","MA","Rochester",1990,138,2003,2141
"6778","Rochester","Plymouth County County","MA","Rochester",1991,200,1961,2161
"6779","Rochester","Plymouth County County","MA","Rochester",1992,194,1993,2187
"6780","Rochester","Plymouth County County","MA","Rochester",1993,162,2132,2294
"6781","Rochester","Plymouth County County","MA","Rochester",1994,158,2236,2394
"6782","Rochester","Plymouth County County","MA","Rochester",1995,160,2170,2330
"6783","Rochester","Plymouth County County","MA","Rochester",1996,128,2182,2310
"6784","Rochester","Plymouth County County","MA","Rochester",1997,121,2269,2390
"6785","Rochester","Plymouth County County","MA","Rochester",1998,87,2340,2427
"6786","Rochester","Plymouth County County","MA","Rochester",1999,83,2414,2497
"6787","Rochester","Plymouth County County","MA","Rochester",2000,67,2561,2628
"6788","Rochester","Plymouth County County","MA","Rochester",2001,83,2626,2709
"6789","Rochester","Plymouth County County","MA","Rochester",2002,125,2694,2819
"6790","Rochester","Plymouth County County","MA","Rochester",2003,135,2705,2840
"6791","Rochester","Plymouth County County","MA","Rochester",2004,130,2788,2918
"6792","Rochester","Plymouth County County","MA","Rochester",2005,125,2892,3017
"6793","Rochester","Plymouth County County","MA","Rochester",2006,113,2996,3109
"6794","Rochester","Plymouth County County","MA","Rochester",2007,124,2900,3024
"6795","Rochester","Plymouth County County","MA","Rochester",2008,143,2851,2994
"6796","Rochester","Plymouth County County","MA","Rochester",2009,222,2782,3004
"6797","Rochester","Plymouth County County","MA","Rochester",2010,233,2714,2947
"6798","Rochester","Plymouth County County","MA","Rochester",2011,217,2755,2972
"6799","Rochester","Plymouth County County","MA","Rochester",2012,194,2787,2981
"6800","Rockland","Plymouth County County","MA","Rockland",1990,675,8160,8835
"6801","Rockland","Plymouth County County","MA","Rockland",1991,912,7868,8780
"6802","Rockland","Plymouth County County","MA","Rockland",1992,854,7921,8775
"6803","Rockland","Plymouth County County","MA","Rockland",1993,694,8054,8748
"6804","Rockland","Plymouth County County","MA","Rockland",1994,570,8249,8819
"6805","Rockland","Plymouth County County","MA","Rockland",1995,544,8477,9021
"6806","Rockland","Plymouth County County","MA","Rockland",1996,455,8736,9191
"6807","Rockland","Plymouth County County","MA","Rockland",1997,383,9067,9450
"6808","Rockland","Plymouth County County","MA","Rockland",1998,326,9283,9609
"6809","Rockland","Plymouth County County","MA","Rockland",1999,339,9482,9821
"6810","Rockland","Plymouth County County","MA","Rockland",2000,286,9680,9966
"6811","Rockland","Plymouth County County","MA","Rockland",2001,322,9698,10020
"6812","Rockland","Plymouth County County","MA","Rockland",2002,480,9610,10090
"6813","Rockland","Plymouth County County","MA","Rockland",2003,544,9448,9992
"6814","Rockland","Plymouth County County","MA","Rockland",2004,543,9402,9945
"6815","Rockland","Plymouth County County","MA","Rockland",2005,494,9491,9985
"6816","Rockland","Plymouth County County","MA","Rockland",2006,496,9347,9843
"6817","Rockland","Plymouth County County","MA","Rockland",2007,507,9431,9938
"6818","Rockland","Plymouth County County","MA","Rockland",2008,558,9455,10013
"6819","Rockland","Plymouth County County","MA","Rockland",2009,867,9182,10049
"6820","Rockland","Plymouth County County","MA","Rockland",2010,899,9012,9911
"6821","Rockland","Plymouth County County","MA","Rockland",2011,710,9099,9809
"6822","Rockland","Plymouth County County","MA","Rockland",2012,654,9199,9853
"6823","Rockport","Essex County County","MA","Rockport",1990,281,3778,4059
"6824","Rockport","Essex County County","MA","Rockport",1991,367,3672,4039
"6825","Rockport","Essex County County","MA","Rockport",1992,408,3688,4096
"6826","Rockport","Essex County County","MA","Rockport",1993,345,3796,4141
"6827","Rockport","Essex County County","MA","Rockport",1994,275,3876,4151
"6828","Rockport","Essex County County","MA","Rockport",1995,236,3760,3996
"6829","Rockport","Essex County County","MA","Rockport",1996,207,3839,4046
"6830","Rockport","Essex County County","MA","Rockport",1997,180,3935,4115
"6831","Rockport","Essex County County","MA","Rockport",1998,165,4016,4181
"6832","Rockport","Essex County County","MA","Rockport",1999,137,4059,4196
"6833","Rockport","Essex County County","MA","Rockport",2000,124,4094,4218
"6834","Rockport","Essex County County","MA","Rockport",2001,175,4096,4271
"6835","Rockport","Essex County County","MA","Rockport",2002,219,4036,4255
"6836","Rockport","Essex County County","MA","Rockport",2003,247,3973,4220
"6837","Rockport","Essex County County","MA","Rockport",2004,223,3953,4176
"6838","Rockport","Essex County County","MA","Rockport",2005,195,3976,4171
"6839","Rockport","Essex County County","MA","Rockport",2006,190,3850,4040
"6840","Rockport","Essex County County","MA","Rockport",2007,172,3870,4042
"6841","Rockport","Essex County County","MA","Rockport",2008,218,3870,4088
"6842","Rockport","Essex County County","MA","Rockport",2009,313,3750,4063
"6843","Rockport","Essex County County","MA","Rockport",2010,317,3448,3765
"6844","Rockport","Essex County County","MA","Rockport",2011,287,3490,3777
"6845","Rockport","Essex County County","MA","Rockport",2012,235,3529,3764
"6846","Rowe","Franklin County County","MA","Rowe",1990,18,152,170
"6847","Rowe","Franklin County County","MA","Rowe",1991,12,149,161
"6848","Rowe","Franklin County County","MA","Rowe",1992,18,150,168
"6849","Rowe","Franklin County County","MA","Rowe",1993,21,152,173
"6850","Rowe","Franklin County County","MA","Rowe",1994,19,159,178
"6851","Rowe","Franklin County County","MA","Rowe",1995,12,155,167
"6852","Rowe","Franklin County County","MA","Rowe",1996,11,155,166
"6853","Rowe","Franklin County County","MA","Rowe",1997,8,158,166
"6854","Rowe","Franklin County County","MA","Rowe",1998,10,160,170
"6855","Rowe","Franklin County County","MA","Rowe",1999,7,163,170
"6856","Rowe","Franklin County County","MA","Rowe",2000,8,182,190
"6857","Rowe","Franklin County County","MA","Rowe",2001,6,180,186
"6858","Rowe","Franklin County County","MA","Rowe",2002,9,182,191
"6859","Rowe","Franklin County County","MA","Rowe",2003,13,182,195
"6860","Rowe","Franklin County County","MA","Rowe",2004,10,178,188
"6861","Rowe","Franklin County County","MA","Rowe",2005,11,178,189
"6862","Rowe","Franklin County County","MA","Rowe",2006,10,181,191
"6863","Rowe","Franklin County County","MA","Rowe",2007,11,177,188
"6864","Rowe","Franklin County County","MA","Rowe",2008,8,175,183
"6865","Rowe","Franklin County County","MA","Rowe",2009,16,169,185
"6866","Rowe","Franklin County County","MA","Rowe",2010,16,194,210
"6867","Rowe","Franklin County County","MA","Rowe",2011,14,195,209
"6868","Rowe","Franklin County County","MA","Rowe",2012,11,196,207
"6869","Rowley","Essex County County","MA","Rowley",1990,190,2480,2670
"6870","Rowley","Essex County County","MA","Rowley",1991,191,2488,2679
"6871","Rowley","Essex County County","MA","Rowley",1992,190,2574,2764
"6872","Rowley","Essex County County","MA","Rowley",1993,125,2705,2830
"6873","Rowley","Essex County County","MA","Rowley",1994,122,2801,2923
"6874","Rowley","Essex County County","MA","Rowley",1995,108,2816,2924
"6875","Rowley","Essex County County","MA","Rowley",1996,105,2892,2997
"6876","Rowley","Essex County County","MA","Rowley",1997,103,2990,3093
"6877","Rowley","Essex County County","MA","Rowley",1998,76,3075,3151
"6878","Rowley","Essex County County","MA","Rowley",1999,67,3173,3240
"6879","Rowley","Essex County County","MA","Rowley",2000,59,3139,3198
"6880","Rowley","Essex County County","MA","Rowley",2001,90,3152,3242
"6881","Rowley","Essex County County","MA","Rowley",2002,154,3113,3267
"6882","Rowley","Essex County County","MA","Rowley",2003,160,3085,3245
"6883","Rowley","Essex County County","MA","Rowley",2004,140,3134,3274
"6884","Rowley","Essex County County","MA","Rowley",2005,145,3239,3384
"6885","Rowley","Essex County County","MA","Rowley",2006,134,3128,3262
"6886","Rowley","Essex County County","MA","Rowley",2007,123,3148,3271
"6887","Rowley","Essex County County","MA","Rowley",2008,150,3150,3300
"6888","Rowley","Essex County County","MA","Rowley",2009,244,3080,3324
"6889","Rowley","Essex County County","MA","Rowley",2010,249,3143,3392
"6890","Rowley","Essex County County","MA","Rowley",2011,232,3182,3414
"6891","Rowley","Essex County County","MA","Rowley",2012,187,3217,3404
"6892","Royalston","Worcester County County","MA","Royalston",1990,27,507,534
"6893","Royalston","Worcester County County","MA","Royalston",1991,57,506,563
"6894","Royalston","Worcester County County","MA","Royalston",1992,31,495,526
"6895","Royalston","Worcester County County","MA","Royalston",1993,43,498,541
"6896","Royalston","Worcester County County","MA","Royalston",1994,42,494,536
"6897","Royalston","Worcester County County","MA","Royalston",1995,29,496,525
"6898","Royalston","Worcester County County","MA","Royalston",1996,27,491,518
"6899","Royalston","Worcester County County","MA","Royalston",1997,23,503,526
"6900","Royalston","Worcester County County","MA","Royalston",1998,22,470,492
"6901","Royalston","Worcester County County","MA","Royalston",1999,21,473,494
"6902","Royalston","Worcester County County","MA","Royalston",2000,16,614,630
"6903","Royalston","Worcester County County","MA","Royalston",2001,27,611,638
"6904","Royalston","Worcester County County","MA","Royalston",2002,43,616,659
"6905","Royalston","Worcester County County","MA","Royalston",2003,46,615,661
"6906","Royalston","Worcester County County","MA","Royalston",2004,43,626,669
"6907","Royalston","Worcester County County","MA","Royalston",2005,40,625,665
"6908","Royalston","Worcester County County","MA","Royalston",2006,41,636,677
"6909","Royalston","Worcester County County","MA","Royalston",2007,37,638,675
"6910","Royalston","Worcester County County","MA","Royalston",2008,49,628,677
"6911","Royalston","Worcester County County","MA","Royalston",2009,64,583,647
"6912","Royalston","Worcester County County","MA","Royalston",2010,64,554,618
"6913","Royalston","Worcester County County","MA","Royalston",2011,63,554,617
"6914","Royalston","Worcester County County","MA","Royalston",2012,51,553,604
"6915","Russell","Hampden County County","MA","Russell",1990,41,830,871
"6916","Russell","Hampden County County","MA","Russell",1991,73,800,873
"6917","Russell","Hampden County County","MA","Russell",1992,73,823,896
"6918","Russell","Hampden County County","MA","Russell",1993,65,827,892
"6919","Russell","Hampden County County","MA","Russell",1994,71,839,910
"6920","Russell","Hampden County County","MA","Russell",1995,64,814,878
"6921","Russell","Hampden County County","MA","Russell",1996,39,824,863
"6922","Russell","Hampden County County","MA","Russell",1997,29,848,877
"6923","Russell","Hampden County County","MA","Russell",1998,24,855,879
"6924","Russell","Hampden County County","MA","Russell",1999,37,859,896
"6925","Russell","Hampden County County","MA","Russell",2000,26,905,931
"6926","Russell","Hampden County County","MA","Russell",2001,38,909,947
"6927","Russell","Hampden County County","MA","Russell",2002,50,912,962
"6928","Russell","Hampden County County","MA","Russell",2003,52,911,963
"6929","Russell","Hampden County County","MA","Russell",2004,47,918,965
"6930","Russell","Hampden County County","MA","Russell",2005,49,929,978
"6931","Russell","Hampden County County","MA","Russell",2006,55,942,997
"6932","Russell","Hampden County County","MA","Russell",2007,50,940,990
"6933","Russell","Hampden County County","MA","Russell",2008,56,926,982
"6934","Russell","Hampden County County","MA","Russell",2009,79,909,988
"6935","Russell","Hampden County County","MA","Russell",2010,86,915,1001
"6936","Russell","Hampden County County","MA","Russell",2011,70,905,975
"6937","Russell","Hampden County County","MA","Russell",2012,65,906,971
"6938","Rutland","Worcester County County","MA","Rutland",1990,131,2647,2778
"6939","Rutland","Worcester County County","MA","Rutland",1991,244,2610,2854
"6940","Rutland","Worcester County County","MA","Rutland",1992,253,2639,2892
"6941","Rutland","Worcester County County","MA","Rutland",1993,187,2786,2973
"6942","Rutland","Worcester County County","MA","Rutland",1994,139,2903,3042
"6943","Rutland","Worcester County County","MA","Rutland",1995,129,2726,2855
"6944","Rutland","Worcester County County","MA","Rutland",1996,111,2794,2905
"6945","Rutland","Worcester County County","MA","Rutland",1997,94,2916,3010
"6946","Rutland","Worcester County County","MA","Rutland",1998,96,3028,3124
"6947","Rutland","Worcester County County","MA","Rutland",1999,85,3098,3183
"6948","Rutland","Worcester County County","MA","Rutland",2000,90,3514,3604
"6949","Rutland","Worcester County County","MA","Rutland",2001,110,3577,3687
"6950","Rutland","Worcester County County","MA","Rutland",2002,181,3658,3839
"6951","Rutland","Worcester County County","MA","Rutland",2003,200,3745,3945
"6952","Rutland","Worcester County County","MA","Rutland",2004,188,3847,4035
"6953","Rutland","Worcester County County","MA","Rutland",2005,163,3942,4105
"6954","Rutland","Worcester County County","MA","Rutland",2006,156,4055,4211
"6955","Rutland","Worcester County County","MA","Rutland",2007,182,4205,4387
"6956","Rutland","Worcester County County","MA","Rutland",2008,197,4171,4368
"6957","Rutland","Worcester County County","MA","Rutland",2009,342,4087,4429
"6958","Rutland","Worcester County County","MA","Rutland",2010,321,4040,4361
"6959","Rutland","Worcester County County","MA","Rutland",2011,291,4077,4368
"6960","Rutland","Worcester County County","MA","Rutland",2012,285,4076,4361
"6961","Salem","Essex County County","MA","Salem",1990,1295,19877,21172
"6962","Salem","Essex County County","MA","Salem",1991,1820,19163,20983
"6963","Salem","Essex County County","MA","Salem",1992,2062,18858,20920
"6964","Salem","Essex County County","MA","Salem",1993,1443,18981,20424
"6965","Salem","Essex County County","MA","Salem",1994,1170,19180,20350
"6966","Salem","Essex County County","MA","Salem",1995,1107,19597,20704
"6967","Salem","Essex County County","MA","Salem",1996,956,19952,20908
"6968","Salem","Essex County County","MA","Salem",1997,872,20507,21379
"6969","Salem","Essex County County","MA","Salem",1998,771,20843,21614
"6970","Salem","Essex County County","MA","Salem",1999,747,20992,21739
"6971","Salem","Essex County County","MA","Salem",2000,588,22477,23065
"6972","Salem","Essex County County","MA","Salem",2001,860,22726,23586
"6973","Salem","Essex County County","MA","Salem",2002,1270,23007,24277
"6974","Salem","Essex County County","MA","Salem",2003,1431,22716,24147
"6975","Salem","Essex County County","MA","Salem",2004,1307,22432,23739
"6976","Salem","Essex County County","MA","Salem",2005,1144,22389,23533
"6977","Salem","Essex County County","MA","Salem",2006,1115,22435,23550
"6978","Salem","Essex County County","MA","Salem",2007,1048,22289,23337
"6979","Salem","Essex County County","MA","Salem",2008,1251,22502,23753
"6980","Salem","Essex County County","MA","Salem",2009,1940,21889,23829
"6981","Salem","Essex County County","MA","Salem",2010,1931,21920,23851
"6982","Salem","Essex County County","MA","Salem",2011,1702,22168,23870
"6983","Salem","Essex County County","MA","Salem",2012,1575,22339,23914
"6984","Salisbury","Essex County County","MA","Salisbury",1990,286,3472,3758
"6985","Salisbury","Essex County County","MA","Salisbury",1991,392,3387,3779
"6986","Salisbury","Essex County County","MA","Salisbury",1992,342,3378,3720
"6987","Salisbury","Essex County County","MA","Salisbury",1993,348,3431,3779
"6988","Salisbury","Essex County County","MA","Salisbury",1994,272,3481,3753
"6989","Salisbury","Essex County County","MA","Salisbury",1995,236,3508,3744
"6990","Salisbury","Essex County County","MA","Salisbury",1996,190,3599,3789
"6991","Salisbury","Essex County County","MA","Salisbury",1997,173,3714,3887
"6992","Salisbury","Essex County County","MA","Salisbury",1998,176,3797,3973
"6993","Salisbury","Essex County County","MA","Salisbury",1999,173,3850,4023
"6994","Salisbury","Essex County County","MA","Salisbury",2000,132,4212,4344
"6995","Salisbury","Essex County County","MA","Salisbury",2001,196,4192,4388
"6996","Salisbury","Essex County County","MA","Salisbury",2002,277,4076,4353
"6997","Salisbury","Essex County County","MA","Salisbury",2003,284,4001,4285
"6998","Salisbury","Essex County County","MA","Salisbury",2004,269,4021,4290
"6999","Salisbury","Essex County County","MA","Salisbury",2005,250,4117,4367
"7000","Salisbury","Essex County County","MA","Salisbury",2006,244,4232,4476
"7001","Salisbury","Essex County County","MA","Salisbury",2007,206,4280,4486
"7002","Salisbury","Essex County County","MA","Salisbury",2008,264,4165,4429
"7003","Salisbury","Essex County County","MA","Salisbury",2009,388,4128,4516
"7004","Salisbury","Essex County County","MA","Salisbury",2010,456,4064,4520
"7005","Salisbury","Essex County County","MA","Salisbury",2011,357,4116,4473
"7006","Salisbury","Essex County County","MA","Salisbury",2012,305,4170,4475
"7007","Sandisfield","Berkshire County County","MA","Sandisfield",1990,16,264,280
"7008","Sandisfield","Berkshire County County","MA","Sandisfield",1991,30,265,295
"7009","Sandisfield","Berkshire County County","MA","Sandisfield",1992,32,274,306
"7010","Sandisfield","Berkshire County County","MA","Sandisfield",1993,40,284,324
"7011","Sandisfield","Berkshire County County","MA","Sandisfield",1994,35,301,336
"7012","Sandisfield","Berkshire County County","MA","Sandisfield",1995,24,283,307
"7013","Sandisfield","Berkshire County County","MA","Sandisfield",1996,21,289,310
"7014","Sandisfield","Berkshire County County","MA","Sandisfield",1997,21,295,316
"7015","Sandisfield","Berkshire County County","MA","Sandisfield",1998,9,294,303
"7016","Sandisfield","Berkshire County County","MA","Sandisfield",1999,13,293,306
"7017","Sandisfield","Berkshire County County","MA","Sandisfield",2000,11,436,447
"7018","Sandisfield","Berkshire County County","MA","Sandisfield",2001,15,451,466
"7019","Sandisfield","Berkshire County County","MA","Sandisfield",2002,23,465,488
"7020","Sandisfield","Berkshire County County","MA","Sandisfield",2003,25,465,490
"7021","Sandisfield","Berkshire County County","MA","Sandisfield",2004,27,464,491
"7022","Sandisfield","Berkshire County County","MA","Sandisfield",2005,19,476,495
"7023","Sandisfield","Berkshire County County","MA","Sandisfield",2006,20,485,505
"7024","Sandisfield","Berkshire County County","MA","Sandisfield",2007,15,477,492
"7025","Sandisfield","Berkshire County County","MA","Sandisfield",2008,23,485,508
"7026","Sandisfield","Berkshire County County","MA","Sandisfield",2009,36,471,507
"7027","Sandisfield","Berkshire County County","MA","Sandisfield",2010,42,512,554
"7028","Sandisfield","Berkshire County County","MA","Sandisfield",2011,36,516,552
"7029","Sandisfield","Berkshire County County","MA","Sandisfield",2012,30,512,542
"7030","Sandwich","Barnstable County County","MA","Sandwich",1990,391,7970,8361
"7031","Sandwich","Barnstable County County","MA","Sandwich",1991,684,7873,8557
"7032","Sandwich","Barnstable County County","MA","Sandwich",1992,722,7988,8710
"7033","Sandwich","Barnstable County County","MA","Sandwich",1993,635,8350,8985
"7034","Sandwich","Barnstable County County","MA","Sandwich",1994,553,8708,9261
"7035","Sandwich","Barnstable County County","MA","Sandwich",1995,509,8769,9278
"7036","Sandwich","Barnstable County County","MA","Sandwich",1996,394,9068,9462
"7037","Sandwich","Barnstable County County","MA","Sandwich",1997,407,9258,9665
"7038","Sandwich","Barnstable County County","MA","Sandwich",1998,316,9506,9822
"7039","Sandwich","Barnstable County County","MA","Sandwich",1999,289,9963,10252
"7040","Sandwich","Barnstable County County","MA","Sandwich",2000,260,10503,10763
"7041","Sandwich","Barnstable County County","MA","Sandwich",2001,329,10648,10977
"7042","Sandwich","Barnstable County County","MA","Sandwich",2002,427,10870,11297
"7043","Sandwich","Barnstable County County","MA","Sandwich",2003,496,11133,11629
"7044","Sandwich","Barnstable County County","MA","Sandwich",2004,492,11219,11711
"7045","Sandwich","Barnstable County County","MA","Sandwich",2005,441,11231,11672
"7046","Sandwich","Barnstable County County","MA","Sandwich",2006,485,11220,11705
"7047","Sandwich","Barnstable County County","MA","Sandwich",2007,462,11146,11608
"7048","Sandwich","Barnstable County County","MA","Sandwich",2008,585,11063,11648
"7049","Sandwich","Barnstable County County","MA","Sandwich",2009,867,10664,11531
"7050","Sandwich","Barnstable County County","MA","Sandwich",2010,887,11203,12090
"7051","Sandwich","Barnstable County County","MA","Sandwich",2011,798,11185,11983
"7052","Sandwich","Barnstable County County","MA","Sandwich",2012,739,11373,12112
"7053","Saugus","Essex County County","MA","Saugus",1990,832,13445,14277
"7054","Saugus","Essex County County","MA","Saugus",1991,1222,13008,14230
"7055","Saugus","Essex County County","MA","Saugus",1992,1335,12894,14229
"7056","Saugus","Essex County County","MA","Saugus",1993,893,13085,13978
"7057","Saugus","Essex County County","MA","Saugus",1994,831,13354,14185
"7058","Saugus","Essex County County","MA","Saugus",1995,718,13564,14282
"7059","Saugus","Essex County County","MA","Saugus",1996,589,13849,14438
"7060","Saugus","Essex County County","MA","Saugus",1997,550,14239,14789
"7061","Saugus","Essex County County","MA","Saugus",1998,457,14604,15061
"7062","Saugus","Essex County County","MA","Saugus",1999,492,14764,15256
"7063","Saugus","Essex County County","MA","Saugus",2000,371,13925,14296
"7064","Saugus","Essex County County","MA","Saugus",2001,476,13965,14441
"7065","Saugus","Essex County County","MA","Saugus",2002,721,13786,14507
"7066","Saugus","Essex County County","MA","Saugus",2003,881,13610,14491
"7067","Saugus","Essex County County","MA","Saugus",2004,830,13722,14552
"7068","Saugus","Essex County County","MA","Saugus",2005,736,13957,14693
"7069","Saugus","Essex County County","MA","Saugus",2006,735,13697,14432
"7070","Saugus","Essex County County","MA","Saugus",2007,676,13917,14593
"7071","Saugus","Essex County County","MA","Saugus",2008,788,14082,14870
"7072","Saugus","Essex County County","MA","Saugus",2009,1259,13826,15085
"7073","Saugus","Essex County County","MA","Saugus",2010,1205,13375,14580
"7074","Saugus","Essex County County","MA","Saugus",2011,1024,13537,14561
"7075","Saugus","Essex County County","MA","Saugus",2012,928,13685,14613
"7076","Savoy","Berkshire County County","MA","Savoy",1990,81,339,420
"7077","Savoy","Berkshire County County","MA","Savoy",1991,78,335,413
"7078","Savoy","Berkshire County County","MA","Savoy",1992,56,343,399
"7079","Savoy","Berkshire County County","MA","Savoy",1993,48,389,437
"7080","Savoy","Berkshire County County","MA","Savoy",1994,36,399,435
"7081","Savoy","Berkshire County County","MA","Savoy",1995,30,359,389
"7082","Savoy","Berkshire County County","MA","Savoy",1996,24,369,393
"7083","Savoy","Berkshire County County","MA","Savoy",1997,27,377,404
"7084","Savoy","Berkshire County County","MA","Savoy",1998,25,384,409
"7085","Savoy","Berkshire County County","MA","Savoy",1999,24,391,415
"7086","Savoy","Berkshire County County","MA","Savoy",2000,16,373,389
"7087","Savoy","Berkshire County County","MA","Savoy",2001,19,374,393
"7088","Savoy","Berkshire County County","MA","Savoy",2002,25,383,408
"7089","Savoy","Berkshire County County","MA","Savoy",2003,32,384,416
"7090","Savoy","Berkshire County County","MA","Savoy",2004,23,388,411
"7091","Savoy","Berkshire County County","MA","Savoy",2005,24,397,421
"7092","Savoy","Berkshire County County","MA","Savoy",2006,21,408,429
"7093","Savoy","Berkshire County County","MA","Savoy",2007,21,404,425
"7094","Savoy","Berkshire County County","MA","Savoy",2008,25,402,427
"7095","Savoy","Berkshire County County","MA","Savoy",2009,39,390,429
"7096","Savoy","Berkshire County County","MA","Savoy",2010,43,361,404
"7097","Savoy","Berkshire County County","MA","Savoy",2011,34,364,398
"7098","Savoy","Berkshire County County","MA","Savoy",2012,39,363,402
"7099","Scituate","Plymouth County County","MA","Scituate",1990,404,8697,9101
"7100","Scituate","Plymouth County County","MA","Scituate",1991,581,8412,8993
"7101","Scituate","Plymouth County County","MA","Scituate",1992,620,8358,8978
"7102","Scituate","Plymouth County County","MA","Scituate",1993,508,8577,9085
"7103","Scituate","Plymouth County County","MA","Scituate",1994,410,8744,9154
"7104","Scituate","Plymouth County County","MA","Scituate",1995,359,8756,9115
"7105","Scituate","Plymouth County County","MA","Scituate",1996,322,8984,9306
"7106","Scituate","Plymouth County County","MA","Scituate",1997,293,9279,9572
"7107","Scituate","Plymouth County County","MA","Scituate",1998,255,9462,9717
"7108","Scituate","Plymouth County County","MA","Scituate",1999,223,9608,9831
"7109","Scituate","Plymouth County County","MA","Scituate",2000,208,9311,9519
"7110","Scituate","Plymouth County County","MA","Scituate",2001,278,9318,9596
"7111","Scituate","Plymouth County County","MA","Scituate",2002,397,9231,9628
"7112","Scituate","Plymouth County County","MA","Scituate",2003,410,9127,9537
"7113","Scituate","Plymouth County County","MA","Scituate",2004,400,9117,9517
"7114","Scituate","Plymouth County County","MA","Scituate",2005,373,9176,9549
"7115","Scituate","Plymouth County County","MA","Scituate",2006,362,9083,9445
"7116","Scituate","Plymouth County County","MA","Scituate",2007,363,9168,9531
"7117","Scituate","Plymouth County County","MA","Scituate",2008,412,9128,9540
"7118","Scituate","Plymouth County County","MA","Scituate",2009,648,8840,9488
"7119","Scituate","Plymouth County County","MA","Scituate",2010,661,8893,9554
"7120","Scituate","Plymouth County County","MA","Scituate",2011,542,8981,9523
"7121","Scituate","Plymouth County County","MA","Scituate",2012,512,9080,9592
"7122","Seekonk","Bristol County County","MA","Seekonk",1990,463,6891,7354
"7123","Seekonk","Bristol County County","MA","Seekonk",1991,697,6590,7287
"7124","Seekonk","Bristol County County","MA","Seekonk",1992,781,6637,7418
"7125","Seekonk","Bristol County County","MA","Seekonk",1993,627,6780,7407
"7126","Seekonk","Bristol County County","MA","Seekonk",1994,603,6909,7512
"7127","Seekonk","Bristol County County","MA","Seekonk",1995,507,7019,7526
"7128","Seekonk","Bristol County County","MA","Seekonk",1996,439,7060,7499
"7129","Seekonk","Bristol County County","MA","Seekonk",1997,360,7200,7560
"7130","Seekonk","Bristol County County","MA","Seekonk",1998,293,7338,7631
"7131","Seekonk","Bristol County County","MA","Seekonk",1999,238,7389,7627
"7132","Seekonk","Bristol County County","MA","Seekonk",2000,245,7119,7364
"7133","Seekonk","Bristol County County","MA","Seekonk",2001,314,7080,7394
"7134","Seekonk","Bristol County County","MA","Seekonk",2002,386,7149,7535
"7135","Seekonk","Bristol County County","MA","Seekonk",2003,399,7214,7613
"7136","Seekonk","Bristol County County","MA","Seekonk",2004,395,7207,7602
"7137","Seekonk","Bristol County County","MA","Seekonk",2005,380,7225,7605
"7138","Seekonk","Bristol County County","MA","Seekonk",2006,399,7290,7689
"7139","Seekonk","Bristol County County","MA","Seekonk",2007,365,7280,7645
"7140","Seekonk","Bristol County County","MA","Seekonk",2008,479,7162,7641
"7141","Seekonk","Bristol County County","MA","Seekonk",2009,793,6925,7718
"7142","Seekonk","Bristol County County","MA","Seekonk",2010,786,6880,7666
"7143","Seekonk","Bristol County County","MA","Seekonk",2011,725,6931,7656
"7144","Seekonk","Bristol County County","MA","Seekonk",2012,646,6942,7588
"7145","Sharon","Norfolk County County","MA","Sharon",1990,385,8334,8719
"7146","Sharon","Norfolk County County","MA","Sharon",1991,508,8072,8580
"7147","Sharon","Norfolk County County","MA","Sharon",1992,499,8128,8627
"7148","Sharon","Norfolk County County","MA","Sharon",1993,433,8375,8808
"7149","Sharon","Norfolk County County","MA","Sharon",1994,406,8698,9104
"7150","Sharon","Norfolk County County","MA","Sharon",1995,331,8775,9106
"7151","Sharon","Norfolk County County","MA","Sharon",1996,302,9004,9306
"7152","Sharon","Norfolk County County","MA","Sharon",1997,252,9275,9527
"7153","Sharon","Norfolk County County","MA","Sharon",1998,187,9442,9629
"7154","Sharon","Norfolk County County","MA","Sharon",1999,213,9532,9745
"7155","Sharon","Norfolk County County","MA","Sharon",2000,207,9212,9419
"7156","Sharon","Norfolk County County","MA","Sharon",2001,279,9205,9484
"7157","Sharon","Norfolk County County","MA","Sharon",2002,417,9044,9461
"7158","Sharon","Norfolk County County","MA","Sharon",2003,376,8882,9258
"7159","Sharon","Norfolk County County","MA","Sharon",2004,347,8833,9180
"7160","Sharon","Norfolk County County","MA","Sharon",2005,315,8852,9167
"7161","Sharon","Norfolk County County","MA","Sharon",2006,315,8690,9005
"7162","Sharon","Norfolk County County","MA","Sharon",2007,316,8742,9058
"7163","Sharon","Norfolk County County","MA","Sharon",2008,394,8947,9341
"7164","Sharon","Norfolk County County","MA","Sharon",2009,617,8853,9470
"7165","Sharon","Norfolk County County","MA","Sharon",2010,573,8775,9348
"7166","Sharon","Norfolk County County","MA","Sharon",2011,513,8875,9388
"7167","Sharon","Norfolk County County","MA","Sharon",2012,463,8972,9435
"7168","Sheffield","Berkshire County County","MA","Sheffield",1990,75,1474,1549
"7169","Sheffield","Berkshire County County","MA","Sheffield",1991,108,1467,1575
"7170","Sheffield","Berkshire County County","MA","Sheffield",1992,128,1463,1591
"7171","Sheffield","Berkshire County County","MA","Sheffield",1993,115,1545,1660
"7172","Sheffield","Berkshire County County","MA","Sheffield",1994,89,1586,1675
"7173","Sheffield","Berkshire County County","MA","Sheffield",1995,77,1615,1692
"7174","Sheffield","Berkshire County County","MA","Sheffield",1996,62,1656,1718
"7175","Sheffield","Berkshire County County","MA","Sheffield",1997,60,1698,1758
"7176","Sheffield","Berkshire County County","MA","Sheffield",1998,42,1697,1739
"7177","Sheffield","Berkshire County County","MA","Sheffield",1999,39,1695,1734
"7178","Sheffield","Berkshire County County","MA","Sheffield",2000,42,1847,1889
"7179","Sheffield","Berkshire County County","MA","Sheffield",2001,43,1911,1954
"7180","Sheffield","Berkshire County County","MA","Sheffield",2002,58,1971,2029
"7181","Sheffield","Berkshire County County","MA","Sheffield",2003,76,1989,2065
"7182","Sheffield","Berkshire County County","MA","Sheffield",2004,65,1977,2042
"7183","Sheffield","Berkshire County County","MA","Sheffield",2005,62,2019,2081
"7184","Sheffield","Berkshire County County","MA","Sheffield",2006,78,2037,2115
"7185","Sheffield","Berkshire County County","MA","Sheffield",2007,76,1989,2065
"7186","Sheffield","Berkshire County County","MA","Sheffield",2008,76,1979,2055
"7187","Sheffield","Berkshire County County","MA","Sheffield",2009,138,1917,2055
"7188","Sheffield","Berkshire County County","MA","Sheffield",2010,122,1910,2032
"7189","Sheffield","Berkshire County County","MA","Sheffield",2011,110,1919,2029
"7190","Sheffield","Berkshire County County","MA","Sheffield",2012,105,1903,2008
"7191","Shelburne","Franklin County County","MA","Shelburne",1990,100,996,1096
"7192","Shelburne","Franklin County County","MA","Shelburne",1991,144,977,1121
"7193","Shelburne","Franklin County County","MA","Shelburne",1992,142,938,1080
"7194","Shelburne","Franklin County County","MA","Shelburne",1993,115,920,1035
"7195","Shelburne","Franklin County County","MA","Shelburne",1994,97,925,1022
"7196","Shelburne","Franklin County County","MA","Shelburne",1995,94,1009,1103
"7197","Shelburne","Franklin County County","MA","Shelburne",1996,82,1012,1094
"7198","Shelburne","Franklin County County","MA","Shelburne",1997,95,1035,1130
"7199","Shelburne","Franklin County County","MA","Shelburne",1998,57,1055,1112
"7200","Shelburne","Franklin County County","MA","Shelburne",1999,53,1072,1125
"7201","Shelburne","Franklin County County","MA","Shelburne",2000,45,1062,1107
"7202","Shelburne","Franklin County County","MA","Shelburne",2001,52,1061,1113
"7203","Shelburne","Franklin County County","MA","Shelburne",2002,70,1074,1144
"7204","Shelburne","Franklin County County","MA","Shelburne",2003,69,1072,1141
"7205","Shelburne","Franklin County County","MA","Shelburne",2004,66,1051,1117
"7206","Shelburne","Franklin County County","MA","Shelburne",2005,61,1045,1106
"7207","Shelburne","Franklin County County","MA","Shelburne",2006,72,1047,1119
"7208","Shelburne","Franklin County County","MA","Shelburne",2007,56,1035,1091
"7209","Shelburne","Franklin County County","MA","Shelburne",2008,76,1018,1094
"7210","Shelburne","Franklin County County","MA","Shelburne",2009,115,987,1102
"7211","Shelburne","Franklin County County","MA","Shelburne",2010,120,937,1057
"7212","Shelburne","Franklin County County","MA","Shelburne",2011,100,938,1038
"7213","Shelburne","Franklin County County","MA","Shelburne",2012,84,941,1025
"7214","Sherborn","Middlesex County County","MA","Sherborn",1990,58,2067,2125
"7215","Sherborn","Middlesex County County","MA","Sherborn",1991,91,2001,2092
"7216","Sherborn","Middlesex County County","MA","Sherborn",1992,73,2028,2101
"7217","Sherborn","Middlesex County County","MA","Sherborn",1993,70,2078,2148
"7218","Sherborn","Middlesex County County","MA","Sherborn",1994,57,2109,2166
"7219","Sherborn","Middlesex County County","MA","Sherborn",1995,55,2083,2138
"7220","Sherborn","Middlesex County County","MA","Sherborn",1996,49,2138,2187
"7221","Sherborn","Middlesex County County","MA","Sherborn",1997,42,2196,2238
"7222","Sherborn","Middlesex County County","MA","Sherborn",1998,34,2234,2268
"7223","Sherborn","Middlesex County County","MA","Sherborn",1999,34,2254,2288
"7224","Sherborn","Middlesex County County","MA","Sherborn",2000,38,1934,1972
"7225","Sherborn","Middlesex County County","MA","Sherborn",2001,57,1928,1985
"7226","Sherborn","Middlesex County County","MA","Sherborn",2002,80,1891,1971
"7227","Sherborn","Middlesex County County","MA","Sherborn",2003,89,1884,1973
"7228","Sherborn","Middlesex County County","MA","Sherborn",2004,76,1874,1950
"7229","Sherborn","Middlesex County County","MA","Sherborn",2005,70,1891,1961
"7230","Sherborn","Middlesex County County","MA","Sherborn",2006,63,1863,1926
"7231","Sherborn","Middlesex County County","MA","Sherborn",2007,60,1877,1937
"7232","Sherborn","Middlesex County County","MA","Sherborn",2008,68,1875,1943
"7233","Sherborn","Middlesex County County","MA","Sherborn",2009,119,1832,1951
"7234","Sherborn","Middlesex County County","MA","Sherborn",2010,114,1786,1900
"7235","Sherborn","Middlesex County County","MA","Sherborn",2011,88,1813,1901
"7236","Sherborn","Middlesex County County","MA","Sherborn",2012,77,1832,1909
"7237","Shirley","Middlesex County County","MA","Shirley",1990,183,2776,2959
"7238","Shirley","Middlesex County County","MA","Shirley",1991,236,2702,2938
"7239","Shirley","Middlesex County County","MA","Shirley",1992,226,3084,3310
"7240","Shirley","Middlesex County County","MA","Shirley",1993,191,3128,3319
"7241","Shirley","Middlesex County County","MA","Shirley",1994,172,3168,3340
"7242","Shirley","Middlesex County County","MA","Shirley",1995,157,3321,3478
"7243","Shirley","Middlesex County County","MA","Shirley",1996,133,3397,3530
"7244","Shirley","Middlesex County County","MA","Shirley",1997,106,3510,3616
"7245","Shirley","Middlesex County County","MA","Shirley",1998,96,3429,3525
"7246","Shirley","Middlesex County County","MA","Shirley",1999,104,3510,3614
"7247","Shirley","Middlesex County County","MA","Shirley",2000,83,3517,3600
"7248","Shirley","Middlesex County County","MA","Shirley",2001,136,3545,3681
"7249","Shirley","Middlesex County County","MA","Shirley",2002,193,3399,3592
"7250","Shirley","Middlesex County County","MA","Shirley",2003,210,3365,3575
"7251","Shirley","Middlesex County County","MA","Shirley",2004,167,3368,3535
"7252","Shirley","Middlesex County County","MA","Shirley",2005,166,3415,3581
"7253","Shirley","Middlesex County County","MA","Shirley",2006,179,3431,3610
"7254","Shirley","Middlesex County County","MA","Shirley",2007,177,3526,3703
"7255","Shirley","Middlesex County County","MA","Shirley",2008,202,3575,3777
"7256","Shirley","Middlesex County County","MA","Shirley",2009,306,3473,3779
"7257","Shirley","Middlesex County County","MA","Shirley",2010,285,3134,3419
"7258","Shirley","Middlesex County County","MA","Shirley",2011,244,3175,3419
"7259","Shirley","Middlesex County County","MA","Shirley",2012,247,3210,3457
"7260","Shrewsbury","Worcester County County","MA","Shrewsbury",1990,704,12653,13357
"7261","Shrewsbury","Worcester County County","MA","Shrewsbury",1991,1002,12257,13259
"7262","Shrewsbury","Worcester County County","MA","Shrewsbury",1992,1016,12491,13507
"7263","Shrewsbury","Worcester County County","MA","Shrewsbury",1993,818,13134,13952
"7264","Shrewsbury","Worcester County County","MA","Shrewsbury",1994,686,13654,14340
"7265","Shrewsbury","Worcester County County","MA","Shrewsbury",1995,582,13810,14392
"7266","Shrewsbury","Worcester County County","MA","Shrewsbury",1996,463,14159,14622
"7267","Shrewsbury","Worcester County County","MA","Shrewsbury",1997,428,14686,15114
"7268","Shrewsbury","Worcester County County","MA","Shrewsbury",1998,371,15156,15527
"7269","Shrewsbury","Worcester County County","MA","Shrewsbury",1999,416,15369,15785
"7270","Shrewsbury","Worcester County County","MA","Shrewsbury",2000,378,16439,16817
"7271","Shrewsbury","Worcester County County","MA","Shrewsbury",2001,542,16598,17140
"7272","Shrewsbury","Worcester County County","MA","Shrewsbury",2002,781,16564,17345
"7273","Shrewsbury","Worcester County County","MA","Shrewsbury",2003,860,16576,17436
"7274","Shrewsbury","Worcester County County","MA","Shrewsbury",2004,757,16576,17333
"7275","Shrewsbury","Worcester County County","MA","Shrewsbury",2005,677,16533,17210
"7276","Shrewsbury","Worcester County County","MA","Shrewsbury",2006,666,16936,17602
"7277","Shrewsbury","Worcester County County","MA","Shrewsbury",2007,655,16950,17605
"7278","Shrewsbury","Worcester County County","MA","Shrewsbury",2008,773,16617,17390
"7279","Shrewsbury","Worcester County County","MA","Shrewsbury",2009,1217,16150,17367
"7280","Shrewsbury","Worcester County County","MA","Shrewsbury",2010,1286,16987,18273
"7281","Shrewsbury","Worcester County County","MA","Shrewsbury",2011,1093,17138,18231
"7282","Shrewsbury","Worcester County County","MA","Shrewsbury",2012,1022,17132,18154
"7283","Shutesbury","Franklin County County","MA","Shutesbury",1990,24,876,900
"7284","Shutesbury","Franklin County County","MA","Shutesbury",1991,55,904,959
"7285","Shutesbury","Franklin County County","MA","Shutesbury",1992,54,888,942
"7286","Shutesbury","Franklin County County","MA","Shutesbury",1993,34,918,952
"7287","Shutesbury","Franklin County County","MA","Shutesbury",1994,31,934,965
"7288","Shutesbury","Franklin County County","MA","Shutesbury",1995,26,951,977
"7289","Shutesbury","Franklin County County","MA","Shutesbury",1996,32,961,993
"7290","Shutesbury","Franklin County County","MA","Shutesbury",1997,32,984,1016
"7291","Shutesbury","Franklin County County","MA","Shutesbury",1998,17,998,1015
"7292","Shutesbury","Franklin County County","MA","Shutesbury",1999,19,1020,1039
"7293","Shutesbury","Franklin County County","MA","Shutesbury",2000,21,1043,1064
"7294","Shutesbury","Franklin County County","MA","Shutesbury",2001,23,1072,1095
"7295","Shutesbury","Franklin County County","MA","Shutesbury",2002,31,1074,1105
"7296","Shutesbury","Franklin County County","MA","Shutesbury",2003,39,1087,1126
"7297","Shutesbury","Franklin County County","MA","Shutesbury",2004,38,1100,1138
"7298","Shutesbury","Franklin County County","MA","Shutesbury",2005,34,1102,1136
"7299","Shutesbury","Franklin County County","MA","Shutesbury",2006,37,1117,1154
"7300","Shutesbury","Franklin County County","MA","Shutesbury",2007,34,1113,1147
"7301","Shutesbury","Franklin County County","MA","Shutesbury",2008,44,1082,1126
"7302","Shutesbury","Franklin County County","MA","Shutesbury",2009,57,1045,1102
"7303","Shutesbury","Franklin County County","MA","Shutesbury",2010,62,981,1043
"7304","Shutesbury","Franklin County County","MA","Shutesbury",2011,50,991,1041
"7305","Shutesbury","Franklin County County","MA","Shutesbury",2012,48,1000,1048
"7306","Somerset","Bristol County County","MA","Somerset",1990,753,8944,9697
"7307","Somerset","Bristol County County","MA","Somerset",1991,1033,8584,9617
"7308","Somerset","Bristol County County","MA","Somerset",1992,1023,8574,9597
"7309","Somerset","Bristol County County","MA","Somerset",1993,1002,8707,9709
"7310","Somerset","Bristol County County","MA","Somerset",1994,773,8796,9569
"7311","Somerset","Bristol County County","MA","Somerset",1995,671,9027,9698
"7312","Somerset","Bristol County County","MA","Somerset",1996,664,9059,9723
"7313","Somerset","Bristol County County","MA","Somerset",1997,539,9205,9744
"7314","Somerset","Bristol County County","MA","Somerset",1998,383,9258,9641
"7315","Somerset","Bristol County County","MA","Somerset",1999,360,9382,9742
"7316","Somerset","Bristol County County","MA","Somerset",2000,340,9310,9650
"7317","Somerset","Bristol County County","MA","Somerset",2001,425,9286,9711
"7318","Somerset","Bristol County County","MA","Somerset",2002,544,9384,9928
"7319","Somerset","Bristol County County","MA","Somerset",2003,546,9441,9987
"7320","Somerset","Bristol County County","MA","Somerset",2004,563,9441,10004
"7321","Somerset","Bristol County County","MA","Somerset",2005,556,9446,10002
"7322","Somerset","Bristol County County","MA","Somerset",2006,576,9473,10049
"7323","Somerset","Bristol County County","MA","Somerset",2007,547,9414,9961
"7324","Somerset","Bristol County County","MA","Somerset",2008,660,9165,9825
"7325","Somerset","Bristol County County","MA","Somerset",2009,1018,8975,9993
"7326","Somerset","Bristol County County","MA","Somerset",2010,1036,8763,9799
"7327","Somerset","Bristol County County","MA","Somerset",2011,924,8827,9751
"7328","Somerset","Bristol County County","MA","Somerset",2012,887,8841,9728
"7329","Somerville","Middlesex County County","MA","Somerville",1990,2232,43162,45394
"7330","Somerville","Middlesex County County","MA","Somerville",1991,3145,40505,43650
"7331","Somerville","Middlesex County County","MA","Somerville",1992,3163,38907,42070
"7332","Somerville","Middlesex County County","MA","Somerville",1993,2659,38663,41322
"7333","Somerville","Middlesex County County","MA","Somerville",1994,2158,38571,40729
"7334","Somerville","Middlesex County County","MA","Somerville",1995,1789,42034,43823
"7335","Somerville","Middlesex County County","MA","Somerville",1996,1482,42694,44176
"7336","Somerville","Middlesex County County","MA","Somerville",1997,1325,43666,44991
"7337","Somerville","Middlesex County County","MA","Somerville",1998,1086,44133,45219
"7338","Somerville","Middlesex County County","MA","Somerville",1999,1043,44240,45283
"7339","Somerville","Middlesex County County","MA","Somerville",2000,951,47505,48456
"7340","Somerville","Middlesex County County","MA","Somerville",2001,1471,47120,48591
"7341","Somerville","Middlesex County County","MA","Somerville",2002,2147,46025,48172
"7342","Somerville","Middlesex County County","MA","Somerville",2003,2295,45031,47326
"7343","Somerville","Middlesex County County","MA","Somerville",2004,1882,44673,46555
"7344","Somerville","Middlesex County County","MA","Somerville",2005,1627,44677,46304
"7345","Somerville","Middlesex County County","MA","Somerville",2006,1597,44679,46276
"7346","Somerville","Middlesex County County","MA","Somerville",2007,1471,44905,46376
"7347","Somerville","Middlesex County County","MA","Somerville",2008,1799,44697,46496
"7348","Somerville","Middlesex County County","MA","Somerville",2009,2846,43502,46348
"7349","Somerville","Middlesex County County","MA","Somerville",2010,2858,43730,46588
"7350","Somerville","Middlesex County County","MA","Somerville",2011,2391,44361,46752
"7351","Somerville","Middlesex County County","MA","Somerville",2012,2135,44847,46982
"7352","South Hadley","Hampshire County County","MA","South Hadley",1990,476,8886,9362
"7353","South Hadley","Hampshire County County","MA","South Hadley",1991,666,8570,9236
"7354","South Hadley","Hampshire County County","MA","South Hadley",1992,681,8588,9269
"7355","South Hadley","Hampshire County County","MA","South Hadley",1993,577,8705,9282
"7356","South Hadley","Hampshire County County","MA","South Hadley",1994,526,8790,9316
"7357","South Hadley","Hampshire County County","MA","South Hadley",1995,470,8758,9228
"7358","South Hadley","Hampshire County County","MA","South Hadley",1996,335,8963,9298
"7359","South Hadley","Hampshire County County","MA","South Hadley",1997,291,9196,9487
"7360","South Hadley","Hampshire County County","MA","South Hadley",1998,262,9245,9507
"7361","South Hadley","Hampshire County County","MA","South Hadley",1999,235,9329,9564
"7362","South Hadley","Hampshire County County","MA","South Hadley",2000,225,9337,9562
"7363","South Hadley","Hampshire County County","MA","South Hadley",2001,283,9307,9590
"7364","South Hadley","Hampshire County County","MA","South Hadley",2002,380,9230,9610
"7365","South Hadley","Hampshire County County","MA","South Hadley",2003,452,9175,9627
"7366","South Hadley","Hampshire County County","MA","South Hadley",2004,423,9132,9555
"7367","South Hadley","Hampshire County County","MA","South Hadley",2005,403,9115,9518
"7368","South Hadley","Hampshire County County","MA","South Hadley",2006,394,9161,9555
"7369","South Hadley","Hampshire County County","MA","South Hadley",2007,369,9143,9512
"7370","South Hadley","Hampshire County County","MA","South Hadley",2008,440,9216,9656
"7371","South Hadley","Hampshire County County","MA","South Hadley",2009,655,8830,9485
"7372","South Hadley","Hampshire County County","MA","South Hadley",2010,680,8957,9637
"7373","South Hadley","Hampshire County County","MA","South Hadley",2011,610,8848,9458
"7374","South Hadley","Hampshire County County","MA","South Hadley",2012,572,8853,9425
"7375","Southampton","Hampshire County County","MA","Southampton",1990,131,2488,2619
"7376","Southampton","Hampshire County County","MA","Southampton",1991,208,2426,2634
"7377","Southampton","Hampshire County County","MA","Southampton",1992,203,2471,2674
"7378","Southampton","Hampshire County County","MA","Southampton",1993,193,2507,2700
"7379","Southampton","Hampshire County County","MA","Southampton",1994,174,2622,2796
"7380","Southampton","Hampshire County County","MA","Southampton",1995,146,2569,2715
"7381","Southampton","Hampshire County County","MA","Southampton",1996,111,2644,2755
"7382","Southampton","Hampshire County County","MA","Southampton",1997,94,2730,2824
"7383","Southampton","Hampshire County County","MA","Southampton",1998,93,2847,2940
"7384","Southampton","Hampshire County County","MA","Southampton",1999,95,2901,2996
"7385","Southampton","Hampshire County County","MA","Southampton",2000,69,3151,3220
"7386","Southampton","Hampshire County County","MA","Southampton",2001,95,3185,3280
"7387","Southampton","Hampshire County County","MA","Southampton",2002,125,3216,3341
"7388","Southampton","Hampshire County County","MA","Southampton",2003,151,3246,3397
"7389","Southampton","Hampshire County County","MA","Southampton",2004,150,3295,3445
"7390","Southampton","Hampshire County County","MA","Southampton",2005,136,3352,3488
"7391","Southampton","Hampshire County County","MA","Southampton",2006,128,3428,3556
"7392","Southampton","Hampshire County County","MA","Southampton",2007,137,3453,3590
"7393","Southampton","Hampshire County County","MA","Southampton",2008,152,3428,3580
"7394","Southampton","Hampshire County County","MA","Southampton",2009,224,3267,3491
"7395","Southampton","Hampshire County County","MA","Southampton",2010,228,3182,3410
"7396","Southampton","Hampshire County County","MA","Southampton",2011,194,3142,3336
"7397","Southampton","Hampshire County County","MA","Southampton",2012,181,3144,3325
"7398","Southborough","Worcester County County","MA","Southborough",1990,184,3632,3816
"7399","Southborough","Worcester County County","MA","Southborough",1991,216,3520,3736
"7400","Southborough","Worcester County County","MA","Southborough",1992,226,3572,3798
"7401","Southborough","Worcester County County","MA","Southborough",1993,199,3675,3874
"7402","Southborough","Worcester County County","MA","Southborough",1994,171,3890,4061
"7403","Southborough","Worcester County County","MA","Southborough",1995,157,3917,4074
"7404","Southborough","Worcester County County","MA","Southborough",1996,129,4054,4183
"7405","Southborough","Worcester County County","MA","Southborough",1997,104,4256,4360
"7406","Southborough","Worcester County County","MA","Southborough",1998,92,4421,4513
"7407","Southborough","Worcester County County","MA","Southborough",1999,95,4597,4692
"7408","Southborough","Worcester County County","MA","Southborough",2000,96,4467,4563
"7409","Southborough","Worcester County County","MA","Southborough",2001,155,4554,4709
"7410","Southborough","Worcester County County","MA","Southborough",2002,236,4544,4780
"7411","Southborough","Worcester County County","MA","Southborough",2003,237,4569,4806
"7412","Southborough","Worcester County County","MA","Southborough",2004,185,4654,4839
"7413","Southborough","Worcester County County","MA","Southborough",2005,178,4731,4909
"7414","Southborough","Worcester County County","MA","Southborough",2006,175,4754,4929
"7415","Southborough","Worcester County County","MA","Southborough",2007,157,4779,4936
"7416","Southborough","Worcester County County","MA","Southborough",2008,183,4873,5056
"7417","Southborough","Worcester County County","MA","Southborough",2009,299,4710,5009
"7418","Southborough","Worcester County County","MA","Southborough",2010,322,4688,5010
"7419","Southborough","Worcester County County","MA","Southborough",2011,242,4700,4942
"7420","Southborough","Worcester County County","MA","Southborough",2012,241,4743,4984
"7421","Southbridge","Worcester County County","MA","Southbridge",1990,681,8076,8757
"7422","Southbridge","Worcester County County","MA","Southbridge",1991,1014,7600,8614
"7423","Southbridge","Worcester County County","MA","Southbridge",1992,984,7209,8193
"7424","Southbridge","Worcester County County","MA","Southbridge",1993,860,7282,8142
"7425","Southbridge","Worcester County County","MA","Southbridge",1994,552,7309,7861
"7426","Southbridge","Worcester County County","MA","Southbridge",1995,532,7909,8441
"7427","Southbridge","Worcester County County","MA","Southbridge",1996,455,7997,8452
"7428","Southbridge","Worcester County County","MA","Southbridge",1997,375,8166,8541
"7429","Southbridge","Worcester County County","MA","Southbridge",1998,368,8236,8604
"7430","Southbridge","Worcester County County","MA","Southbridge",1999,316,8169,8485
"7431","Southbridge","Worcester County County","MA","Southbridge",2000,269,7891,8160
"7432","Southbridge","Worcester County County","MA","Southbridge",2001,378,7866,8244
"7433","Southbridge","Worcester County County","MA","Southbridge",2002,542,7789,8331
"7434","Southbridge","Worcester County County","MA","Southbridge",2003,623,7723,8346
"7435","Southbridge","Worcester County County","MA","Southbridge",2004,568,7662,8230
"7436","Southbridge","Worcester County County","MA","Southbridge",2005,510,7602,8112
"7437","Southbridge","Worcester County County","MA","Southbridge",2006,540,7741,8281
"7438","Southbridge","Worcester County County","MA","Southbridge",2007,501,7730,8231
"7439","Southbridge","Worcester County County","MA","Southbridge",2008,628,7573,8201
"7440","Southbridge","Worcester County County","MA","Southbridge",2009,849,7359,8208
"7441","Southbridge","Worcester County County","MA","Southbridge",2010,964,7059,8023
"7442","Southbridge","Worcester County County","MA","Southbridge",2011,870,7121,7991
"7443","Southbridge","Worcester County County","MA","Southbridge",2012,808,7119,7927
"7444","Southwick","Hampden County County","MA","Southwick",1990,228,4152,4380
"7445","Southwick","Hampden County County","MA","Southwick",1991,374,4082,4456
"7446","Southwick","Hampden County County","MA","Southwick",1992,423,4147,4570
"7447","Southwick","Hampden County County","MA","Southwick",1993,421,4194,4615
"7448","Southwick","Hampden County County","MA","Southwick",1994,384,4262,4646
"7449","Southwick","Hampden County County","MA","Southwick",1995,310,4110,4420
"7450","Southwick","Hampden County County","MA","Southwick",1996,241,4259,4500
"7451","Southwick","Hampden County County","MA","Southwick",1997,201,4441,4642
"7452","Southwick","Hampden County County","MA","Southwick",1998,183,4533,4716
"7453","Southwick","Hampden County County","MA","Southwick",1999,151,4639,4790
"7454","Southwick","Hampden County County","MA","Southwick",2000,147,4704,4851
"7455","Southwick","Hampden County County","MA","Southwick",2001,182,4773,4955
"7456","Southwick","Hampden County County","MA","Southwick",2002,256,4809,5065
"7457","Southwick","Hampden County County","MA","Southwick",2003,268,4843,5111
"7458","Southwick","Hampden County County","MA","Southwick",2004,259,4902,5161
"7459","Southwick","Hampden County County","MA","Southwick",2005,248,4984,5232
"7460","Southwick","Hampden County County","MA","Southwick",2006,244,5046,5290
"7461","Southwick","Hampden County County","MA","Southwick",2007,228,4970,5198
"7462","Southwick","Hampden County County","MA","Southwick",2008,285,4999,5284
"7463","Southwick","Hampden County County","MA","Southwick",2009,448,4830,5278
"7464","Southwick","Hampden County County","MA","Southwick",2010,488,4748,5236
"7465","Southwick","Hampden County County","MA","Southwick",2011,401,4702,5103
"7466","Southwick","Hampden County County","MA","Southwick",2012,353,4705,5058
"7467","Spencer","Worcester County County","MA","Spencer",1990,395,5695,6090
"7468","Spencer","Worcester County County","MA","Spencer",1991,594,5490,6084
"7469","Spencer","Worcester County County","MA","Spencer",1992,586,5569,6155
"7470","Spencer","Worcester County County","MA","Spencer",1993,454,5604,6058
"7471","Spencer","Worcester County County","MA","Spencer",1994,342,5692,6034
"7472","Spencer","Worcester County County","MA","Spencer",1995,338,5810,6148
"7473","Spencer","Worcester County County","MA","Spencer",1996,315,5957,6272
"7474","Spencer","Worcester County County","MA","Spencer",1997,227,6194,6421
"7475","Spencer","Worcester County County","MA","Spencer",1998,214,6328,6542
"7476","Spencer","Worcester County County","MA","Spencer",1999,193,6296,6489
"7477","Spencer","Worcester County County","MA","Spencer",2000,170,6390,6560
"7478","Spencer","Worcester County County","MA","Spencer",2001,226,6398,6624
"7479","Spencer","Worcester County County","MA","Spencer",2002,341,6366,6707
"7480","Spencer","Worcester County County","MA","Spencer",2003,397,6338,6735
"7481","Spencer","Worcester County County","MA","Spencer",2004,380,6332,6712
"7482","Spencer","Worcester County County","MA","Spencer",2005,338,6353,6691
"7483","Spencer","Worcester County County","MA","Spencer",2006,333,6333,6666
"7484","Spencer","Worcester County County","MA","Spencer",2007,329,6325,6654
"7485","Spencer","Worcester County County","MA","Spencer",2008,399,6193,6592
"7486","Spencer","Worcester County County","MA","Spencer",2009,628,6022,6650
"7487","Spencer","Worcester County County","MA","Spencer",2010,671,5878,6549
"7488","Spencer","Worcester County County","MA","Spencer",2011,509,5931,6440
"7489","Spencer","Worcester County County","MA","Spencer",2012,476,5929,6405
"7490","Springfield","Hampden County County","MA","Springfield",1990,5588,64373,69961
"7491","Springfield","Hampden County County","MA","Springfield",1991,8018,61502,69520
"7492","Springfield","Hampden County County","MA","Springfield",1992,7678,60743,68421
"7493","Springfield","Hampden County County","MA","Springfield",1993,7035,59891,66926
"7494","Springfield","Hampden County County","MA","Springfield",1994,6152,59274,65426
"7495","Springfield","Hampden County County","MA","Springfield",1995,5046,60372,65418
"7496","Springfield","Hampden County County","MA","Springfield",1996,4072,60729,64801
"7497","Springfield","Hampden County County","MA","Springfield",1997,3814,61863,65677
"7498","Springfield","Hampden County County","MA","Springfield",1998,3476,61819,65295
"7499","Springfield","Hampden County County","MA","Springfield",1999,3401,61764,65165
"7500","Springfield","Hampden County County","MA","Springfield",2000,2698,62316,65014
"7501","Springfield","Hampden County County","MA","Springfield",2001,3418,62183,65601
"7502","Springfield","Hampden County County","MA","Springfield",2002,4803,61827,66630
"7503","Springfield","Hampden County County","MA","Springfield",2003,5409,61137,66546
"7504","Springfield","Hampden County County","MA","Springfield",2004,5180,61089,66269
"7505","Springfield","Hampden County County","MA","Springfield",2005,4812,61182,65994
"7506","Springfield","Hampden County County","MA","Springfield",2006,4936,61374,66310
"7507","Springfield","Hampden County County","MA","Springfield",2007,4623,61042,65665
"7508","Springfield","Hampden County County","MA","Springfield",2008,5293,60781,66074
"7509","Springfield","Hampden County County","MA","Springfield",2009,7563,59911,67474
"7510","Springfield","Hampden County County","MA","Springfield",2010,8368,59091,67459
"7511","Springfield","Hampden County County","MA","Springfield",2011,7883,58500,66383
"7512","Springfield","Hampden County County","MA","Springfield",2012,7200,58535,65735
"7513","Sterling","Worcester County County","MA","Sterling",1990,189,3264,3453
"7514","Sterling","Worcester County County","MA","Sterling",1991,282,3188,3470
"7515","Sterling","Worcester County County","MA","Sterling",1992,328,3279,3607
"7516","Sterling","Worcester County County","MA","Sterling",1993,266,3420,3686
"7517","Sterling","Worcester County County","MA","Sterling",1994,214,3531,3745
"7518","Sterling","Worcester County County","MA","Sterling",1995,181,3384,3565
"7519","Sterling","Worcester County County","MA","Sterling",1996,127,3477,3604
"7520","Sterling","Worcester County County","MA","Sterling",1997,131,3610,3741
"7521","Sterling","Worcester County County","MA","Sterling",1998,90,3742,3832
"7522","Sterling","Worcester County County","MA","Sterling",1999,127,3803,3930
"7523","Sterling","Worcester County County","MA","Sterling",2000,87,4123,4210
"7524","Sterling","Worcester County County","MA","Sterling",2001,127,4167,4294
"7525","Sterling","Worcester County County","MA","Sterling",2002,213,4186,4399
"7526","Sterling","Worcester County County","MA","Sterling",2003,223,4215,4438
"7527","Sterling","Worcester County County","MA","Sterling",2004,202,4232,4434
"7528","Sterling","Worcester County County","MA","Sterling",2005,194,4234,4428
"7529","Sterling","Worcester County County","MA","Sterling",2006,184,4257,4441
"7530","Sterling","Worcester County County","MA","Sterling",2007,179,4252,4431
"7531","Sterling","Worcester County County","MA","Sterling",2008,192,4162,4354
"7532","Sterling","Worcester County County","MA","Sterling",2009,315,4047,4362
"7533","Sterling","Worcester County County","MA","Sterling",2010,347,4073,4420
"7534","Sterling","Worcester County County","MA","Sterling",2011,279,4109,4388
"7535","Sterling","Worcester County County","MA","Sterling",2012,247,4107,4354
"7536","Stockbridge","Berkshire County County","MA","Stockbridge",1990,42,1052,1094
"7537","Stockbridge","Berkshire County County","MA","Stockbridge",1991,65,984,1049
"7538","Stockbridge","Berkshire County County","MA","Stockbridge",1992,74,979,1053
"7539","Stockbridge","Berkshire County County","MA","Stockbridge",1993,54,971,1025
"7540","Stockbridge","Berkshire County County","MA","Stockbridge",1994,60,951,1011
"7541","Stockbridge","Berkshire County County","MA","Stockbridge",1995,56,974,1030
"7542","Stockbridge","Berkshire County County","MA","Stockbridge",1996,43,987,1030
"7543","Stockbridge","Berkshire County County","MA","Stockbridge",1997,38,991,1029
"7544","Stockbridge","Berkshire County County","MA","Stockbridge",1998,34,988,1022
"7545","Stockbridge","Berkshire County County","MA","Stockbridge",1999,27,989,1016
"7546","Stockbridge","Berkshire County County","MA","Stockbridge",2000,25,1258,1283
"7547","Stockbridge","Berkshire County County","MA","Stockbridge",2001,30,1298,1328
"7548","Stockbridge","Berkshire County County","MA","Stockbridge",2002,46,1334,1380
"7549","Stockbridge","Berkshire County County","MA","Stockbridge",2003,50,1332,1382
"7550","Stockbridge","Berkshire County County","MA","Stockbridge",2004,54,1324,1378
"7551","Stockbridge","Berkshire County County","MA","Stockbridge",2005,46,1354,1400
"7552","Stockbridge","Berkshire County County","MA","Stockbridge",2006,47,1366,1413
"7553","Stockbridge","Berkshire County County","MA","Stockbridge",2007,44,1332,1376
"7554","Stockbridge","Berkshire County County","MA","Stockbridge",2008,52,1326,1378
"7555","Stockbridge","Berkshire County County","MA","Stockbridge",2009,68,1277,1345
"7556","Stockbridge","Berkshire County County","MA","Stockbridge",2010,64,1142,1206
"7557","Stockbridge","Berkshire County County","MA","Stockbridge",2011,61,1149,1210
"7558","Stockbridge","Berkshire County County","MA","Stockbridge",2012,50,1139,1189
"7559","Stoneham","Middlesex County County","MA","Stoneham",1990,679,11488,12167
"7560","Stoneham","Middlesex County County","MA","Stoneham",1991,881,11027,11908
"7561","Stoneham","Middlesex County County","MA","Stoneham",1992,898,10985,11883
"7562","Stoneham","Middlesex County County","MA","Stoneham",1993,681,10997,11678
"7563","Stoneham","Middlesex County County","MA","Stoneham",1994,607,11198,11805
"7564","Stoneham","Middlesex County County","MA","Stoneham",1995,613,11338,11951
"7565","Stoneham","Middlesex County County","MA","Stoneham",1996,479,11551,12030
"7566","Stoneham","Middlesex County County","MA","Stoneham",1997,421,11838,12259
"7567","Stoneham","Middlesex County County","MA","Stoneham",1998,361,12066,12427
"7568","Stoneham","Middlesex County County","MA","Stoneham",1999,358,12164,12522
"7569","Stoneham","Middlesex County County","MA","Stoneham",2000,281,12006,12287
"7570","Stoneham","Middlesex County County","MA","Stoneham",2001,405,11938,12343
"7571","Stoneham","Middlesex County County","MA","Stoneham",2002,596,11663,12259
"7572","Stoneham","Middlesex County County","MA","Stoneham",2003,626,11422,12048
"7573","Stoneham","Middlesex County County","MA","Stoneham",2004,580,11333,11913
"7574","Stoneham","Middlesex County County","MA","Stoneham",2005,531,11348,11879
"7575","Stoneham","Middlesex County County","MA","Stoneham",2006,507,11061,11568
"7576","Stoneham","Middlesex County County","MA","Stoneham",2007,491,11142,11633
"7577","Stoneham","Middlesex County County","MA","Stoneham",2008,562,11117,11679
"7578","Stoneham","Middlesex County County","MA","Stoneham",2009,870,10817,11687
"7579","Stoneham","Middlesex County County","MA","Stoneham",2010,840,10918,11758
"7580","Stoneham","Middlesex County County","MA","Stoneham",2011,761,11078,11839
"7581","Stoneham","Middlesex County County","MA","Stoneham",2012,665,11199,11864
"7582","Stoughton","Norfolk County County","MA","Stoughton",1990,904,14302,15206
"7583","Stoughton","Norfolk County County","MA","Stoughton",1991,1257,13910,15167
"7584","Stoughton","Norfolk County County","MA","Stoughton",1992,1377,13834,15211
"7585","Stoughton","Norfolk County County","MA","Stoughton",1993,1123,13970,15093
"7586","Stoughton","Norfolk County County","MA","Stoughton",1994,945,14155,15100
"7587","Stoughton","Norfolk County County","MA","Stoughton",1995,775,14472,15247
"7588","Stoughton","Norfolk County County","MA","Stoughton",1996,641,14759,15400
"7589","Stoughton","Norfolk County County","MA","Stoughton",1997,602,15128,15730
"7590","Stoughton","Norfolk County County","MA","Stoughton",1998,472,15337,15809
"7591","Stoughton","Norfolk County County","MA","Stoughton",1999,517,15523,16040
"7592","Stoughton","Norfolk County County","MA","Stoughton",2000,426,14966,15392
"7593","Stoughton","Norfolk County County","MA","Stoughton",2001,563,14918,15481
"7594","Stoughton","Norfolk County County","MA","Stoughton",2002,794,14630,15424
"7595","Stoughton","Norfolk County County","MA","Stoughton",2003,907,14360,15267
"7596","Stoughton","Norfolk County County","MA","Stoughton",2004,786,14279,15065
"7597","Stoughton","Norfolk County County","MA","Stoughton",2005,729,14314,15043
"7598","Stoughton","Norfolk County County","MA","Stoughton",2006,692,14230,14922
"7599","Stoughton","Norfolk County County","MA","Stoughton",2007,654,14402,15056
"7600","Stoughton","Norfolk County County","MA","Stoughton",2008,813,14406,15219
"7601","Stoughton","Norfolk County County","MA","Stoughton",2009,1202,13896,15098
"7602","Stoughton","Norfolk County County","MA","Stoughton",2010,1219,14004,15223
"7603","Stoughton","Norfolk County County","MA","Stoughton",2011,1023,14163,15186
"7604","Stoughton","Norfolk County County","MA","Stoughton",2012,964,14318,15282
"7605","Stow","Middlesex County County","MA","Stow",1990,114,3009,3123
"7606","Stow","Middlesex County County","MA","Stow",1991,177,2899,3076
"7607","Stow","Middlesex County County","MA","Stow",1992,197,2918,3115
"7608","Stow","Middlesex County County","MA","Stow",1993,176,2995,3171
"7609","Stow","Middlesex County County","MA","Stow",1994,149,3064,3213
"7610","Stow","Middlesex County County","MA","Stow",1995,136,3168,3304
"7611","Stow","Middlesex County County","MA","Stow",1996,88,3256,3344
"7612","Stow","Middlesex County County","MA","Stow",1997,74,3357,3431
"7613","Stow","Middlesex County County","MA","Stow",1998,78,3427,3505
"7614","Stow","Middlesex County County","MA","Stow",1999,77,3490,3567
"7615","Stow","Middlesex County County","MA","Stow",2000,65,3263,3328
"7616","Stow","Middlesex County County","MA","Stow",2001,108,3301,3409
"7617","Stow","Middlesex County County","MA","Stow",2002,168,3264,3432
"7618","Stow","Middlesex County County","MA","Stow",2003,172,3247,3419
"7619","Stow","Middlesex County County","MA","Stow",2004,136,3243,3379
"7620","Stow","Middlesex County County","MA","Stow",2005,123,3310,3433
"7621","Stow","Middlesex County County","MA","Stow",2006,125,3293,3418
"7622","Stow","Middlesex County County","MA","Stow",2007,115,3369,3484
"7623","Stow","Middlesex County County","MA","Stow",2008,150,3442,3592
"7624","Stow","Middlesex County County","MA","Stow",2009,222,3410,3632
"7625","Stow","Middlesex County County","MA","Stow",2010,198,3419,3617
"7626","Stow","Middlesex County County","MA","Stow",2011,175,3469,3644
"7627","Stow","Middlesex County County","MA","Stow",2012,167,3507,3674
"7628","Sturbridge","Worcester County County","MA","Sturbridge",1990,238,4001,4239
"7629","Sturbridge","Worcester County County","MA","Sturbridge",1991,357,3912,4269
"7630","Sturbridge","Worcester County County","MA","Sturbridge",1992,365,3992,4357
"7631","Sturbridge","Worcester County County","MA","Sturbridge",1993,279,4057,4336
"7632","Sturbridge","Worcester County County","MA","Sturbridge",1994,209,4117,4326
"7633","Sturbridge","Worcester County County","MA","Sturbridge",1995,184,4020,4204
"7634","Sturbridge","Worcester County County","MA","Sturbridge",1996,156,4092,4248
"7635","Sturbridge","Worcester County County","MA","Sturbridge",1997,156,4221,4377
"7636","Sturbridge","Worcester County County","MA","Sturbridge",1998,119,4311,4430
"7637","Sturbridge","Worcester County County","MA","Sturbridge",1999,111,4296,4407
"7638","Sturbridge","Worcester County County","MA","Sturbridge",2000,105,4351,4456
"7639","Sturbridge","Worcester County County","MA","Sturbridge",2001,133,4420,4553
"7640","Sturbridge","Worcester County County","MA","Sturbridge",2002,224,4447,4671
"7641","Sturbridge","Worcester County County","MA","Sturbridge",2003,268,4527,4795
"7642","Sturbridge","Worcester County County","MA","Sturbridge",2004,249,4636,4885
"7643","Sturbridge","Worcester County County","MA","Sturbridge",2005,214,4711,4925
"7644","Sturbridge","Worcester County County","MA","Sturbridge",2006,208,4703,4911
"7645","Sturbridge","Worcester County County","MA","Sturbridge",2007,221,4715,4936
"7646","Sturbridge","Worcester County County","MA","Sturbridge",2008,248,4620,4868
"7647","Sturbridge","Worcester County County","MA","Sturbridge",2009,385,4497,4882
"7648","Sturbridge","Worcester County County","MA","Sturbridge",2010,381,4717,5098
"7649","Sturbridge","Worcester County County","MA","Sturbridge",2011,357,4759,5116
"7650","Sturbridge","Worcester County County","MA","Sturbridge",2012,323,4757,5080
"7651","Sudbury","Middlesex County County","MA","Sudbury",1990,280,7916,8196
"7652","Sudbury","Middlesex County County","MA","Sudbury",1991,344,7729,8073
"7653","Sudbury","Middlesex County County","MA","Sudbury",1992,412,7808,8220
"7654","Sudbury","Middlesex County County","MA","Sudbury",1993,344,7997,8341
"7655","Sudbury","Middlesex County County","MA","Sudbury",1994,317,8250,8567
"7656","Sudbury","Middlesex County County","MA","Sudbury",1995,289,8123,8412
"7657","Sudbury","Middlesex County County","MA","Sudbury",1996,199,8379,8578
"7658","Sudbury","Middlesex County County","MA","Sudbury",1997,167,8680,8847
"7659","Sudbury","Middlesex County County","MA","Sudbury",1998,142,8917,9059
"7660","Sudbury","Middlesex County County","MA","Sudbury",1999,144,9146,9290
"7661","Sudbury","Middlesex County County","MA","Sudbury",2000,153,8305,8458
"7662","Sudbury","Middlesex County County","MA","Sudbury",2001,255,8366,8621
"7663","Sudbury","Middlesex County County","MA","Sudbury",2002,405,8260,8665
"7664","Sudbury","Middlesex County County","MA","Sudbury",2003,408,8136,8544
"7665","Sudbury","Middlesex County County","MA","Sudbury",2004,323,8122,8445
"7666","Sudbury","Middlesex County County","MA","Sudbury",2005,287,8162,8449
"7667","Sudbury","Middlesex County County","MA","Sudbury",2006,308,8054,8362
"7668","Sudbury","Middlesex County County","MA","Sudbury",2007,265,8160,8425
"7669","Sudbury","Middlesex County County","MA","Sudbury",2008,323,8208,8531
"7670","Sudbury","Middlesex County County","MA","Sudbury",2009,515,8061,8576
"7671","Sudbury","Middlesex County County","MA","Sudbury",2010,507,8180,8687
"7672","Sudbury","Middlesex County County","MA","Sudbury",2011,436,8301,8737
"7673","Sudbury","Middlesex County County","MA","Sudbury",2012,395,8392,8787
"7674",NA,"Suffolk County County","MA","Suffolk County County",1990,21425,328598,350023
"7675",NA,"Suffolk County County","MA","Suffolk County County",1991,29524,312148,341672
"7676",NA,"Suffolk County County","MA","Suffolk County County",1992,28585,304876,333461
"7677",NA,"Suffolk County County","MA","Suffolk County County",1993,23615,306629,330244
"7678",NA,"Suffolk County County","MA","Suffolk County County",1994,20383,308484,328867
"7679",NA,"Suffolk County County","MA","Suffolk County County",1995,18920,318455,337375
"7680",NA,"Suffolk County County","MA","Suffolk County County",1996,16232,322348,338580
"7681",NA,"Suffolk County County","MA","Suffolk County County",1997,14912,328401,343313
"7682",NA,"Suffolk County County","MA","Suffolk County County",1998,12289,332037,344326
"7683",NA,"Suffolk County County","MA","Suffolk County County",1999,12148,334447,346595
"7684",NA,"Suffolk County County","MA","Suffolk County County",2000,10739,340347,351086
"7685",NA,"Suffolk County County","MA","Suffolk County County",2001,14645,339407,354052
"7686",NA,"Suffolk County County","MA","Suffolk County County",2002,20873,330953,351826
"7687",NA,"Suffolk County County","MA","Suffolk County County",2003,22566,321685,344251
"7688",NA,"Suffolk County County","MA","Suffolk County County",2004,19356,316149,335505
"7689",NA,"Suffolk County County","MA","Suffolk County County",2005,17660,314335,331995
"7690",NA,"Suffolk County County","MA","Suffolk County County",2006,17826,340610,358436
"7691",NA,"Suffolk County County","MA","Suffolk County County",2007,16381,348430,364811
"7692",NA,"Suffolk County County","MA","Suffolk County County",2008,19589,353405,372994
"7693",NA,"Suffolk County County","MA","Suffolk County County",2009,29134,345421,374555
"7694",NA,"Suffolk County County","MA","Suffolk County County",2010,29709,335890,365599
"7695",NA,"Suffolk County County","MA","Suffolk County County",2011,26164,341489,367653
"7696",NA,"Suffolk County County","MA","Suffolk County County",2012,24392,345228,369620
"7697","Sunderland","Franklin County County","MA","Sunderland",1990,83,1989,2072
"7698","Sunderland","Franklin County County","MA","Sunderland",1991,120,1884,2004
"7699","Sunderland","Franklin County County","MA","Sunderland",1992,123,1897,2020
"7700","Sunderland","Franklin County County","MA","Sunderland",1993,106,1981,2087
"7701","Sunderland","Franklin County County","MA","Sunderland",1994,98,2014,2112
"7702","Sunderland","Franklin County County","MA","Sunderland",1995,72,2000,2072
"7703","Sunderland","Franklin County County","MA","Sunderland",1996,53,2037,2090
"7704","Sunderland","Franklin County County","MA","Sunderland",1997,45,2080,2125
"7705","Sunderland","Franklin County County","MA","Sunderland",1998,45,2080,2125
"7706","Sunderland","Franklin County County","MA","Sunderland",1999,48,2109,2157
"7707","Sunderland","Franklin County County","MA","Sunderland",2000,41,2197,2238
"7708","Sunderland","Franklin County County","MA","Sunderland",2001,48,2252,2300
"7709","Sunderland","Franklin County County","MA","Sunderland",2002,68,2245,2313
"7710","Sunderland","Franklin County County","MA","Sunderland",2003,81,2265,2346
"7711","Sunderland","Franklin County County","MA","Sunderland",2004,74,2285,2359
"7712","Sunderland","Franklin County County","MA","Sunderland",2005,77,2288,2365
"7713","Sunderland","Franklin County County","MA","Sunderland",2006,80,2297,2377
"7714","Sunderland","Franklin County County","MA","Sunderland",2007,78,2275,2353
"7715","Sunderland","Franklin County County","MA","Sunderland",2008,80,2189,2269
"7716","Sunderland","Franklin County County","MA","Sunderland",2009,119,2243,2362
"7717","Sunderland","Franklin County County","MA","Sunderland",2010,126,2055,2181
"7718","Sunderland","Franklin County County","MA","Sunderland",2011,102,2077,2179
"7719","Sunderland","Franklin County County","MA","Sunderland",2012,92,2096,2188
"7720","Sutton","Worcester County County","MA","Sutton",1990,172,3533,3705
"7721","Sutton","Worcester County County","MA","Sutton",1991,291,3495,3786
"7722","Sutton","Worcester County County","MA","Sutton",1992,297,3558,3855
"7723","Sutton","Worcester County County","MA","Sutton",1993,218,3714,3932
"7724","Sutton","Worcester County County","MA","Sutton",1994,187,3872,4059
"7725","Sutton","Worcester County County","MA","Sutton",1995,170,3707,3877
"7726","Sutton","Worcester County County","MA","Sutton",1996,159,3798,3957
"7727","Sutton","Worcester County County","MA","Sutton",1997,154,3932,4086
"7728","Sutton","Worcester County County","MA","Sutton",1998,112,4004,4116
"7729","Sutton","Worcester County County","MA","Sutton",1999,122,4057,4179
"7730","Sutton","Worcester County County","MA","Sutton",2000,102,4478,4580
"7731","Sutton","Worcester County County","MA","Sutton",2001,155,4565,4720
"7732","Sutton","Worcester County County","MA","Sutton",2002,214,4592,4806
"7733","Sutton","Worcester County County","MA","Sutton",2003,248,4633,4881
"7734","Sutton","Worcester County County","MA","Sutton",2004,233,4625,4858
"7735","Sutton","Worcester County County","MA","Sutton",2005,213,4669,4882
"7736","Sutton","Worcester County County","MA","Sutton",2006,199,4728,4927
"7737","Sutton","Worcester County County","MA","Sutton",2007,196,4752,4948
"7738","Sutton","Worcester County County","MA","Sutton",2008,242,4668,4910
"7739","Sutton","Worcester County County","MA","Sutton",2009,374,4548,4922
"7740","Sutton","Worcester County County","MA","Sutton",2010,387,4456,4843
"7741","Sutton","Worcester County County","MA","Sutton",2011,337,4496,4833
"7742","Sutton","Worcester County County","MA","Sutton",2012,308,4495,4803
"7743","Swampscott","Essex County County","MA","Swampscott",1990,324,6947,7271
"7744","Swampscott","Essex County County","MA","Swampscott",1991,506,6736,7242
"7745","Swampscott","Essex County County","MA","Swampscott",1992,527,6687,7214
"7746","Swampscott","Essex County County","MA","Swampscott",1993,375,6717,7092
"7747","Swampscott","Essex County County","MA","Swampscott",1994,357,6851,7208
"7748","Swampscott","Essex County County","MA","Swampscott",1995,298,6863,7161
"7749","Swampscott","Essex County County","MA","Swampscott",1996,247,6997,7244
"7750","Swampscott","Essex County County","MA","Swampscott",1997,230,7176,7406
"7751","Swampscott","Essex County County","MA","Swampscott",1998,185,7258,7443
"7752","Swampscott","Essex County County","MA","Swampscott",1999,191,7347,7538
"7753","Swampscott","Essex County County","MA","Swampscott",2000,173,7739,7912
"7754","Swampscott","Essex County County","MA","Swampscott",2001,236,7746,7982
"7755","Swampscott","Essex County County","MA","Swampscott",2002,345,7638,7983
"7756","Swampscott","Essex County County","MA","Swampscott",2003,384,7552,7936
"7757","Swampscott","Essex County County","MA","Swampscott",2004,336,7476,7812
"7758","Swampscott","Essex County County","MA","Swampscott",2005,306,7415,7721
"7759","Swampscott","Essex County County","MA","Swampscott",2006,293,7423,7716
"7760","Swampscott","Essex County County","MA","Swampscott",2007,260,7377,7637
"7761","Swampscott","Essex County County","MA","Swampscott",2008,334,7360,7694
"7762","Swampscott","Essex County County","MA","Swampscott",2009,537,7205,7742
"7763","Swampscott","Essex County County","MA","Swampscott",2010,537,7074,7611
"7764","Swampscott","Essex County County","MA","Swampscott",2011,417,7157,7574
"7765","Swampscott","Essex County County","MA","Swampscott",2012,402,7212,7614
"7766","Swansea","Bristol County County","MA","Swansea",1990,635,8192,8827
"7767","Swansea","Bristol County County","MA","Swansea",1991,1042,7863,8905
"7768","Swansea","Bristol County County","MA","Swansea",1992,1051,7887,8938
"7769","Swansea","Bristol County County","MA","Swansea",1993,1034,8050,9084
"7770","Swansea","Bristol County County","MA","Swansea",1994,748,8228,8976
"7771","Swansea","Bristol County County","MA","Swansea",1995,675,8271,8946
"7772","Swansea","Bristol County County","MA","Swansea",1996,613,8320,8933
"7773","Swansea","Bristol County County","MA","Swansea",1997,542,8486,9028
"7774","Swansea","Bristol County County","MA","Swansea",1998,353,8554,8907
"7775","Swansea","Bristol County County","MA","Swansea",1999,333,8567,8900
"7776","Swansea","Bristol County County","MA","Swansea",2000,340,8703,9043
"7777","Swansea","Bristol County County","MA","Swansea",2001,399,8663,9062
"7778","Swansea","Bristol County County","MA","Swansea",2002,506,8731,9237
"7779","Swansea","Bristol County County","MA","Swansea",2003,532,8813,9345
"7780","Swansea","Bristol County County","MA","Swansea",2004,525,8838,9363
"7781","Swansea","Bristol County County","MA","Swansea",2005,493,8864,9357
"7782","Swansea","Bristol County County","MA","Swansea",2006,544,8942,9486
"7783","Swansea","Bristol County County","MA","Swansea",2007,534,8973,9507
"7784","Swansea","Bristol County County","MA","Swansea",2008,643,8794,9437
"7785","Swansea","Bristol County County","MA","Swansea",2009,1022,8393,9415
"7786","Swansea","Bristol County County","MA","Swansea",2010,1021,8208,9229
"7787","Swansea","Bristol County County","MA","Swansea",2011,944,8268,9212
"7788","Swansea","Bristol County County","MA","Swansea",2012,879,8281,9160
"7789","Taunton","Bristol County County","MA","Taunton",1990,2236,24546,26782
"7790","Taunton","Bristol County County","MA","Taunton",1991,2826,23826,26652
"7791","Taunton","Bristol County County","MA","Taunton",1992,2859,23872,26731
"7792","Taunton","Bristol County County","MA","Taunton",1993,2342,24262,26604
"7793","Taunton","Bristol County County","MA","Taunton",1994,2006,24805,26811
"7794","Taunton","Bristol County County","MA","Taunton",1995,1813,25127,26940
"7795","Taunton","Bristol County County","MA","Taunton",1996,1571,25611,27182
"7796","Taunton","Bristol County County","MA","Taunton",1997,1378,26347,27725
"7797","Taunton","Bristol County County","MA","Taunton",1998,1073,26921,27994
"7798","Taunton","Bristol County County","MA","Taunton",1999,997,27314,28311
"7799","Taunton","Bristol County County","MA","Taunton",2000,888,29297,30185
"7800","Taunton","Bristol County County","MA","Taunton",2001,1186,29295,30481
"7801","Taunton","Bristol County County","MA","Taunton",2002,1640,29178,30818
"7802","Taunton","Bristol County County","MA","Taunton",2003,1828,29012,30840
"7803","Taunton","Bristol County County","MA","Taunton",2004,1683,28756,30439
"7804","Taunton","Bristol County County","MA","Taunton",2005,1577,29068,30645
"7805","Taunton","Bristol County County","MA","Taunton",2006,1664,29336,31000
"7806","Taunton","Bristol County County","MA","Taunton",2007,1577,29436,31013
"7807","Taunton","Bristol County County","MA","Taunton",2008,1951,29355,31306
"7808","Taunton","Bristol County County","MA","Taunton",2009,2960,28291,31251
"7809","Taunton","Bristol County County","MA","Taunton",2010,2951,28207,31158
"7810","Taunton","Bristol County County","MA","Taunton",2011,2653,28500,31153
"7811","Taunton","Bristol County County","MA","Taunton",2012,2378,28415,30793
"7812","Templeton","Worcester County County","MA","Templeton",1990,281,3042,3323
"7813","Templeton","Worcester County County","MA","Templeton",1991,389,3002,3391
"7814","Templeton","Worcester County County","MA","Templeton",1992,370,3103,3473
"7815","Templeton","Worcester County County","MA","Templeton",1993,257,3116,3373
"7816","Templeton","Worcester County County","MA","Templeton",1994,239,3104,3343
"7817","Templeton","Worcester County County","MA","Templeton",1995,234,3274,3508
"7818","Templeton","Worcester County County","MA","Templeton",1996,217,3281,3498
"7819","Templeton","Worcester County County","MA","Templeton",1997,191,3368,3559
"7820","Templeton","Worcester County County","MA","Templeton",1998,155,3387,3542
"7821","Templeton","Worcester County County","MA","Templeton",1999,158,3397,3555
"7822","Templeton","Worcester County County","MA","Templeton",2000,125,3363,3488
"7823","Templeton","Worcester County County","MA","Templeton",2001,155,3367,3522
"7824","Templeton","Worcester County County","MA","Templeton",2002,231,3397,3628
"7825","Templeton","Worcester County County","MA","Templeton",2003,269,3404,3673
"7826","Templeton","Worcester County County","MA","Templeton",2004,246,3417,3663
"7827","Templeton","Worcester County County","MA","Templeton",2005,259,3457,3716
"7828","Templeton","Worcester County County","MA","Templeton",2006,253,3583,3836
"7829","Templeton","Worcester County County","MA","Templeton",2007,222,3639,3861
"7830","Templeton","Worcester County County","MA","Templeton",2008,266,3612,3878
"7831","Templeton","Worcester County County","MA","Templeton",2009,407,3463,3870
"7832","Templeton","Worcester County County","MA","Templeton",2010,412,3564,3976
"7833","Templeton","Worcester County County","MA","Templeton",2011,364,3561,3925
"7834","Templeton","Worcester County County","MA","Templeton",2012,353,3558,3911
"7835","Tewksbury","Middlesex County County","MA","Tewksbury",1990,1007,15615,16622
"7836","Tewksbury","Middlesex County County","MA","Tewksbury",1991,1420,15208,16628
"7837","Tewksbury","Middlesex County County","MA","Tewksbury",1992,1471,15415,16886
"7838","Tewksbury","Middlesex County County","MA","Tewksbury",1993,1244,15493,16737
"7839","Tewksbury","Middlesex County County","MA","Tewksbury",1994,985,15635,16620
"7840","Tewksbury","Middlesex County County","MA","Tewksbury",1995,838,15435,16273
"7841","Tewksbury","Middlesex County County","MA","Tewksbury",1996,679,16031,16710
"7842","Tewksbury","Middlesex County County","MA","Tewksbury",1997,611,16725,17336
"7843","Tewksbury","Middlesex County County","MA","Tewksbury",1998,505,17033,17538
"7844","Tewksbury","Middlesex County County","MA","Tewksbury",1999,552,17576,18128
"7845","Tewksbury","Middlesex County County","MA","Tewksbury",2000,398,16224,16622
"7846","Tewksbury","Middlesex County County","MA","Tewksbury",2001,576,16349,16925
"7847","Tewksbury","Middlesex County County","MA","Tewksbury",2002,897,16096,16993
"7848","Tewksbury","Middlesex County County","MA","Tewksbury",2003,1002,15818,16820
"7849","Tewksbury","Middlesex County County","MA","Tewksbury",2004,823,15683,16506
"7850","Tewksbury","Middlesex County County","MA","Tewksbury",2005,775,15748,16523
"7851","Tewksbury","Middlesex County County","MA","Tewksbury",2006,740,15936,16676
"7852","Tewksbury","Middlesex County County","MA","Tewksbury",2007,700,16031,16731
"7853","Tewksbury","Middlesex County County","MA","Tewksbury",2008,815,15953,16768
"7854","Tewksbury","Middlesex County County","MA","Tewksbury",2009,1323,16042,17365
"7855","Tewksbury","Middlesex County County","MA","Tewksbury",2010,1292,15298,16590
"7856","Tewksbury","Middlesex County County","MA","Tewksbury",2011,1119,15459,16578
"7857","Tewksbury","Middlesex County County","MA","Tewksbury",2012,1026,15629,16655
"7858","Tisbury","Dukes County County","MA","Tisbury",1990,125,1838,1963
"7859","Tisbury","Dukes County County","MA","Tisbury",1991,174,1872,2046
"7860","Tisbury","Dukes County County","MA","Tisbury",1992,207,1736,1943
"7861","Tisbury","Dukes County County","MA","Tisbury",1993,196,1774,1970
"7862","Tisbury","Dukes County County","MA","Tisbury",1994,198,1905,2103
"7863","Tisbury","Dukes County County","MA","Tisbury",1995,151,1997,2148
"7864","Tisbury","Dukes County County","MA","Tisbury",1996,153,2074,2227
"7865","Tisbury","Dukes County County","MA","Tisbury",1997,143,2116,2259
"7866","Tisbury","Dukes County County","MA","Tisbury",1998,130,2154,2284
"7867","Tisbury","Dukes County County","MA","Tisbury",1999,121,2190,2311
"7868","Tisbury","Dukes County County","MA","Tisbury",2000,91,2420,2511
"7869","Tisbury","Dukes County County","MA","Tisbury",2001,96,2424,2520
"7870","Tisbury","Dukes County County","MA","Tisbury",2002,137,2507,2644
"7871","Tisbury","Dukes County County","MA","Tisbury",2003,137,2589,2726
"7872","Tisbury","Dukes County County","MA","Tisbury",2004,138,2594,2732
"7873","Tisbury","Dukes County County","MA","Tisbury",2005,132,2545,2677
"7874","Tisbury","Dukes County County","MA","Tisbury",2006,122,2573,2695
"7875","Tisbury","Dukes County County","MA","Tisbury",2007,116,2609,2725
"7876","Tisbury","Dukes County County","MA","Tisbury",2008,135,2606,2741
"7877","Tisbury","Dukes County County","MA","Tisbury",2009,205,2575,2780
"7878","Tisbury","Dukes County County","MA","Tisbury",2010,261,2518,2779
"7879","Tisbury","Dukes County County","MA","Tisbury",2011,231,2538,2769
"7880","Tisbury","Dukes County County","MA","Tisbury",2012,244,2563,2807
"7881","Tolland","Hampden County County","MA","Tolland",1990,6,125,131
"7882","Tolland","Hampden County County","MA","Tolland",1991,8,120,128
"7883","Tolland","Hampden County County","MA","Tolland",1992,13,135,148
"7884","Tolland","Hampden County County","MA","Tolland",1993,14,140,154
"7885","Tolland","Hampden County County","MA","Tolland",1994,14,143,157
"7886","Tolland","Hampden County County","MA","Tolland",1995,18,151,169
"7887","Tolland","Hampden County County","MA","Tolland",1996,12,145,157
"7888","Tolland","Hampden County County","MA","Tolland",1997,8,147,155
"7889","Tolland","Hampden County County","MA","Tolland",1998,5,154,159
"7890","Tolland","Hampden County County","MA","Tolland",1999,4,167,171
"7891","Tolland","Hampden County County","MA","Tolland",2000,5,234,239
"7892","Tolland","Hampden County County","MA","Tolland",2001,4,236,240
"7893","Tolland","Hampden County County","MA","Tolland",2002,6,235,241
"7894","Tolland","Hampden County County","MA","Tolland",2003,6,235,241
"7895","Tolland","Hampden County County","MA","Tolland",2004,8,239,247
"7896","Tolland","Hampden County County","MA","Tolland",2005,9,242,251
"7897","Tolland","Hampden County County","MA","Tolland",2006,6,244,250
"7898","Tolland","Hampden County County","MA","Tolland",2007,8,246,254
"7899","Tolland","Hampden County County","MA","Tolland",2008,8,248,256
"7900","Tolland","Hampden County County","MA","Tolland",2009,15,240,255
"7901","Tolland","Hampden County County","MA","Tolland",2010,13,252,265
"7902","Tolland","Hampden County County","MA","Tolland",2011,13,249,262
"7903","Tolland","Hampden County County","MA","Tolland",2012,10,249,259
"7904","Topsfield","Essex County County","MA","Topsfield",1990,111,2836,2947
"7905","Topsfield","Essex County County","MA","Topsfield",1991,163,2729,2892
"7906","Topsfield","Essex County County","MA","Topsfield",1992,181,2737,2918
"7907","Topsfield","Essex County County","MA","Topsfield",1993,156,2803,2959
"7908","Topsfield","Essex County County","MA","Topsfield",1994,113,2858,2971
"7909","Topsfield","Essex County County","MA","Topsfield",1995,97,2894,2991
"7910","Topsfield","Essex County County","MA","Topsfield",1996,63,3020,3083
"7911","Topsfield","Essex County County","MA","Topsfield",1997,73,3132,3205
"7912","Topsfield","Essex County County","MA","Topsfield",1998,64,3115,3179
"7913","Topsfield","Essex County County","MA","Topsfield",1999,60,3167,3227
"7914","Topsfield","Essex County County","MA","Topsfield",2000,60,2997,3057
"7915","Topsfield","Essex County County","MA","Topsfield",2001,81,3020,3101
"7916","Topsfield","Essex County County","MA","Topsfield",2002,124,2972,3096
"7917","Topsfield","Essex County County","MA","Topsfield",2003,126,2932,3058
"7918","Topsfield","Essex County County","MA","Topsfield",2004,116,2917,3033
"7919","Topsfield","Essex County County","MA","Topsfield",2005,102,2929,3031
"7920","Topsfield","Essex County County","MA","Topsfield",2006,107,2844,2951
"7921","Topsfield","Essex County County","MA","Topsfield",2007,99,2861,2960
"7922","Topsfield","Essex County County","MA","Topsfield",2008,119,2867,2986
"7923","Topsfield","Essex County County","MA","Topsfield",2009,193,2777,2970
"7924","Topsfield","Essex County County","MA","Topsfield",2010,194,2792,2986
"7925","Topsfield","Essex County County","MA","Topsfield",2011,166,2826,2992
"7926","Topsfield","Essex County County","MA","Topsfield",2012,142,2857,2999
"7927","Townsend","Middlesex County County","MA","Townsend",1990,236,4353,4589
"7928","Townsend","Middlesex County County","MA","Townsend",1991,336,4220,4556
"7929","Townsend","Middlesex County County","MA","Townsend",1992,333,4304,4637
"7930","Townsend","Middlesex County County","MA","Townsend",1993,289,4386,4675
"7931","Townsend","Middlesex County County","MA","Townsend",1994,241,4543,4784
"7932","Townsend","Middlesex County County","MA","Townsend",1995,229,4521,4750
"7933","Townsend","Middlesex County County","MA","Townsend",1996,190,4640,4830
"7934","Townsend","Middlesex County County","MA","Townsend",1997,176,4785,4961
"7935","Townsend","Middlesex County County","MA","Townsend",1998,135,4894,5029
"7936","Townsend","Middlesex County County","MA","Townsend",1999,159,4966,5125
"7937","Townsend","Middlesex County County","MA","Townsend",2000,120,5007,5127
"7938","Townsend","Middlesex County County","MA","Townsend",2001,176,4971,5147
"7939","Townsend","Middlesex County County","MA","Townsend",2002,267,4861,5128
"7940","Townsend","Middlesex County County","MA","Townsend",2003,287,4960,5247
"7941","Townsend","Middlesex County County","MA","Townsend",2004,261,4990,5251
"7942","Townsend","Middlesex County County","MA","Townsend",2005,226,5032,5258
"7943","Townsend","Middlesex County County","MA","Townsend",2006,211,5055,5266
"7944","Townsend","Middlesex County County","MA","Townsend",2007,205,5086,5291
"7945","Townsend","Middlesex County County","MA","Townsend",2008,247,5080,5327
"7946","Townsend","Middlesex County County","MA","Townsend",2009,388,5003,5391
"7947","Townsend","Middlesex County County","MA","Townsend",2010,410,4687,5097
"7948","Townsend","Middlesex County County","MA","Townsend",2011,318,4702,5020
"7949","Townsend","Middlesex County County","MA","Townsend",2012,303,4743,5046
"7950","Truro","Barnstable County County","MA","Truro",1990,127,1049,1176
"7951","Truro","Barnstable County County","MA","Truro",1991,196,1051,1247
"7952","Truro","Barnstable County County","MA","Truro",1992,200,1037,1237
"7953","Truro","Barnstable County County","MA","Truro",1993,212,1106,1318
"7954","Truro","Barnstable County County","MA","Truro",1994,222,1121,1343
"7955","Truro","Barnstable County County","MA","Truro",1995,188,1170,1358
"7956","Truro","Barnstable County County","MA","Truro",1996,188,1176,1364
"7957","Truro","Barnstable County County","MA","Truro",1997,191,1183,1374
"7958","Truro","Barnstable County County","MA","Truro",1998,150,1207,1357
"7959","Truro","Barnstable County County","MA","Truro",1999,153,1250,1403
"7960","Truro","Barnstable County County","MA","Truro",2000,85,1047,1132
"7961","Truro","Barnstable County County","MA","Truro",2001,85,1061,1146
"7962","Truro","Barnstable County County","MA","Truro",2002,101,1086,1187
"7963","Truro","Barnstable County County","MA","Truro",2003,107,1113,1220
"7964","Truro","Barnstable County County","MA","Truro",2004,114,1129,1243
"7965","Truro","Barnstable County County","MA","Truro",2005,98,1127,1225
"7966","Truro","Barnstable County County","MA","Truro",2006,100,1132,1232
"7967","Truro","Barnstable County County","MA","Truro",2007,91,1129,1220
"7968","Truro","Barnstable County County","MA","Truro",2008,126,1123,1249
"7969","Truro","Barnstable County County","MA","Truro",2009,164,1091,1255
"7970","Truro","Barnstable County County","MA","Truro",2010,177,1043,1220
"7971","Truro","Barnstable County County","MA","Truro",2011,169,1042,1211
"7972","Truro","Barnstable County County","MA","Truro",2012,160,1059,1219
"7973","Tyngsborough","Middlesex County County","MA","Tyngsborough",1990,343,4810,5153
"7974","Tyngsborough","Middlesex County County","MA","Tyngsborough",1991,485,4732,5217
"7975","Tyngsborough","Middlesex County County","MA","Tyngsborough",1992,519,4800,5319
"7976","Tyngsborough","Middlesex County County","MA","Tyngsborough",1993,438,4887,5325
"7977","Tyngsborough","Middlesex County County","MA","Tyngsborough",1994,386,5072,5458
"7978","Tyngsborough","Middlesex County County","MA","Tyngsborough",1995,323,5057,5380
"7979","Tyngsborough","Middlesex County County","MA","Tyngsborough",1996,234,5344,5578
"7980","Tyngsborough","Middlesex County County","MA","Tyngsborough",1997,209,5649,5858
"7981","Tyngsborough","Middlesex County County","MA","Tyngsborough",1998,203,5909,6112
"7982","Tyngsborough","Middlesex County County","MA","Tyngsborough",1999,212,6206,6418
"7983","Tyngsborough","Middlesex County County","MA","Tyngsborough",2000,153,6172,6325
"7984","Tyngsborough","Middlesex County County","MA","Tyngsborough",2001,236,6252,6488
"7985","Tyngsborough","Middlesex County County","MA","Tyngsborough",2002,340,6154,6494
"7986","Tyngsborough","Middlesex County County","MA","Tyngsborough",2003,385,6057,6442
"7987","Tyngsborough","Middlesex County County","MA","Tyngsborough",2004,302,6065,6367
"7988","Tyngsborough","Middlesex County County","MA","Tyngsborough",2005,282,6083,6365
"7989","Tyngsborough","Middlesex County County","MA","Tyngsborough",2006,272,6186,6458
"7990","Tyngsborough","Middlesex County County","MA","Tyngsborough",2007,278,6354,6632
"7991","Tyngsborough","Middlesex County County","MA","Tyngsborough",2008,317,6421,6738
"7992","Tyngsborough","Middlesex County County","MA","Tyngsborough",2009,510,6220,6730
"7993","Tyngsborough","Middlesex County County","MA","Tyngsborough",2010,532,5901,6433
"7994","Tyngsborough","Middlesex County County","MA","Tyngsborough",2011,463,5965,6428
"7995","Tyngsborough","Middlesex County County","MA","Tyngsborough",2012,427,6031,6458
"7996","Tyringham","Berkshire County County","MA","Tyringham",1990,6,206,212
"7997","Tyringham","Berkshire County County","MA","Tyringham",1991,8,204,212
"7998","Tyringham","Berkshire County County","MA","Tyringham",1992,8,196,204
"7999","Tyringham","Berkshire County County","MA","Tyringham",1993,9,216,225
"8000","Tyringham","Berkshire County County","MA","Tyringham",1994,6,205,211
"8001","Tyringham","Berkshire County County","MA","Tyringham",1995,4,222,226
"8002","Tyringham","Berkshire County County","MA","Tyringham",1996,7,228,235
"8003","Tyringham","Berkshire County County","MA","Tyringham",1997,4,232,236
"8004","Tyringham","Berkshire County County","MA","Tyringham",1998,3,229,232
"8005","Tyringham","Berkshire County County","MA","Tyringham",1999,2,226,228
"8006","Tyringham","Berkshire County County","MA","Tyringham",2000,2,237,239
"8007","Tyringham","Berkshire County County","MA","Tyringham",2001,4,249,253
"8008","Tyringham","Berkshire County County","MA","Tyringham",2002,4,261,265
"8009","Tyringham","Berkshire County County","MA","Tyringham",2003,6,259,265
"8010","Tyringham","Berkshire County County","MA","Tyringham",2004,6,255,261
"8011","Tyringham","Berkshire County County","MA","Tyringham",2005,8,258,266
"8012","Tyringham","Berkshire County County","MA","Tyringham",2006,6,257,263
"8013","Tyringham","Berkshire County County","MA","Tyringham",2007,6,251,257
"8014","Tyringham","Berkshire County County","MA","Tyringham",2008,9,248,257
"8015","Tyringham","Berkshire County County","MA","Tyringham",2009,13,242,255
"8016","Tyringham","Berkshire County County","MA","Tyringham",2010,13,234,247
"8017","Tyringham","Berkshire County County","MA","Tyringham",2011,7,235,242
"8018","Tyringham","Berkshire County County","MA","Tyringham",2012,6,233,239
"8019","Upton","Worcester County County","MA","Upton",1990,166,2502,2668
"8020","Upton","Worcester County County","MA","Upton",1991,203,2480,2683
"8021","Upton","Worcester County County","MA","Upton",1992,237,2537,2774
"8022","Upton","Worcester County County","MA","Upton",1993,170,2667,2837
"8023","Upton","Worcester County County","MA","Upton",1994,160,2777,2937
"8024","Upton","Worcester County County","MA","Upton",1995,134,2749,2883
"8025","Upton","Worcester County County","MA","Upton",1996,124,2851,2975
"8026","Upton","Worcester County County","MA","Upton",1997,107,2975,3082
"8027","Upton","Worcester County County","MA","Upton",1998,81,3062,3143
"8028","Upton","Worcester County County","MA","Upton",1999,75,3122,3197
"8029","Upton","Worcester County County","MA","Upton",2000,66,2939,3005
"8030","Upton","Worcester County County","MA","Upton",2001,106,3012,3118
"8031","Upton","Worcester County County","MA","Upton",2002,202,3031,3233
"8032","Upton","Worcester County County","MA","Upton",2003,213,3029,3242
"8033","Upton","Worcester County County","MA","Upton",2004,170,3080,3250
"8034","Upton","Worcester County County","MA","Upton",2005,154,3195,3349
"8035","Upton","Worcester County County","MA","Upton",2006,151,3258,3409
"8036","Upton","Worcester County County","MA","Upton",2007,149,3319,3468
"8037","Upton","Worcester County County","MA","Upton",2008,181,3380,3561
"8038","Upton","Worcester County County","MA","Upton",2009,279,3287,3566
"8039","Upton","Worcester County County","MA","Upton",2010,286,3654,3940
"8040","Upton","Worcester County County","MA","Upton",2011,233,3665,3898
"8041","Upton","Worcester County County","MA","Upton",2012,224,3699,3923
"8042","Uxbridge","Worcester County County","MA","Uxbridge",1990,401,5213,5614
"8043","Uxbridge","Worcester County County","MA","Uxbridge",1991,550,5079,5629
"8044","Uxbridge","Worcester County County","MA","Uxbridge",1992,455,5209,5664
"8045","Uxbridge","Worcester County County","MA","Uxbridge",1993,416,5515,5931
"8046","Uxbridge","Worcester County County","MA","Uxbridge",1994,284,5695,5979
"8047","Uxbridge","Worcester County County","MA","Uxbridge",1995,276,5394,5670
"8048","Uxbridge","Worcester County County","MA","Uxbridge",1996,257,5521,5778
"8049","Uxbridge","Worcester County County","MA","Uxbridge",1997,220,5702,5922
"8050","Uxbridge","Worcester County County","MA","Uxbridge",1998,179,5860,6039
"8051","Uxbridge","Worcester County County","MA","Uxbridge",1999,165,5951,6116
"8052","Uxbridge","Worcester County County","MA","Uxbridge",2000,150,6083,6233
"8053","Uxbridge","Worcester County County","MA","Uxbridge",2001,244,6203,6447
"8054","Uxbridge","Worcester County County","MA","Uxbridge",2002,336,6234,6570
"8055","Uxbridge","Worcester County County","MA","Uxbridge",2003,374,6322,6696
"8056","Uxbridge","Worcester County County","MA","Uxbridge",2004,351,6405,6756
"8057","Uxbridge","Worcester County County","MA","Uxbridge",2005,314,6473,6787
"8058","Uxbridge","Worcester County County","MA","Uxbridge",2006,327,6618,6945
"8059","Uxbridge","Worcester County County","MA","Uxbridge",2007,329,6677,7006
"8060","Uxbridge","Worcester County County","MA","Uxbridge",2008,418,6574,6992
"8061","Uxbridge","Worcester County County","MA","Uxbridge",2009,630,6411,7041
"8062","Uxbridge","Worcester County County","MA","Uxbridge",2010,599,6719,7318
"8063","Uxbridge","Worcester County County","MA","Uxbridge",2011,538,6779,7317
"8064","Uxbridge","Worcester County County","MA","Uxbridge",2012,520,6777,7297
"8065","Wakefield","Middlesex County County","MA","Wakefield",1990,761,13135,13896
"8066","Wakefield","Middlesex County County","MA","Wakefield",1991,1005,12784,13789
"8067","Wakefield","Middlesex County County","MA","Wakefield",1992,1048,12735,13783
"8068","Wakefield","Middlesex County County","MA","Wakefield",1993,813,12906,13719
"8069","Wakefield","Middlesex County County","MA","Wakefield",1994,699,13054,13753
"8070","Wakefield","Middlesex County County","MA","Wakefield",1995,592,12906,13498
"8071","Wakefield","Middlesex County County","MA","Wakefield",1996,464,13173,13637
"8072","Wakefield","Middlesex County County","MA","Wakefield",1997,418,13486,13904
"8073","Wakefield","Middlesex County County","MA","Wakefield",1998,364,13674,14038
"8074","Wakefield","Middlesex County County","MA","Wakefield",1999,391,13833,14224
"8075","Wakefield","Middlesex County County","MA","Wakefield",2000,310,13649,13959
"8076","Wakefield","Middlesex County County","MA","Wakefield",2001,472,13586,14058
"8077","Wakefield","Middlesex County County","MA","Wakefield",2002,682,13298,13980
"8078","Wakefield","Middlesex County County","MA","Wakefield",2003,728,13090,13818
"8079","Wakefield","Middlesex County County","MA","Wakefield",2004,636,13010,13646
"8080","Wakefield","Middlesex County County","MA","Wakefield",2005,596,13155,13751
"8081","Wakefield","Middlesex County County","MA","Wakefield",2006,592,12972,13564
"8082","Wakefield","Middlesex County County","MA","Wakefield",2007,561,13101,13662
"8083","Wakefield","Middlesex County County","MA","Wakefield",2008,681,13153,13834
"8084","Wakefield","Middlesex County County","MA","Wakefield",2009,1041,12870,13911
"8085","Wakefield","Middlesex County County","MA","Wakefield",2010,1005,12926,13931
"8086","Wakefield","Middlesex County County","MA","Wakefield",2011,831,13117,13948
"8087","Wakefield","Middlesex County County","MA","Wakefield",2012,738,13260,13998
"8088","Wales","Hampden County County","MA","Wales",1990,62,791,853
"8089","Wales","Hampden County County","MA","Wales",1991,87,788,875
"8090","Wales","Hampden County County","MA","Wales",1992,80,772,852
"8091","Wales","Hampden County County","MA","Wales",1993,95,800,895
"8092","Wales","Hampden County County","MA","Wales",1994,64,788,852
"8093","Wales","Hampden County County","MA","Wales",1995,49,857,906
"8094","Wales","Hampden County County","MA","Wales",1996,61,901,962
"8095","Wales","Hampden County County","MA","Wales",1997,58,894,952
"8096","Wales","Hampden County County","MA","Wales",1998,38,849,887
"8097","Wales","Hampden County County","MA","Wales",1999,36,823,859
"8098","Wales","Hampden County County","MA","Wales",2000,28,976,1004
"8099","Wales","Hampden County County","MA","Wales",2001,41,983,1024
"8100","Wales","Hampden County County","MA","Wales",2002,52,983,1035
"8101","Wales","Hampden County County","MA","Wales",2003,64,981,1045
"8102","Wales","Hampden County County","MA","Wales",2004,63,988,1051
"8103","Wales","Hampden County County","MA","Wales",2005,48,1005,1053
"8104","Wales","Hampden County County","MA","Wales",2006,59,1022,1081
"8105","Wales","Hampden County County","MA","Wales",2007,58,1027,1085
"8106","Wales","Hampden County County","MA","Wales",2008,65,1039,1104
"8107","Wales","Hampden County County","MA","Wales",2009,94,1002,1096
"8108","Wales","Hampden County County","MA","Wales",2010,95,971,1066
"8109","Wales","Hampden County County","MA","Wales",2011,88,962,1050
"8110","Wales","Hampden County County","MA","Wales",2012,79,962,1041
"8111","Walpole","Norfolk County County","MA","Walpole",1990,570,10765,11335
"8112","Walpole","Norfolk County County","MA","Walpole",1991,862,10522,11384
"8113","Walpole","Norfolk County County","MA","Walpole",1992,815,10602,11417
"8114","Walpole","Norfolk County County","MA","Walpole",1993,676,10939,11615
"8115","Walpole","Norfolk County County","MA","Walpole",1994,560,11372,11932
"8116","Walpole","Norfolk County County","MA","Walpole",1995,491,11572,12063
"8117","Walpole","Norfolk County County","MA","Walpole",1996,430,11873,12303
"8118","Walpole","Norfolk County County","MA","Walpole",1997,380,12264,12644
"8119","Walpole","Norfolk County County","MA","Walpole",1998,313,12599,12912
"8120","Walpole","Norfolk County County","MA","Walpole",1999,291,12754,13045
"8121","Walpole","Norfolk County County","MA","Walpole",2000,282,11938,12220
"8122","Walpole","Norfolk County County","MA","Walpole",2001,392,11963,12355
"8123","Walpole","Norfolk County County","MA","Walpole",2002,531,11817,12348
"8124","Walpole","Norfolk County County","MA","Walpole",2003,621,11671,12292
"8125","Walpole","Norfolk County County","MA","Walpole",2004,518,11671,12189
"8126","Walpole","Norfolk County County","MA","Walpole",2005,489,11744,12233
"8127","Walpole","Norfolk County County","MA","Walpole",2006,505,11557,12062
"8128","Walpole","Norfolk County County","MA","Walpole",2007,484,11723,12207
"8129","Walpole","Norfolk County County","MA","Walpole",2008,553,11744,12297
"8130","Walpole","Norfolk County County","MA","Walpole",2009,864,11370,12234
"8131","Walpole","Norfolk County County","MA","Walpole",2010,901,11846,12747
"8132","Walpole","Norfolk County County","MA","Walpole",2011,762,11978,12740
"8133","Walpole","Norfolk County County","MA","Walpole",2012,685,12109,12794
"8134","Waltham","Middlesex County County","MA","Waltham",1990,1858,32209,34067
"8135","Waltham","Middlesex County County","MA","Waltham",1991,2393,30522,32915
"8136","Waltham","Middlesex County County","MA","Waltham",1992,2568,29584,32152
"8137","Waltham","Middlesex County County","MA","Waltham",1993,2176,29613,31789
"8138","Waltham","Middlesex County County","MA","Waltham",1994,1876,29899,31775
"8139","Waltham","Middlesex County County","MA","Waltham",1995,1512,31429,32941
"8140","Waltham","Middlesex County County","MA","Waltham",1996,1260,32042,33302
"8141","Waltham","Middlesex County County","MA","Waltham",1997,1088,33133,34221
"8142","Waltham","Middlesex County County","MA","Waltham",1998,890,33844,34734
"8143","Waltham","Middlesex County County","MA","Waltham",1999,867,34249,35116
"8144","Waltham","Middlesex County County","MA","Waltham",2000,818,34367,35185
"8145","Waltham","Middlesex County County","MA","Waltham",2001,1189,34157,35346
"8146","Waltham","Middlesex County County","MA","Waltham",2002,1777,33408,35185
"8147","Waltham","Middlesex County County","MA","Waltham",2003,1889,32830,34719
"8148","Waltham","Middlesex County County","MA","Waltham",2004,1582,33098,34680
"8149","Waltham","Middlesex County County","MA","Waltham",2005,1465,33627,35092
"8150","Waltham","Middlesex County County","MA","Waltham",2006,1361,33986,35347
"8151","Waltham","Middlesex County County","MA","Waltham",2007,1283,33907,35190
"8152","Waltham","Middlesex County County","MA","Waltham",2008,1539,33917,35456
"8153","Waltham","Middlesex County County","MA","Waltham",2009,2323,32655,34978
"8154","Waltham","Middlesex County County","MA","Waltham",2010,2289,33160,35449
"8155","Waltham","Middlesex County County","MA","Waltham",2011,1965,33604,35569
"8156","Waltham","Middlesex County County","MA","Waltham",2012,1801,33972,35773
"8157","Ware","Hampshire County County","MA","Ware",1990,365,4605,4970
"8158","Ware","Hampshire County County","MA","Ware",1991,523,4457,4980
"8159","Ware","Hampshire County County","MA","Ware",1992,448,4434,4882
"8160","Ware","Hampshire County County","MA","Ware",1993,409,4395,4804
"8161","Ware","Hampshire County County","MA","Ware",1994,337,4428,4765
"8162","Ware","Hampshire County County","MA","Ware",1995,268,4455,4723
"8163","Ware","Hampshire County County","MA","Ware",1996,236,4528,4764
"8164","Ware","Hampshire County County","MA","Ware",1997,193,4618,4811
"8165","Ware","Hampshire County County","MA","Ware",1998,233,4626,4859
"8166","Ware","Hampshire County County","MA","Ware",1999,210,4652,4862
"8167","Ware","Hampshire County County","MA","Ware",2000,150,5004,5154
"8168","Ware","Hampshire County County","MA","Ware",2001,210,5006,5216
"8169","Ware","Hampshire County County","MA","Ware",2002,263,4984,5247
"8170","Ware","Hampshire County County","MA","Ware",2003,324,4969,5293
"8171","Ware","Hampshire County County","MA","Ware",2004,316,5055,5371
"8172","Ware","Hampshire County County","MA","Ware",2005,291,5072,5363
"8173","Ware","Hampshire County County","MA","Ware",2006,308,5095,5403
"8174","Ware","Hampshire County County","MA","Ware",2007,315,5084,5399
"8175","Ware","Hampshire County County","MA","Ware",2008,344,4984,5328
"8176","Ware","Hampshire County County","MA","Ware",2009,497,4763,5260
"8177","Ware","Hampshire County County","MA","Ware",2010,503,4792,5295
"8178","Ware","Hampshire County County","MA","Ware",2011,467,4733,5200
"8179","Ware","Hampshire County County","MA","Ware",2012,430,4735,5165
"8180","Wareham","Plymouth County County","MA","Wareham",1990,865,8268,9133
"8181","Wareham","Plymouth County County","MA","Wareham",1991,1147,8058,9205
"8182","Wareham","Plymouth County County","MA","Wareham",1992,1157,8043,9200
"8183","Wareham","Plymouth County County","MA","Wareham",1993,1018,8195,9213
"8184","Wareham","Plymouth County County","MA","Wareham",1994,839,8463,9302
"8185","Wareham","Plymouth County County","MA","Wareham",1995,748,8270,9018
"8186","Wareham","Plymouth County County","MA","Wareham",1996,623,8437,9060
"8187","Wareham","Plymouth County County","MA","Wareham",1997,598,8669,9267
"8188","Wareham","Plymouth County County","MA","Wareham",1998,481,8825,9306
"8189","Wareham","Plymouth County County","MA","Wareham",1999,432,8959,9391
"8190","Wareham","Plymouth County County","MA","Wareham",2000,373,10508,10881
"8191","Wareham","Plymouth County County","MA","Wareham",2001,457,10652,11109
"8192","Wareham","Plymouth County County","MA","Wareham",2002,619,10886,11505
"8193","Wareham","Plymouth County County","MA","Wareham",2003,714,11142,11856
"8194","Wareham","Plymouth County County","MA","Wareham",2004,686,11361,12047
"8195","Wareham","Plymouth County County","MA","Wareham",2005,661,11447,12108
"8196","Wareham","Plymouth County County","MA","Wareham",2006,656,11572,12228
"8197","Wareham","Plymouth County County","MA","Wareham",2007,664,11548,12212
"8198","Wareham","Plymouth County County","MA","Wareham",2008,818,11568,12386
"8199","Wareham","Plymouth County County","MA","Wareham",2009,1188,11316,12504
"8200","Wareham","Plymouth County County","MA","Wareham",2010,1195,11730,12925
"8201","Wareham","Plymouth County County","MA","Wareham",2011,1082,11781,12863
"8202","Wareham","Plymouth County County","MA","Wareham",2012,1017,11979,12996
"8203","Warren","Worcester County County","MA","Warren",1990,142,2138,2280
"8204","Warren","Worcester County County","MA","Warren",1991,194,2045,2239
"8205","Warren","Worcester County County","MA","Warren",1992,210,1965,2175
"8206","Warren","Worcester County County","MA","Warren",1993,203,1959,2162
"8207","Warren","Worcester County County","MA","Warren",1994,182,1955,2137
"8208","Warren","Worcester County County","MA","Warren",1995,131,2364,2495
"8209","Warren","Worcester County County","MA","Warren",1996,136,2493,2629
"8210","Warren","Worcester County County","MA","Warren",1997,119,2491,2610
"8211","Warren","Worcester County County","MA","Warren",1998,115,2411,2526
"8212","Warren","Worcester County County","MA","Warren",1999,109,2352,2461
"8213","Warren","Worcester County County","MA","Warren",2000,71,2270,2341
"8214","Warren","Worcester County County","MA","Warren",2001,91,2257,2348
"8215","Warren","Worcester County County","MA","Warren",2002,131,2256,2387
"8216","Warren","Worcester County County","MA","Warren",2003,163,2265,2428
"8217","Warren","Worcester County County","MA","Warren",2004,167,2287,2454
"8218","Warren","Worcester County County","MA","Warren",2005,144,2309,2453
"8219","Warren","Worcester County County","MA","Warren",2006,178,2401,2579
"8220","Warren","Worcester County County","MA","Warren",2007,171,2411,2582
"8221","Warren","Worcester County County","MA","Warren",2008,166,2368,2534
"8222","Warren","Worcester County County","MA","Warren",2009,234,2308,2542
"8223","Warren","Worcester County County","MA","Warren",2010,258,2250,2508
"8224","Warren","Worcester County County","MA","Warren",2011,205,2269,2474
"8225","Warren","Worcester County County","MA","Warren",2012,197,2269,2466
"8226","Warwick","Franklin County County","MA","Warwick",1990,19,333,352
"8227","Warwick","Franklin County County","MA","Warwick",1991,31,311,342
"8228","Warwick","Franklin County County","MA","Warwick",1992,32,297,329
"8229","Warwick","Franklin County County","MA","Warwick",1993,27,275,302
"8230","Warwick","Franklin County County","MA","Warwick",1994,23,269,292
"8231","Warwick","Franklin County County","MA","Warwick",1995,18,320,338
"8232","Warwick","Franklin County County","MA","Warwick",1996,13,318,331
"8233","Warwick","Franklin County County","MA","Warwick",1997,15,322,337
"8234","Warwick","Franklin County County","MA","Warwick",1998,14,311,325
"8235","Warwick","Franklin County County","MA","Warwick",1999,19,311,330
"8236","Warwick","Franklin County County","MA","Warwick",2000,14,363,377
"8237","Warwick","Franklin County County","MA","Warwick",2001,12,356,368
"8238","Warwick","Franklin County County","MA","Warwick",2002,18,357,375
"8239","Warwick","Franklin County County","MA","Warwick",2003,26,350,376
"8240","Warwick","Franklin County County","MA","Warwick",2004,24,345,369
"8241","Warwick","Franklin County County","MA","Warwick",2005,25,343,368
"8242","Warwick","Franklin County County","MA","Warwick",2006,26,342,368
"8243","Warwick","Franklin County County","MA","Warwick",2007,15,334,349
"8244","Warwick","Franklin County County","MA","Warwick",2008,16,337,353
"8245","Warwick","Franklin County County","MA","Warwick",2009,30,321,351
"8246","Warwick","Franklin County County","MA","Warwick",2010,35,333,368
"8247","Warwick","Franklin County County","MA","Warwick",2011,27,332,359
"8248","Warwick","Franklin County County","MA","Warwick",2012,24,334,358
"8249","Washington","Berkshire County County","MA","Washington",1990,14,280,294
"8250","Washington","Berkshire County County","MA","Washington",1991,27,271,298
"8251","Washington","Berkshire County County","MA","Washington",1992,28,284,312
"8252","Washington","Berkshire County County","MA","Washington",1993,14,301,315
"8253","Washington","Berkshire County County","MA","Washington",1994,15,315,330
"8254","Washington","Berkshire County County","MA","Washington",1995,15,334,349
"8255","Washington","Berkshire County County","MA","Washington",1996,14,324,338
"8256","Washington","Berkshire County County","MA","Washington",1997,14,326,340
"8257","Washington","Berkshire County County","MA","Washington",1998,11,339,350
"8258","Washington","Berkshire County County","MA","Washington",1999,15,367,382
"8259","Washington","Berkshire County County","MA","Washington",2000,11,300,311
"8260","Washington","Berkshire County County","MA","Washington",2001,12,299,311
"8261","Washington","Berkshire County County","MA","Washington",2002,12,304,316
"8262","Washington","Berkshire County County","MA","Washington",2003,18,303,321
"8263","Washington","Berkshire County County","MA","Washington",2004,13,305,318
"8264","Washington","Berkshire County County","MA","Washington",2005,13,312,325
"8265","Washington","Berkshire County County","MA","Washington",2006,12,320,332
"8266","Washington","Berkshire County County","MA","Washington",2007,15,321,336
"8267","Washington","Berkshire County County","MA","Washington",2008,16,315,331
"8268","Washington","Berkshire County County","MA","Washington",2009,23,306,329
"8269","Washington","Berkshire County County","MA","Washington",2010,30,294,324
"8270","Washington","Berkshire County County","MA","Washington",2011,20,296,316
"8271","Washington","Berkshire County County","MA","Washington",2012,16,295,311
"8272","Watertown","Middlesex County County","MA","Watertown",1990,856,19591,20447
"8273","Watertown","Middlesex County County","MA","Watertown",1991,1100,18723,19823
"8274","Watertown","Middlesex County County","MA","Watertown",1992,1188,18216,19404
"8275","Watertown","Middlesex County County","MA","Watertown",1993,1057,18141,19198
"8276","Watertown","Middlesex County County","MA","Watertown",1994,876,18176,19052
"8277","Watertown","Middlesex County County","MA","Watertown",1995,762,18967,19729
"8278","Watertown","Middlesex County County","MA","Watertown",1996,644,19278,19922
"8279","Watertown","Middlesex County County","MA","Watertown",1997,505,19733,20238
"8280","Watertown","Middlesex County County","MA","Watertown",1998,425,19910,20335
"8281","Watertown","Middlesex County County","MA","Watertown",1999,446,19976,20422
"8282","Watertown","Middlesex County County","MA","Watertown",2000,414,19938,20352
"8283","Watertown","Middlesex County County","MA","Watertown",2001,661,19810,20471
"8284","Watertown","Middlesex County County","MA","Watertown",2002,959,19355,20314
"8285","Watertown","Middlesex County County","MA","Watertown",2003,969,19116,20085
"8286","Watertown","Middlesex County County","MA","Watertown",2004,770,18982,19752
"8287","Watertown","Middlesex County County","MA","Watertown",2005,700,19005,19705
"8288","Watertown","Middlesex County County","MA","Watertown",2006,699,19050,19749
"8289","Watertown","Middlesex County County","MA","Watertown",2007,640,19167,19807
"8290","Watertown","Middlesex County County","MA","Watertown",2008,751,19132,19883
"8291","Watertown","Middlesex County County","MA","Watertown",2009,1221,18593,19814
"8292","Watertown","Middlesex County County","MA","Watertown",2010,1205,18187,19392
"8293","Watertown","Middlesex County County","MA","Watertown",2011,1006,18456,19462
"8294","Watertown","Middlesex County County","MA","Watertown",2012,918,18658,19576
"8295","Wayland","Middlesex County County","MA","Wayland",1990,228,6318,6546
"8296","Wayland","Middlesex County County","MA","Wayland",1991,278,6168,6446
"8297","Wayland","Middlesex County County","MA","Wayland",1992,300,6220,6520
"8298","Wayland","Middlesex County County","MA","Wayland",1993,273,6308,6581
"8299","Wayland","Middlesex County County","MA","Wayland",1994,221,6443,6664
"8300","Wayland","Middlesex County County","MA","Wayland",1995,183,6287,6470
"8301","Wayland","Middlesex County County","MA","Wayland",1996,138,6444,6582
"8302","Wayland","Middlesex County County","MA","Wayland",1997,125,6682,6807
"8303","Wayland","Middlesex County County","MA","Wayland",1998,100,6800,6900
"8304","Wayland","Middlesex County County","MA","Wayland",1999,118,6899,7017
"8305","Wayland","Middlesex County County","MA","Wayland",2000,129,6721,6850
"8306","Wayland","Middlesex County County","MA","Wayland",2001,197,6728,6925
"8307","Wayland","Middlesex County County","MA","Wayland",2002,297,6601,6898
"8308","Wayland","Middlesex County County","MA","Wayland",2003,293,6483,6776
"8309","Wayland","Middlesex County County","MA","Wayland",2004,248,6442,6690
"8310","Wayland","Middlesex County County","MA","Wayland",2005,210,6480,6690
"8311","Wayland","Middlesex County County","MA","Wayland",2006,212,6453,6665
"8312","Wayland","Middlesex County County","MA","Wayland",2007,197,6523,6720
"8313","Wayland","Middlesex County County","MA","Wayland",2008,246,6563,6809
"8314","Wayland","Middlesex County County","MA","Wayland",2009,389,6421,6810
"8315","Wayland","Middlesex County County","MA","Wayland",2010,392,6272,6664
"8316","Wayland","Middlesex County County","MA","Wayland",2011,325,6365,6690
"8317","Wayland","Middlesex County County","MA","Wayland",2012,303,6435,6738
"8318","Webster","Worcester County County","MA","Webster",1990,689,7716,8405
"8319","Webster","Worcester County County","MA","Webster",1991,848,7448,8296
"8320","Webster","Worcester County County","MA","Webster",1992,894,7464,8358
"8321","Webster","Worcester County County","MA","Webster",1993,697,7598,8295
"8322","Webster","Worcester County County","MA","Webster",1994,505,7710,8215
"8323","Webster","Worcester County County","MA","Webster",1995,506,7634,8140
"8324","Webster","Worcester County County","MA","Webster",1996,398,7727,8125
"8325","Webster","Worcester County County","MA","Webster",1997,367,7895,8262
"8326","Webster","Worcester County County","MA","Webster",1998,383,8228,8611
"8327","Webster","Worcester County County","MA","Webster",1999,336,8167,8503
"8328","Webster","Worcester County County","MA","Webster",2000,277,7973,8250
"8329","Webster","Worcester County County","MA","Webster",2001,361,7969,8330
"8330","Webster","Worcester County County","MA","Webster",2002,508,7934,8442
"8331","Webster","Worcester County County","MA","Webster",2003,622,7932,8554
"8332","Webster","Worcester County County","MA","Webster",2004,543,7910,8453
"8333","Webster","Worcester County County","MA","Webster",2005,486,7872,8358
"8334","Webster","Worcester County County","MA","Webster",2006,513,7910,8423
"8335","Webster","Worcester County County","MA","Webster",2007,502,7914,8416
"8336","Webster","Worcester County County","MA","Webster",2008,589,7745,8334
"8337","Webster","Worcester County County","MA","Webster",2009,898,7520,8418
"8338","Webster","Worcester County County","MA","Webster",2010,851,7497,8348
"8339","Webster","Worcester County County","MA","Webster",2011,773,7563,8336
"8340","Webster","Worcester County County","MA","Webster",2012,717,7561,8278
"8341","Wellesley","Norfolk County County","MA","Wellesley",1990,353,13337,13690
"8342","Wellesley","Norfolk County County","MA","Wellesley",1991,452,12811,13263
"8343","Wellesley","Norfolk County County","MA","Wellesley",1992,484,12867,13351
"8344","Wellesley","Norfolk County County","MA","Wellesley",1993,412,13061,13473
"8345","Wellesley","Norfolk County County","MA","Wellesley",1994,369,13263,13632
"8346","Wellesley","Norfolk County County","MA","Wellesley",1995,326,13273,13599
"8347","Wellesley","Norfolk County County","MA","Wellesley",1996,219,13496,13715
"8348","Wellesley","Norfolk County County","MA","Wellesley",1997,202,13806,14008
"8349","Wellesley","Norfolk County County","MA","Wellesley",1998,199,13944,14143
"8350","Wellesley","Norfolk County County","MA","Wellesley",1999,191,14000,14191
"8351","Wellesley","Norfolk County County","MA","Wellesley",2000,235,13111,13346
"8352","Wellesley","Norfolk County County","MA","Wellesley",2001,340,13050,13390
"8353","Wellesley","Norfolk County County","MA","Wellesley",2002,499,12817,13316
"8354","Wellesley","Norfolk County County","MA","Wellesley",2003,494,12597,13091
"8355","Wellesley","Norfolk County County","MA","Wellesley",2004,453,12581,13034
"8356","Wellesley","Norfolk County County","MA","Wellesley",2005,424,12723,13147
"8357","Wellesley","Norfolk County County","MA","Wellesley",2006,390,12567,12957
"8358","Wellesley","Norfolk County County","MA","Wellesley",2007,395,12718,13113
"8359","Wellesley","Norfolk County County","MA","Wellesley",2008,482,12740,13222
"8360","Wellesley","Norfolk County County","MA","Wellesley",2009,742,12330,13072
"8361","Wellesley","Norfolk County County","MA","Wellesley",2010,705,12782,13487
"8362","Wellesley","Norfolk County County","MA","Wellesley",2011,598,12915,13513
"8363","Wellesley","Norfolk County County","MA","Wellesley",2012,565,13057,13622
"8364","Wellfleet","Barnstable County County","MA","Wellfleet",1990,157,1663,1820
"8365","Wellfleet","Barnstable County County","MA","Wellfleet",1991,212,1672,1884
"8366","Wellfleet","Barnstable County County","MA","Wellfleet",1992,251,1695,1946
"8367","Wellfleet","Barnstable County County","MA","Wellfleet",1993,231,1782,2013
"8368","Wellfleet","Barnstable County County","MA","Wellfleet",1994,239,1799,2038
"8369","Wellfleet","Barnstable County County","MA","Wellfleet",1995,239,1835,2074
"8370","Wellfleet","Barnstable County County","MA","Wellfleet",1996,156,1844,2000
"8371","Wellfleet","Barnstable County County","MA","Wellfleet",1997,152,1845,1997
"8372","Wellfleet","Barnstable County County","MA","Wellfleet",1998,154,1872,2026
"8373","Wellfleet","Barnstable County County","MA","Wellfleet",1999,133,1915,2048
"8374","Wellfleet","Barnstable County County","MA","Wellfleet",2000,74,1459,1533
"8375","Wellfleet","Barnstable County County","MA","Wellfleet",2001,81,1476,1557
"8376","Wellfleet","Barnstable County County","MA","Wellfleet",2002,99,1506,1605
"8377","Wellfleet","Barnstable County County","MA","Wellfleet",2003,110,1540,1650
"8378","Wellfleet","Barnstable County County","MA","Wellfleet",2004,103,1558,1661
"8379","Wellfleet","Barnstable County County","MA","Wellfleet",2005,108,1557,1665
"8380","Wellfleet","Barnstable County County","MA","Wellfleet",2006,114,1554,1668
"8381","Wellfleet","Barnstable County County","MA","Wellfleet",2007,103,1540,1643
"8382","Wellfleet","Barnstable County County","MA","Wellfleet",2008,129,1524,1653
"8383","Wellfleet","Barnstable County County","MA","Wellfleet",2009,199,1545,1744
"8384","Wellfleet","Barnstable County County","MA","Wellfleet",2010,199,1517,1716
"8385","Wellfleet","Barnstable County County","MA","Wellfleet",2011,206,1515,1721
"8386","Wellfleet","Barnstable County County","MA","Wellfleet",2012,184,1540,1724
"8387","Wendell","Franklin County County","MA","Wendell",1990,31,489,520
"8388","Wendell","Franklin County County","MA","Wendell",1991,50,497,547
"8389","Wendell","Franklin County County","MA","Wendell",1992,51,477,528
"8390","Wendell","Franklin County County","MA","Wendell",1993,37,479,516
"8391","Wendell","Franklin County County","MA","Wendell",1994,35,495,530
"8392","Wendell","Franklin County County","MA","Wendell",1995,20,520,540
"8393","Wendell","Franklin County County","MA","Wendell",1996,20,523,543
"8394","Wendell","Franklin County County","MA","Wendell",1997,19,536,555
"8395","Wendell","Franklin County County","MA","Wendell",1998,22,549,571
"8396","Wendell","Franklin County County","MA","Wendell",1999,15,563,578
"8397","Wendell","Franklin County County","MA","Wendell",2000,12,601,613
"8398","Wendell","Franklin County County","MA","Wendell",2001,20,592,612
"8399","Wendell","Franklin County County","MA","Wendell",2002,21,598,619
"8400","Wendell","Franklin County County","MA","Wendell",2003,22,592,614
"8401","Wendell","Franklin County County","MA","Wendell",2004,27,587,614
"8402","Wendell","Franklin County County","MA","Wendell",2005,18,586,604
"8403","Wendell","Franklin County County","MA","Wendell",2006,26,585,611
"8404","Wendell","Franklin County County","MA","Wendell",2007,20,561,581
"8405","Wendell","Franklin County County","MA","Wendell",2008,27,565,592
"8406","Wendell","Franklin County County","MA","Wendell",2009,40,542,582
"8407","Wendell","Franklin County County","MA","Wendell",2010,40,455,495
"8408","Wendell","Franklin County County","MA","Wendell",2011,35,454,489
"8409","Wendell","Franklin County County","MA","Wendell",2012,30,455,485
"8410","Wenham","Essex County County","MA","Wenham",1990,70,2225,2295
"8411","Wenham","Essex County County","MA","Wenham",1991,92,2151,2243
"8412","Wenham","Essex County County","MA","Wenham",1992,78,2183,2261
"8413","Wenham","Essex County County","MA","Wenham",1993,73,2251,2324
"8414","Wenham","Essex County County","MA","Wenham",1994,61,2289,2350
"8415","Wenham","Essex County County","MA","Wenham",1995,58,2310,2368
"8416","Wenham","Essex County County","MA","Wenham",1996,53,2352,2405
"8417","Wenham","Essex County County","MA","Wenham",1997,51,2419,2470
"8418","Wenham","Essex County County","MA","Wenham",1998,40,2504,2544
"8419","Wenham","Essex County County","MA","Wenham",1999,38,2539,2577
"8420","Wenham","Essex County County","MA","Wenham",2000,43,1771,1814
"8421","Wenham","Essex County County","MA","Wenham",2001,65,1758,1823
"8422","Wenham","Essex County County","MA","Wenham",2002,98,1734,1832
"8423","Wenham","Essex County County","MA","Wenham",2003,102,1709,1811
"8424","Wenham","Essex County County","MA","Wenham",2004,90,1703,1793
"8425","Wenham","Essex County County","MA","Wenham",2005,90,1715,1805
"8426","Wenham","Essex County County","MA","Wenham",2006,73,1636,1709
"8427","Wenham","Essex County County","MA","Wenham",2007,72,1733,1805
"8428","Wenham","Essex County County","MA","Wenham",2008,98,1727,1825
"8429","Wenham","Essex County County","MA","Wenham",2009,151,1671,1822
"8430","Wenham","Essex County County","MA","Wenham",2010,148,1742,1890
"8431","Wenham","Essex County County","MA","Wenham",2011,130,1759,1889
"8432","Wenham","Essex County County","MA","Wenham",2012,122,1778,1900
"8433","West Boylston","Worcester County County","MA","West Boylston",1990,172,2988,3160
"8434","West Boylston","Worcester County County","MA","West Boylston",1991,245,2834,3079
"8435","West Boylston","Worcester County County","MA","West Boylston",1992,254,2853,3107
"8436","West Boylston","Worcester County County","MA","West Boylston",1993,194,2937,3131
"8437","West Boylston","Worcester County County","MA","West Boylston",1994,157,2972,3129
"8438","West Boylston","Worcester County County","MA","West Boylston",1995,138,2969,3107
"8439","West Boylston","Worcester County County","MA","West Boylston",1996,95,3016,3111
"8440","West Boylston","Worcester County County","MA","West Boylston",1997,97,3105,3202
"8441","West Boylston","Worcester County County","MA","West Boylston",1998,78,3163,3241
"8442","West Boylston","Worcester County County","MA","West Boylston",1999,98,3148,3246
"8443","West Boylston","Worcester County County","MA","West Boylston",2000,87,3189,3276
"8444","West Boylston","Worcester County County","MA","West Boylston",2001,103,3194,3297
"8445","West Boylston","Worcester County County","MA","West Boylston",2002,158,3144,3302
"8446","West Boylston","Worcester County County","MA","West Boylston",2003,189,3150,3339
"8447","West Boylston","Worcester County County","MA","West Boylston",2004,170,3131,3301
"8448","West Boylston","Worcester County County","MA","West Boylston",2005,158,3155,3313
"8449","West Boylston","Worcester County County","MA","West Boylston",2006,174,3295,3469
"8450","West Boylston","Worcester County County","MA","West Boylston",2007,165,3347,3512
"8451","West Boylston","Worcester County County","MA","West Boylston",2008,189,3271,3460
"8452","West Boylston","Worcester County County","MA","West Boylston",2009,304,3173,3477
"8453","West Boylston","Worcester County County","MA","West Boylston",2010,298,3008,3306
"8454","West Boylston","Worcester County County","MA","West Boylston",2011,271,3033,3304
"8455","West Boylston","Worcester County County","MA","West Boylston",2012,239,3032,3271
"8456","West Bridgewater","Plymouth County County","MA","West Bridgewater",1990,225,3322,3547
"8457","West Bridgewater","Plymouth County County","MA","West Bridgewater",1991,329,3160,3489
"8458","West Bridgewater","Plymouth County County","MA","West Bridgewater",1992,355,3118,3473
"8459","West Bridgewater","Plymouth County County","MA","West Bridgewater",1993,297,3272,3569
"8460","West Bridgewater","Plymouth County County","MA","West Bridgewater",1994,234,3408,3642
"8461","West Bridgewater","Plymouth County County","MA","West Bridgewater",1995,204,3500,3704
"8462","West Bridgewater","Plymouth County County","MA","West Bridgewater",1996,180,3537,3717
"8463","West Bridgewater","Plymouth County County","MA","West Bridgewater",1997,164,3648,3812
"8464","West Bridgewater","Plymouth County County","MA","West Bridgewater",1998,113,3681,3794
"8465","West Bridgewater","Plymouth County County","MA","West Bridgewater",1999,104,3751,3855
"8466","West Bridgewater","Plymouth County County","MA","West Bridgewater",2000,91,3420,3511
"8467","West Bridgewater","Plymouth County County","MA","West Bridgewater",2001,118,3428,3546
"8468","West Bridgewater","Plymouth County County","MA","West Bridgewater",2002,184,3405,3589
"8469","West Bridgewater","Plymouth County County","MA","West Bridgewater",2003,193,3336,3529
"8470","West Bridgewater","Plymouth County County","MA","West Bridgewater",2004,181,3327,3508
"8471","West Bridgewater","Plymouth County County","MA","West Bridgewater",2005,178,3326,3504
"8472","West Bridgewater","Plymouth County County","MA","West Bridgewater",2006,167,3344,3511
"8473","West Bridgewater","Plymouth County County","MA","West Bridgewater",2007,165,3344,3509
"8474","West Bridgewater","Plymouth County County","MA","West Bridgewater",2008,198,3319,3517
"8475","West Bridgewater","Plymouth County County","MA","West Bridgewater",2009,301,3213,3514
"8476","West Bridgewater","Plymouth County County","MA","West Bridgewater",2010,304,3320,3624
"8477","West Bridgewater","Plymouth County County","MA","West Bridgewater",2011,279,3352,3631
"8478","West Bridgewater","Plymouth County County","MA","West Bridgewater",2012,254,3381,3635
"8479","West Brookfield","Worcester County County","MA","West Brookfield",1990,112,1622,1734
"8480","West Brookfield","Worcester County County","MA","West Brookfield",1991,153,1576,1729
"8481","West Brookfield","Worcester County County","MA","West Brookfield",1992,150,1595,1745
"8482","West Brookfield","Worcester County County","MA","West Brookfield",1993,117,1650,1767
"8483","West Brookfield","Worcester County County","MA","West Brookfield",1994,110,1683,1793
"8484","West Brookfield","Worcester County County","MA","West Brookfield",1995,97,1645,1742
"8485","West Brookfield","Worcester County County","MA","West Brookfield",1996,96,1678,1774
"8486","West Brookfield","Worcester County County","MA","West Brookfield",1997,82,1729,1811
"8487","West Brookfield","Worcester County County","MA","West Brookfield",1998,64,1776,1840
"8488","West Brookfield","Worcester County County","MA","West Brookfield",1999,54,1778,1832
"8489","West Brookfield","Worcester County County","MA","West Brookfield",2000,46,1828,1874
"8490","West Brookfield","Worcester County County","MA","West Brookfield",2001,65,1831,1896
"8491","West Brookfield","Worcester County County","MA","West Brookfield",2002,103,1819,1922
"8492","West Brookfield","Worcester County County","MA","West Brookfield",2003,118,1811,1929
"8493","West Brookfield","Worcester County County","MA","West Brookfield",2004,117,1806,1923
"8494","West Brookfield","Worcester County County","MA","West Brookfield",2005,102,1798,1900
"8495","West Brookfield","Worcester County County","MA","West Brookfield",2006,98,1799,1897
"8496","West Brookfield","Worcester County County","MA","West Brookfield",2007,97,1795,1892
"8497","West Brookfield","Worcester County County","MA","West Brookfield",2008,116,1753,1869
"8498","West Brookfield","Worcester County County","MA","West Brookfield",2009,179,1702,1881
"8499","West Brookfield","Worcester County County","MA","West Brookfield",2010,183,1636,1819
"8500","West Brookfield","Worcester County County","MA","West Brookfield",2011,163,1651,1814
"8501","West Brookfield","Worcester County County","MA","West Brookfield",2012,143,1650,1793
"8502","West Newbury","Essex County County","MA","West Newbury",1990,86,1878,1964
"8503","West Newbury","Essex County County","MA","West Newbury",1991,114,1886,2000
"8504","West Newbury","Essex County County","MA","West Newbury",1992,120,1959,2079
"8505","West Newbury","Essex County County","MA","West Newbury",1993,96,2106,2202
"8506","West Newbury","Essex County County","MA","West Newbury",1994,93,2157,2250
"8507","West Newbury","Essex County County","MA","West Newbury",1995,87,2121,2208
"8508","West Newbury","Essex County County","MA","West Newbury",1996,68,2211,2279
"8509","West Newbury","Essex County County","MA","West Newbury",1997,61,2256,2317
"8510","West Newbury","Essex County County","MA","West Newbury",1998,52,2318,2370
"8511","West Newbury","Essex County County","MA","West Newbury",1999,61,2391,2452
"8512","West Newbury","Essex County County","MA","West Newbury",2000,48,2281,2329
"8513","West Newbury","Essex County County","MA","West Newbury",2001,62,2271,2333
"8514","West Newbury","Essex County County","MA","West Newbury",2002,81,2218,2299
"8515","West Newbury","Essex County County","MA","West Newbury",2003,105,2175,2280
"8516","West Newbury","Essex County County","MA","West Newbury",2004,89,2164,2253
"8517","West Newbury","Essex County County","MA","West Newbury",2005,78,2186,2264
"8518","West Newbury","Essex County County","MA","West Newbury",2006,83,2197,2280
"8519","West Newbury","Essex County County","MA","West Newbury",2007,73,2191,2264
"8520","West Newbury","Essex County County","MA","West Newbury",2008,81,2159,2240
"8521","West Newbury","Essex County County","MA","West Newbury",2009,151,2159,2310
"8522","West Newbury","Essex County County","MA","West Newbury",2010,145,2123,2268
"8523","West Newbury","Essex County County","MA","West Newbury",2011,121,2150,2271
"8524","West Newbury","Essex County County","MA","West Newbury",2012,109,2178,2287
"8525","West Springfield","Hampden County County","MA","West Springfield",1990,897,14063,14960
"8526","West Springfield","Hampden County County","MA","West Springfield",1991,1238,13479,14717
"8527","West Springfield","Hampden County County","MA","West Springfield",1992,1245,13416,14661
"8528","West Springfield","Hampden County County","MA","West Springfield",1993,1143,13265,14408
"8529","West Springfield","Hampden County County","MA","West Springfield",1994,1338,13246,14584
"8530","West Springfield","Hampden County County","MA","West Springfield",1995,1127,13104,14231
"8531","West Springfield","Hampden County County","MA","West Springfield",1996,795,13202,13997
"8532","West Springfield","Hampden County County","MA","West Springfield",1997,714,13446,14160
"8533","West Springfield","Hampden County County","MA","West Springfield",1998,497,13522,14019
"8534","West Springfield","Hampden County County","MA","West Springfield",1999,497,13511,14008
"8535","West Springfield","Hampden County County","MA","West Springfield",2000,410,14043,14453
"8536","West Springfield","Hampden County County","MA","West Springfield",2001,563,14055,14618
"8537","West Springfield","Hampden County County","MA","West Springfield",2002,738,13992,14730
"8538","West Springfield","Hampden County County","MA","West Springfield",2003,839,13851,14690
"8539","West Springfield","Hampden County County","MA","West Springfield",2004,792,13836,14628
"8540","West Springfield","Hampden County County","MA","West Springfield",2005,779,13860,14639
"8541","West Springfield","Hampden County County","MA","West Springfield",2006,728,13885,14613
"8542","West Springfield","Hampden County County","MA","West Springfield",2007,706,13801,14507
"8543","West Springfield","Hampden County County","MA","West Springfield",2008,891,13606,14497
"8544","West Springfield","Hampden County County","MA","West Springfield",2009,1281,13306,14587
"8545","West Springfield","Hampden County County","MA","West Springfield",2010,1359,13461,14820
"8546","West Springfield","Hampden County County","MA","West Springfield",2011,1173,13327,14500
"8547","West Springfield","Hampden County County","MA","West Springfield",2012,1092,13335,14427
"8548","West Stockbridge","Berkshire County County","MA","West Stockbridge",1990,49,742,791
"8549","West Stockbridge","Berkshire County County","MA","West Stockbridge",1991,62,724,786
"8550","West Stockbridge","Berkshire County County","MA","West Stockbridge",1992,76,731,807
"8551","West Stockbridge","Berkshire County County","MA","West Stockbridge",1993,41,775,816
"8552","West Stockbridge","Berkshire County County","MA","West Stockbridge",1994,46,792,838
"8553","West Stockbridge","Berkshire County County","MA","West Stockbridge",1995,42,792,834
"8554","West Stockbridge","Berkshire County County","MA","West Stockbridge",1996,36,809,845
"8555","West Stockbridge","Berkshire County County","MA","West Stockbridge",1997,26,823,849
"8556","West Stockbridge","Berkshire County County","MA","West Stockbridge",1998,23,820,843
"8557","West Stockbridge","Berkshire County County","MA","West Stockbridge",1999,19,817,836
"8558","West Stockbridge","Berkshire County County","MA","West Stockbridge",2000,17,778,795
"8559","West Stockbridge","Berkshire County County","MA","West Stockbridge",2001,17,814,831
"8560","West Stockbridge","Berkshire County County","MA","West Stockbridge",2002,25,842,867
"8561","West Stockbridge","Berkshire County County","MA","West Stockbridge",2003,25,848,873
"8562","West Stockbridge","Berkshire County County","MA","West Stockbridge",2004,24,846,870
"8563","West Stockbridge","Berkshire County County","MA","West Stockbridge",2005,27,863,890
"8564","West Stockbridge","Berkshire County County","MA","West Stockbridge",2006,23,873,896
"8565","West Stockbridge","Berkshire County County","MA","West Stockbridge",2007,24,855,879
"8566","West Stockbridge","Berkshire County County","MA","West Stockbridge",2008,30,848,878
"8567","West Stockbridge","Berkshire County County","MA","West Stockbridge",2009,53,824,877
"8568","West Stockbridge","Berkshire County County","MA","West Stockbridge",2010,55,758,813
"8569","West Stockbridge","Berkshire County County","MA","West Stockbridge",2011,52,763,815
"8570","West Stockbridge","Berkshire County County","MA","West Stockbridge",2012,39,756,795
"8571","West Tisbury","Dukes County County","MA","West Tisbury",1990,12,1106,1118
"8572","West Tisbury","Dukes County County","MA","West Tisbury",1991,19,1130,1149
"8573","West Tisbury","Dukes County County","MA","West Tisbury",1992,27,1080,1107
"8574","West Tisbury","Dukes County County","MA","West Tisbury",1993,26,1129,1155
"8575","West Tisbury","Dukes County County","MA","West Tisbury",1994,24,1226,1250
"8576","West Tisbury","Dukes County County","MA","West Tisbury",1995,33,1402,1435
"8577","West Tisbury","Dukes County County","MA","West Tisbury",1996,36,1483,1519
"8578","West Tisbury","Dukes County County","MA","West Tisbury",1997,30,1540,1570
"8579","West Tisbury","Dukes County County","MA","West Tisbury",1998,27,1579,1606
"8580","West Tisbury","Dukes County County","MA","West Tisbury",1999,28,1618,1646
"8581","West Tisbury","Dukes County County","MA","West Tisbury",2000,26,1751,1777
"8582","West Tisbury","Dukes County County","MA","West Tisbury",2001,26,1782,1808
"8583","West Tisbury","Dukes County County","MA","West Tisbury",2002,39,1858,1897
"8584","West Tisbury","Dukes County County","MA","West Tisbury",2003,49,1937,1986
"8585","West Tisbury","Dukes County County","MA","West Tisbury",2004,51,1970,2021
"8586","West Tisbury","Dukes County County","MA","West Tisbury",2005,46,1954,2000
"8587","West Tisbury","Dukes County County","MA","West Tisbury",2006,48,1961,2009
"8588","West Tisbury","Dukes County County","MA","West Tisbury",2007,42,1975,2017
"8589","West Tisbury","Dukes County County","MA","West Tisbury",2008,54,1978,2032
"8590","West Tisbury","Dukes County County","MA","West Tisbury",2009,88,1912,2000
"8591","West Tisbury","Dukes County County","MA","West Tisbury",2010,107,1915,2022
"8592","West Tisbury","Dukes County County","MA","West Tisbury",2011,93,1930,2023
"8593","West Tisbury","Dukes County County","MA","West Tisbury",2012,87,1949,2036
"8594","Westborough","Worcester County County","MA","Westborough",1990,342,7721,8063
"8595","Westborough","Worcester County County","MA","Westborough",1991,509,7564,8073
"8596","Westborough","Worcester County County","MA","Westborough",1992,524,7622,8146
"8597","Westborough","Worcester County County","MA","Westborough",1993,421,8017,8438
"8598","Westborough","Worcester County County","MA","Westborough",1994,357,8282,8639
"8599","Westborough","Worcester County County","MA","Westborough",1995,306,7947,8253
"8600","Westborough","Worcester County County","MA","Westborough",1996,223,8284,8507
"8601","Westborough","Worcester County County","MA","Westborough",1997,207,8594,8801
"8602","Westborough","Worcester County County","MA","Westborough",1998,185,8802,8987
"8603","Westborough","Worcester County County","MA","Westborough",1999,229,8848,9077
"8604","Westborough","Worcester County County","MA","Westborough",2000,189,8931,9120
"8605","Westborough","Worcester County County","MA","Westborough",2001,296,8982,9278
"8606","Westborough","Worcester County County","MA","Westborough",2002,463,8968,9431
"8607","Westborough","Worcester County County","MA","Westborough",2003,489,9012,9501
"8608","Westborough","Worcester County County","MA","Westborough",2004,390,8957,9347
"8609","Westborough","Worcester County County","MA","Westborough",2005,342,8927,9269
"8610","Westborough","Worcester County County","MA","Westborough",2006,339,8785,9124
"8611","Westborough","Worcester County County","MA","Westborough",2007,315,8804,9119
"8612","Westborough","Worcester County County","MA","Westborough",2008,380,8608,8988
"8613","Westborough","Worcester County County","MA","Westborough",2009,583,8361,8944
"8614","Westborough","Worcester County County","MA","Westborough",2010,591,8335,8926
"8615","Westborough","Worcester County County","MA","Westborough",2011,520,8409,8929
"8616","Westborough","Worcester County County","MA","Westborough",2012,453,8406,8859
"8617","Westfield","Hampden County County","MA","Westfield",1990,1066,18690,19756
"8618","Westfield","Hampden County County","MA","Westfield",1991,1845,18010,19855
"8619","Westfield","Hampden County County","MA","Westfield",1992,1634,17813,19447
"8620","Westfield","Hampden County County","MA","Westfield",1993,1444,17860,19304
"8621","Westfield","Hampden County County","MA","Westfield",1994,1044,18002,19046
"8622","Westfield","Hampden County County","MA","Westfield",1995,829,17818,18647
"8623","Westfield","Hampden County County","MA","Westfield",1996,646,18037,18683
"8624","Westfield","Hampden County County","MA","Westfield",1997,662,18493,19155
"8625","Westfield","Hampden County County","MA","Westfield",1998,648,18635,19283
"8626","Westfield","Hampden County County","MA","Westfield",1999,670,18723,19393
"8627","Westfield","Hampden County County","MA","Westfield",2000,573,20409,20982
"8628","Westfield","Hampden County County","MA","Westfield",2001,707,20423,21130
"8629","Westfield","Hampden County County","MA","Westfield",2002,988,20364,21352
"8630","Westfield","Hampden County County","MA","Westfield",2003,1118,20225,21343
"8631","Westfield","Hampden County County","MA","Westfield",2004,1041,20228,21269
"8632","Westfield","Hampden County County","MA","Westfield",2005,984,20290,21274
"8633","Westfield","Hampden County County","MA","Westfield",2006,995,20395,21390
"8634","Westfield","Hampden County County","MA","Westfield",2007,988,20301,21289
"8635","Westfield","Hampden County County","MA","Westfield",2008,1150,20344,21494
"8636","Westfield","Hampden County County","MA","Westfield",2009,1744,20146,21890
"8637","Westfield","Hampden County County","MA","Westfield",2010,1788,19699,21487
"8638","Westfield","Hampden County County","MA","Westfield",2011,1631,19501,21132
"8639","Westfield","Hampden County County","MA","Westfield",2012,1520,19513,21033
"8640","Westford","Middlesex County County","MA","Westford",1990,474,9386,9860
"8641","Westford","Middlesex County County","MA","Westford",1991,683,9210,9893
"8642","Westford","Middlesex County County","MA","Westford",1992,756,9374,10130
"8643","Westford","Middlesex County County","MA","Westford",1993,602,9601,10203
"8644","Westford","Middlesex County County","MA","Westford",1994,516,9941,10457
"8645","Westford","Middlesex County County","MA","Westford",1995,441,9920,10361
"8646","Westford","Middlesex County County","MA","Westford",1996,339,10433,10772
"8647","Westford","Middlesex County County","MA","Westford",1997,272,11034,11306
"8648","Westford","Middlesex County County","MA","Westford",1998,249,11511,11760
"8649","Westford","Middlesex County County","MA","Westford",1999,269,12103,12372
"8650","Westford","Middlesex County County","MA","Westford",2000,206,11323,11529
"8651","Westford","Middlesex County County","MA","Westford",2001,364,11452,11816
"8652","Westford","Middlesex County County","MA","Westford",2002,659,11307,11966
"8653","Westford","Middlesex County County","MA","Westford",2003,698,11189,11887
"8654","Westford","Middlesex County County","MA","Westford",2004,500,11207,11707
"8655","Westford","Middlesex County County","MA","Westford",2005,448,11280,11728
"8656","Westford","Middlesex County County","MA","Westford",2006,447,11292,11739
"8657","Westford","Middlesex County County","MA","Westford",2007,418,11436,11854
"8658","Westford","Middlesex County County","MA","Westford",2008,482,11550,12032
"8659","Westford","Middlesex County County","MA","Westford",2009,843,11508,12351
"8660","Westford","Middlesex County County","MA","Westford",2010,807,11239,12046
"8661","Westford","Middlesex County County","MA","Westford",2011,634,11360,11994
"8662","Westford","Middlesex County County","MA","Westford",2012,624,11485,12109
"8663","Westhampton","Hampshire County County","MA","Westhampton",1990,21,764,785
"8664","Westhampton","Hampshire County County","MA","Westhampton",1991,47,732,779
"8665","Westhampton","Hampshire County County","MA","Westhampton",1992,47,806,853
"8666","Westhampton","Hampshire County County","MA","Westhampton",1993,40,814,854
"8667","Westhampton","Hampshire County County","MA","Westhampton",1994,36,874,910
"8668","Westhampton","Hampshire County County","MA","Westhampton",1995,35,938,973
"8669","Westhampton","Hampshire County County","MA","Westhampton",1996,25,927,952
"8670","Westhampton","Hampshire County County","MA","Westhampton",1997,34,943,977
"8671","Westhampton","Hampshire County County","MA","Westhampton",1998,28,982,1010
"8672","Westhampton","Hampshire County County","MA","Westhampton",1999,26,1071,1097
"8673","Westhampton","Hampshire County County","MA","Westhampton",2000,17,875,892
"8674","Westhampton","Hampshire County County","MA","Westhampton",2001,22,887,909
"8675","Westhampton","Hampshire County County","MA","Westhampton",2002,28,890,918
"8676","Westhampton","Hampshire County County","MA","Westhampton",2003,33,894,927
"8677","Westhampton","Hampshire County County","MA","Westhampton",2004,31,909,940
"8678","Westhampton","Hampshire County County","MA","Westhampton",2005,27,917,944
"8679","Westhampton","Hampshire County County","MA","Westhampton",2006,26,934,960
"8680","Westhampton","Hampshire County County","MA","Westhampton",2007,30,936,966
"8681","Westhampton","Hampshire County County","MA","Westhampton",2008,42,922,964
"8682","Westhampton","Hampshire County County","MA","Westhampton",2009,65,886,951
"8683","Westhampton","Hampshire County County","MA","Westhampton",2010,57,899,956
"8684","Westhampton","Hampshire County County","MA","Westhampton",2011,59,889,948
"8685","Westhampton","Hampshire County County","MA","Westhampton",2012,52,889,941
"8686","Westminster","Worcester County County","MA","Westminster",1990,306,3128,3434
"8687","Westminster","Worcester County County","MA","Westminster",1991,322,3057,3379
"8688","Westminster","Worcester County County","MA","Westminster",1992,318,3178,3496
"8689","Westminster","Worcester County County","MA","Westminster",1993,245,3255,3500
"8690","Westminster","Worcester County County","MA","Westminster",1994,235,3316,3551
"8691","Westminster","Worcester County County","MA","Westminster",1995,188,3292,3480
"8692","Westminster","Worcester County County","MA","Westminster",1996,159,3299,3458
"8693","Westminster","Worcester County County","MA","Westminster",1997,138,3382,3520
"8694","Westminster","Worcester County County","MA","Westminster",1998,121,3406,3527
"8695","Westminster","Worcester County County","MA","Westminster",1999,138,3439,3577
"8696","Westminster","Worcester County County","MA","Westminster",2000,108,3649,3757
"8697","Westminster","Worcester County County","MA","Westminster",2001,142,3638,3780
"8698","Westminster","Worcester County County","MA","Westminster",2002,233,3636,3869
"8699","Westminster","Worcester County County","MA","Westminster",2003,250,3645,3895
"8700","Westminster","Worcester County County","MA","Westminster",2004,230,3641,3871
"8701","Westminster","Worcester County County","MA","Westminster",2005,222,3635,3857
"8702","Westminster","Worcester County County","MA","Westminster",2006,218,3693,3911
"8703","Westminster","Worcester County County","MA","Westminster",2007,196,3691,3887
"8704","Westminster","Worcester County County","MA","Westminster",2008,226,3643,3869
"8705","Westminster","Worcester County County","MA","Westminster",2009,346,3476,3822
"8706","Westminster","Worcester County County","MA","Westminster",2010,347,3459,3806
"8707","Westminster","Worcester County County","MA","Westminster",2011,305,3457,3762
"8708","Westminster","Worcester County County","MA","Westminster",2012,306,3455,3761
"8709","Weston","Middlesex County County","MA","Weston",1990,128,5076,5204
"8710","Weston","Middlesex County County","MA","Weston",1991,164,4856,5020
"8711","Weston","Middlesex County County","MA","Weston",1992,152,4861,5013
"8712","Weston","Middlesex County County","MA","Weston",1993,134,4907,5041
"8713","Weston","Middlesex County County","MA","Weston",1994,123,5035,5158
"8714","Weston","Middlesex County County","MA","Weston",1995,115,5127,5242
"8715","Weston","Middlesex County County","MA","Weston",1996,94,5240,5334
"8716","Weston","Middlesex County County","MA","Weston",1997,76,5413,5489
"8717","Weston","Middlesex County County","MA","Weston",1998,62,5540,5602
"8718","Weston","Middlesex County County","MA","Weston",1999,62,5610,5672
"8719","Weston","Middlesex County County","MA","Weston",2000,89,5320,5409
"8720","Weston","Middlesex County County","MA","Weston",2001,126,5328,5454
"8721","Weston","Middlesex County County","MA","Weston",2002,190,5256,5446
"8722","Weston","Middlesex County County","MA","Weston",2003,208,5178,5386
"8723","Weston","Middlesex County County","MA","Weston",2004,169,5170,5339
"8724","Weston","Middlesex County County","MA","Weston",2005,149,5218,5367
"8725","Weston","Middlesex County County","MA","Weston",2006,151,5166,5317
"8726","Weston","Middlesex County County","MA","Weston",2007,148,5229,5377
"8727","Weston","Middlesex County County","MA","Weston",2008,174,5240,5414
"8728","Weston","Middlesex County County","MA","Weston",2009,280,5117,5397
"8729","Weston","Middlesex County County","MA","Weston",2010,252,4914,5166
"8730","Weston","Middlesex County County","MA","Weston",2011,216,4984,5200
"8731","Weston","Middlesex County County","MA","Weston",2012,195,5038,5233
"8732","Westport","Bristol County County","MA","Westport",1990,626,7021,7647
"8733","Westport","Bristol County County","MA","Westport",1991,959,6764,7723
"8734","Westport","Bristol County County","MA","Westport",1992,978,6889,7867
"8735","Westport","Bristol County County","MA","Westport",1993,937,7036,7973
"8736","Westport","Bristol County County","MA","Westport",1994,725,7104,7829
"8737","Westport","Bristol County County","MA","Westport",1995,656,7112,7768
"8738","Westport","Bristol County County","MA","Westport",1996,636,7141,7777
"8739","Westport","Bristol County County","MA","Westport",1997,503,7293,7796
"8740","Westport","Bristol County County","MA","Westport",1998,370,7428,7798
"8741","Westport","Bristol County County","MA","Westport",1999,368,7546,7914
"8742","Westport","Bristol County County","MA","Westport",2000,315,7511,7826
"8743","Westport","Bristol County County","MA","Westport",2001,380,7503,7883
"8744","Westport","Bristol County County","MA","Westport",2002,489,7602,8091
"8745","Westport","Bristol County County","MA","Westport",2003,536,7654,8190
"8746","Westport","Bristol County County","MA","Westport",2004,535,7717,8252
"8747","Westport","Bristol County County","MA","Westport",2005,525,7946,8471
"8748","Westport","Bristol County County","MA","Westport",2006,544,8065,8609
"8749","Westport","Bristol County County","MA","Westport",2007,531,8085,8616
"8750","Westport","Bristol County County","MA","Westport",2008,635,8112,8747
"8751","Westport","Bristol County County","MA","Westport",2009,941,7795,8736
"8752","Westport","Bristol County County","MA","Westport",2010,1011,7767,8778
"8753","Westport","Bristol County County","MA","Westport",2011,964,7823,8787
"8754","Westport","Bristol County County","MA","Westport",2012,877,7836,8713
"8755","Westwood","Norfolk County County","MA","Westwood",1990,297,6416,6713
"8756","Westwood","Norfolk County County","MA","Westwood",1991,375,6347,6722
"8757","Westwood","Norfolk County County","MA","Westwood",1992,408,6383,6791
"8758","Westwood","Norfolk County County","MA","Westwood",1993,314,6501,6815
"8759","Westwood","Norfolk County County","MA","Westwood",1994,274,6674,6948
"8760","Westwood","Norfolk County County","MA","Westwood",1995,260,6491,6751
"8761","Westwood","Norfolk County County","MA","Westwood",1996,185,6646,6831
"8762","Westwood","Norfolk County County","MA","Westwood",1997,190,6847,7037
"8763","Westwood","Norfolk County County","MA","Westwood",1998,155,6978,7133
"8764","Westwood","Norfolk County County","MA","Westwood",1999,139,7085,7224
"8765","Westwood","Norfolk County County","MA","Westwood",2000,146,6754,6900
"8766","Westwood","Norfolk County County","MA","Westwood",2001,211,6739,6950
"8767","Westwood","Norfolk County County","MA","Westwood",2002,285,6613,6898
"8768","Westwood","Norfolk County County","MA","Westwood",2003,308,6490,6798
"8769","Westwood","Norfolk County County","MA","Westwood",2004,257,6458,6715
"8770","Westwood","Norfolk County County","MA","Westwood",2005,232,6469,6701
"8771","Westwood","Norfolk County County","MA","Westwood",2006,212,6346,6558
"8772","Westwood","Norfolk County County","MA","Westwood",2007,208,6501,6709
"8773","Westwood","Norfolk County County","MA","Westwood",2008,259,6583,6842
"8774","Westwood","Norfolk County County","MA","Westwood",2009,411,6360,6771
"8775","Westwood","Norfolk County County","MA","Westwood",2010,406,6589,6995
"8776","Westwood","Norfolk County County","MA","Westwood",2011,337,6664,7001
"8777","Westwood","Norfolk County County","MA","Westwood",2012,322,6737,7059
"8778","Weymouth","Norfolk County County","MA","Weymouth",1990,1931,29558,31489
"8779","Weymouth","Norfolk County County","MA","Weymouth",1991,2677,28736,31413
"8780","Weymouth","Norfolk County County","MA","Weymouth",1992,2675,28760,31435
"8781","Weymouth","Norfolk County County","MA","Weymouth",1993,2151,28815,30966
"8782","Weymouth","Norfolk County County","MA","Weymouth",1994,1780,29385,31165
"8783","Weymouth","Norfolk County County","MA","Weymouth",1995,1678,29657,31335
"8784","Weymouth","Norfolk County County","MA","Weymouth",1996,1433,30150,31583
"8785","Weymouth","Norfolk County County","MA","Weymouth",1997,1249,30873,32122
"8786","Weymouth","Norfolk County County","MA","Weymouth",1998,965,31222,32187
"8787","Weymouth","Norfolk County County","MA","Weymouth",1999,916,31354,32270
"8788","Weymouth","Norfolk County County","MA","Weymouth",2000,791,29322,30113
"8789","Weymouth","Norfolk County County","MA","Weymouth",2001,996,29202,30198
"8790","Weymouth","Norfolk County County","MA","Weymouth",2002,1477,28995,30472
"8791","Weymouth","Norfolk County County","MA","Weymouth",2003,1754,28478,30232
"8792","Weymouth","Norfolk County County","MA","Weymouth",2004,1568,28351,29919
"8793","Weymouth","Norfolk County County","MA","Weymouth",2005,1455,28425,29880
"8794","Weymouth","Norfolk County County","MA","Weymouth",2006,1460,27936,29396
"8795","Weymouth","Norfolk County County","MA","Weymouth",2007,1343,28131,29474
"8796","Weymouth","Norfolk County County","MA","Weymouth",2008,1604,28137,29741
"8797","Weymouth","Norfolk County County","MA","Weymouth",2009,2466,27219,29685
"8798","Weymouth","Norfolk County County","MA","Weymouth",2010,2614,27509,30123
"8799","Weymouth","Norfolk County County","MA","Weymouth",2011,2176,27818,29994
"8800","Weymouth","Norfolk County County","MA","Weymouth",2012,1918,28123,30041
"8801","Whately","Franklin County County","MA","Whately",1990,30,797,827
"8802","Whately","Franklin County County","MA","Whately",1991,38,814,852
"8803","Whately","Franklin County County","MA","Whately",1992,35,795,830
"8804","Whately","Franklin County County","MA","Whately",1993,28,795,823
"8805","Whately","Franklin County County","MA","Whately",1994,15,750,765
"8806","Whately","Franklin County County","MA","Whately",1995,19,844,863
"8807","Whately","Franklin County County","MA","Whately",1996,16,854,870
"8808","Whately","Franklin County County","MA","Whately",1997,17,876,893
"8809","Whately","Franklin County County","MA","Whately",1998,11,805,816
"8810","Whately","Franklin County County","MA","Whately",1999,13,825,838
"8811","Whately","Franklin County County","MA","Whately",2000,15,952,967
"8812","Whately","Franklin County County","MA","Whately",2001,19,955,974
"8813","Whately","Franklin County County","MA","Whately",2002,25,955,980
"8814","Whately","Franklin County County","MA","Whately",2003,28,940,968
"8815","Whately","Franklin County County","MA","Whately",2004,32,948,980
"8816","Whately","Franklin County County","MA","Whately",2005,29,951,980
"8817","Whately","Franklin County County","MA","Whately",2006,28,952,980
"8818","Whately","Franklin County County","MA","Whately",2007,25,942,967
"8819","Whately","Franklin County County","MA","Whately",2008,35,941,976
"8820","Whately","Franklin County County","MA","Whately",2009,46,900,946
"8821","Whately","Franklin County County","MA","Whately",2010,40,860,900
"8822","Whately","Franklin County County","MA","Whately",2011,38,853,891
"8823","Whately","Franklin County County","MA","Whately",2012,34,854,888
"8824","Whitman","Plymouth County County","MA","Whitman",1990,501,6668,7169
"8825","Whitman","Plymouth County County","MA","Whitman",1991,783,6411,7194
"8826","Whitman","Plymouth County County","MA","Whitman",1992,796,6325,7121
"8827","Whitman","Plymouth County County","MA","Whitman",1993,607,6531,7138
"8828","Whitman","Plymouth County County","MA","Whitman",1994,450,6866,7316
"8829","Whitman","Plymouth County County","MA","Whitman",1995,402,6986,7388
"8830","Whitman","Plymouth County County","MA","Whitman",1996,395,7078,7473
"8831","Whitman","Plymouth County County","MA","Whitman",1997,303,7350,7653
"8832","Whitman","Plymouth County County","MA","Whitman",1998,256,7499,7755
"8833","Whitman","Plymouth County County","MA","Whitman",1999,242,7708,7950
"8834","Whitman","Plymouth County County","MA","Whitman",2000,197,7829,8026
"8835","Whitman","Plymouth County County","MA","Whitman",2001,270,7898,8168
"8836","Whitman","Plymouth County County","MA","Whitman",2002,387,7816,8203
"8837","Whitman","Plymouth County County","MA","Whitman",2003,461,7640,8101
"8838","Whitman","Plymouth County County","MA","Whitman",2004,416,7618,8034
"8839","Whitman","Plymouth County County","MA","Whitman",2005,404,7689,8093
"8840","Whitman","Plymouth County County","MA","Whitman",2006,430,7800,8230
"8841","Whitman","Plymouth County County","MA","Whitman",2007,404,7866,8270
"8842","Whitman","Plymouth County County","MA","Whitman",2008,466,7845,8311
"8843","Whitman","Plymouth County County","MA","Whitman",2009,730,7445,8175
"8844","Whitman","Plymouth County County","MA","Whitman",2010,706,7594,8300
"8845","Whitman","Plymouth County County","MA","Whitman",2011,655,7667,8322
"8846","Whitman","Plymouth County County","MA","Whitman",2012,573,7734,8307
"8847","Wilbraham","Hampden County County","MA","Wilbraham",1990,293,6423,6716
"8848","Wilbraham","Hampden County County","MA","Wilbraham",1991,399,6126,6525
"8849","Wilbraham","Hampden County County","MA","Wilbraham",1992,371,6155,6526
"8850","Wilbraham","Hampden County County","MA","Wilbraham",1993,396,6163,6559
"8851","Wilbraham","Hampden County County","MA","Wilbraham",1994,331,6182,6513
"8852","Wilbraham","Hampden County County","MA","Wilbraham",1995,280,6154,6434
"8853","Wilbraham","Hampden County County","MA","Wilbraham",1996,226,6237,6463
"8854","Wilbraham","Hampden County County","MA","Wilbraham",1997,197,6388,6585
"8855","Wilbraham","Hampden County County","MA","Wilbraham",1998,189,6471,6660
"8856","Wilbraham","Hampden County County","MA","Wilbraham",1999,155,6525,6680
"8857","Wilbraham","Hampden County County","MA","Wilbraham",2000,171,6543,6714
"8858","Wilbraham","Hampden County County","MA","Wilbraham",2001,203,6621,6824
"8859","Wilbraham","Hampden County County","MA","Wilbraham",2002,265,6602,6867
"8860","Wilbraham","Hampden County County","MA","Wilbraham",2003,313,6582,6895
"8861","Wilbraham","Hampden County County","MA","Wilbraham",2004,301,6616,6917
"8862","Wilbraham","Hampden County County","MA","Wilbraham",2005,285,6673,6958
"8863","Wilbraham","Hampden County County","MA","Wilbraham",2006,305,6738,7043
"8864","Wilbraham","Hampden County County","MA","Wilbraham",2007,275,6751,7026
"8865","Wilbraham","Hampden County County","MA","Wilbraham",2008,320,6661,6981
"8866","Wilbraham","Hampden County County","MA","Wilbraham",2009,474,6442,6916
"8867","Wilbraham","Hampden County County","MA","Wilbraham",2010,480,6488,6968
"8868","Wilbraham","Hampden County County","MA","Wilbraham",2011,437,6423,6860
"8869","Wilbraham","Hampden County County","MA","Wilbraham",2012,396,6427,6823
"8870","Williamsburg","Hampshire County County","MA","Williamsburg",1990,92,1455,1547
"8871","Williamsburg","Hampshire County County","MA","Williamsburg",1991,123,1404,1527
"8872","Williamsburg","Hampshire County County","MA","Williamsburg",1992,141,1397,1538
"8873","Williamsburg","Hampshire County County","MA","Williamsburg",1993,100,1410,1510
"8874","Williamsburg","Hampshire County County","MA","Williamsburg",1994,121,1418,1539
"8875","Williamsburg","Hampshire County County","MA","Williamsburg",1995,95,1449,1544
"8876","Williamsburg","Hampshire County County","MA","Williamsburg",1996,78,1471,1549
"8877","Williamsburg","Hampshire County County","MA","Williamsburg",1997,64,1500,1564
"8878","Williamsburg","Hampshire County County","MA","Williamsburg",1998,57,1551,1608
"8879","Williamsburg","Hampshire County County","MA","Williamsburg",1999,56,1557,1613
"8880","Williamsburg","Hampshire County County","MA","Williamsburg",2000,39,1462,1501
"8881","Williamsburg","Hampshire County County","MA","Williamsburg",2001,48,1454,1502
"8882","Williamsburg","Hampshire County County","MA","Williamsburg",2002,71,1453,1524
"8883","Williamsburg","Hampshire County County","MA","Williamsburg",2003,73,1443,1516
"8884","Williamsburg","Hampshire County County","MA","Williamsburg",2004,65,1441,1506
"8885","Williamsburg","Hampshire County County","MA","Williamsburg",2005,69,1444,1513
"8886","Williamsburg","Hampshire County County","MA","Williamsburg",2006,59,1457,1516
"8887","Williamsburg","Hampshire County County","MA","Williamsburg",2007,57,1462,1519
"8888","Williamsburg","Hampshire County County","MA","Williamsburg",2008,69,1489,1558
"8889","Williamsburg","Hampshire County County","MA","Williamsburg",2009,118,1421,1539
"8890","Williamsburg","Hampshire County County","MA","Williamsburg",2010,122,1410,1532
"8891","Williamsburg","Hampshire County County","MA","Williamsburg",2011,107,1392,1499
"8892","Williamsburg","Hampshire County County","MA","Williamsburg",2012,87,1392,1479
"8893","Williamstown","Berkshire County County","MA","Williamstown",1990,213,3679,3892
"8894","Williamstown","Berkshire County County","MA","Williamstown",1991,265,3532,3797
"8895","Williamstown","Berkshire County County","MA","Williamstown",1992,245,3568,3813
"8896","Williamstown","Berkshire County County","MA","Williamstown",1993,212,3651,3863
"8897","Williamstown","Berkshire County County","MA","Williamstown",1994,172,3676,3848
"8898","Williamstown","Berkshire County County","MA","Williamstown",1995,123,3600,3723
"8899","Williamstown","Berkshire County County","MA","Williamstown",1996,111,3640,3751
"8900","Williamstown","Berkshire County County","MA","Williamstown",1997,115,3675,3790
"8901","Williamstown","Berkshire County County","MA","Williamstown",1998,80,3795,3875
"8902","Williamstown","Berkshire County County","MA","Williamstown",1999,84,3831,3915
"8903","Williamstown","Berkshire County County","MA","Williamstown",2000,102,3857,3959
"8904","Williamstown","Berkshire County County","MA","Williamstown",2001,126,3871,3997
"8905","Williamstown","Berkshire County County","MA","Williamstown",2002,162,3856,4018
"8906","Williamstown","Berkshire County County","MA","Williamstown",2003,165,3816,3981
"8907","Williamstown","Berkshire County County","MA","Williamstown",2004,170,3798,3968
"8908","Williamstown","Berkshire County County","MA","Williamstown",2005,164,3813,3977
"8909","Williamstown","Berkshire County County","MA","Williamstown",2006,159,3847,4006
"8910","Williamstown","Berkshire County County","MA","Williamstown",2007,153,3863,4016
"8911","Williamstown","Berkshire County County","MA","Williamstown",2008,168,3801,3969
"8912","Williamstown","Berkshire County County","MA","Williamstown",2009,259,3747,4006
"8913","Williamstown","Berkshire County County","MA","Williamstown",2010,251,3558,3809
"8914","Williamstown","Berkshire County County","MA","Williamstown",2011,211,3558,3769
"8915","Williamstown","Berkshire County County","MA","Williamstown",2012,194,3512,3706
"8916","Wilmington","Middlesex County County","MA","Wilmington",1990,657,9632,10289
"8917","Wilmington","Middlesex County County","MA","Wilmington",1991,910,9501,10411
"8918","Wilmington","Middlesex County County","MA","Wilmington",1992,1000,9646,10646
"8919","Wilmington","Middlesex County County","MA","Wilmington",1993,726,9888,10614
"8920","Wilmington","Middlesex County County","MA","Wilmington",1994,642,10226,10868
"8921","Wilmington","Middlesex County County","MA","Wilmington",1995,544,10483,11027
"8922","Wilmington","Middlesex County County","MA","Wilmington",1996,505,10867,11372
"8923","Wilmington","Middlesex County County","MA","Wilmington",1997,385,11315,11700
"8924","Wilmington","Middlesex County County","MA","Wilmington",1998,338,11681,12019
"8925","Wilmington","Middlesex County County","MA","Wilmington",1999,320,11884,12204
"8926","Wilmington","Middlesex County County","MA","Wilmington",2000,302,11883,12185
"8927","Wilmington","Middlesex County County","MA","Wilmington",2001,417,11890,12307
"8928","Wilmington","Middlesex County County","MA","Wilmington",2002,611,11701,12312
"8929","Wilmington","Middlesex County County","MA","Wilmington",2003,647,11532,12179
"8930","Wilmington","Middlesex County County","MA","Wilmington",2004,588,11534,12122
"8931","Wilmington","Middlesex County County","MA","Wilmington",2005,505,11604,12109
"8932","Wilmington","Middlesex County County","MA","Wilmington",2006,502,11660,12162
"8933","Wilmington","Middlesex County County","MA","Wilmington",2007,468,11795,12263
"8934","Wilmington","Middlesex County County","MA","Wilmington",2008,565,11820,12385
"8935","Wilmington","Middlesex County County","MA","Wilmington",2009,943,11536,12479
"8936","Wilmington","Middlesex County County","MA","Wilmington",2010,912,11687,12599
"8937","Wilmington","Middlesex County County","MA","Wilmington",2011,769,11858,12627
"8938","Wilmington","Middlesex County County","MA","Wilmington",2012,700,11988,12688
"8939","Winchendon","Worcester County County","MA","Winchendon",1990,352,3997,4349
"8940","Winchendon","Worcester County County","MA","Winchendon",1991,468,3956,4424
"8941","Winchendon","Worcester County County","MA","Winchendon",1992,411,4023,4434
"8942","Winchendon","Worcester County County","MA","Winchendon",1993,287,4129,4416
"8943","Winchendon","Worcester County County","MA","Winchendon",1994,322,4180,4502
"8944","Winchendon","Worcester County County","MA","Winchendon",1995,345,4029,4374
"8945","Winchendon","Worcester County County","MA","Winchendon",1996,256,4011,4267
"8946","Winchendon","Worcester County County","MA","Winchendon",1997,232,4121,4353
"8947","Winchendon","Worcester County County","MA","Winchendon",1998,180,4164,4344
"8948","Winchendon","Worcester County County","MA","Winchendon",1999,174,4213,4387
"8949","Winchendon","Worcester County County","MA","Winchendon",2000,145,4620,4765
"8950","Winchendon","Worcester County County","MA","Winchendon",2001,182,4587,4769
"8951","Winchendon","Worcester County County","MA","Winchendon",2002,320,4593,4913
"8952","Winchendon","Worcester County County","MA","Winchendon",2003,333,4569,4902
"8953","Winchendon","Worcester County County","MA","Winchendon",2004,300,4560,4860
"8954","Winchendon","Worcester County County","MA","Winchendon",2005,313,4540,4853
"8955","Winchendon","Worcester County County","MA","Winchendon",2006,300,4599,4899
"8956","Winchendon","Worcester County County","MA","Winchendon",2007,288,4611,4899
"8957","Winchendon","Worcester County County","MA","Winchendon",2008,352,4564,4916
"8958","Winchendon","Worcester County County","MA","Winchendon",2009,525,4368,4893
"8959","Winchendon","Worcester County County","MA","Winchendon",2010,556,4460,5016
"8960","Winchendon","Worcester County County","MA","Winchendon",2011,509,4458,4967
"8961","Winchendon","Worcester County County","MA","Winchendon",2012,456,4455,4911
"8962","Winchester","Middlesex County County","MA","Winchester",1990,396,10560,10956
"8963","Winchester","Middlesex County County","MA","Winchester",1991,568,10244,10812
"8964","Winchester","Middlesex County County","MA","Winchester",1992,569,10233,10802
"8965","Winchester","Middlesex County County","MA","Winchester",1993,456,10389,10845
"8966","Winchester","Middlesex County County","MA","Winchester",1994,390,10572,10962
"8967","Winchester","Middlesex County County","MA","Winchester",1995,337,10477,10814
"8968","Winchester","Middlesex County County","MA","Winchester",1996,263,10674,10937
"8969","Winchester","Middlesex County County","MA","Winchester",1997,273,10905,11178
"8970","Winchester","Middlesex County County","MA","Winchester",1998,206,11090,11296
"8971","Winchester","Middlesex County County","MA","Winchester",1999,203,11220,11423
"8972","Winchester","Middlesex County County","MA","Winchester",2000,223,10566,10789
"8973","Winchester","Middlesex County County","MA","Winchester",2001,316,10580,10896
"8974","Winchester","Middlesex County County","MA","Winchester",2002,468,10412,10880
"8975","Winchester","Middlesex County County","MA","Winchester",2003,473,10309,10782
"8976","Winchester","Middlesex County County","MA","Winchester",2004,413,10330,10743
"8977","Winchester","Middlesex County County","MA","Winchester",2005,351,10445,10796
"8978","Winchester","Middlesex County County","MA","Winchester",2006,358,10296,10654
"8979","Winchester","Middlesex County County","MA","Winchester",2007,339,10377,10716
"8980","Winchester","Middlesex County County","MA","Winchester",2008,395,10371,10766
"8981","Winchester","Middlesex County County","MA","Winchester",2009,641,10115,10756
"8982","Winchester","Middlesex County County","MA","Winchester",2010,590,10210,10800
"8983","Winchester","Middlesex County County","MA","Winchester",2011,542,10359,10901
"8984","Winchester","Middlesex County County","MA","Winchester",2012,479,10472,10951
"8985","Windsor","Berkshire County County","MA","Windsor",1990,16,397,413
"8986","Windsor","Berkshire County County","MA","Windsor",1991,42,390,432
"8987","Windsor","Berkshire County County","MA","Windsor",1992,25,433,458
"8988","Windsor","Berkshire County County","MA","Windsor",1993,31,459,490
"8989","Windsor","Berkshire County County","MA","Windsor",1994,24,496,520
"8990","Windsor","Berkshire County County","MA","Windsor",1995,20,464,484
"8991","Windsor","Berkshire County County","MA","Windsor",1996,14,449,463
"8992","Windsor","Berkshire County County","MA","Windsor",1997,19,452,471
"8993","Windsor","Berkshire County County","MA","Windsor",1998,14,471,485
"8994","Windsor","Berkshire County County","MA","Windsor",1999,18,509,527
"8995","Windsor","Berkshire County County","MA","Windsor",2000,14,478,492
"8996","Windsor","Berkshire County County","MA","Windsor",2001,12,476,488
"8997","Windsor","Berkshire County County","MA","Windsor",2002,20,481,501
"8998","Windsor","Berkshire County County","MA","Windsor",2003,24,478,502
"8999","Windsor","Berkshire County County","MA","Windsor",2004,22,478,500
"9000","Windsor","Berkshire County County","MA","Windsor",2005,19,488,507
"9001","Windsor","Berkshire County County","MA","Windsor",2006,18,497,515
"9002","Windsor","Berkshire County County","MA","Windsor",2007,18,499,517
"9003","Windsor","Berkshire County County","MA","Windsor",2008,23,489,512
"9004","Windsor","Berkshire County County","MA","Windsor",2009,35,489,524
"9005","Windsor","Berkshire County County","MA","Windsor",2010,40,488,528
"9006","Windsor","Berkshire County County","MA","Windsor",2011,38,492,530
"9007","Windsor","Berkshire County County","MA","Windsor",2012,37,490,527
"9008","Winthrop","Suffolk County County","MA","Winthrop",1990,512,10007,10519
"9009","Winthrop","Suffolk County County","MA","Winthrop",1991,836,9594,10430
"9010","Winthrop","Suffolk County County","MA","Winthrop",1992,765,9547,10312
"9011","Winthrop","Suffolk County County","MA","Winthrop",1993,669,9607,10276
"9012","Winthrop","Suffolk County County","MA","Winthrop",1994,657,9723,10380
"9013","Winthrop","Suffolk County County","MA","Winthrop",1995,539,9510,10049
"9014","Winthrop","Suffolk County County","MA","Winthrop",1996,370,9619,9989
"9015","Winthrop","Suffolk County County","MA","Winthrop",1997,359,9788,10147
"9016","Winthrop","Suffolk County County","MA","Winthrop",1998,279,9962,10241
"9017","Winthrop","Suffolk County County","MA","Winthrop",1999,298,10015,10313
"9018","Winthrop","Suffolk County County","MA","Winthrop",2000,259,9877,10136
"9019","Winthrop","Suffolk County County","MA","Winthrop",2001,347,9836,10183
"9020","Winthrop","Suffolk County County","MA","Winthrop",2002,527,9586,10113
"9021","Winthrop","Suffolk County County","MA","Winthrop",2003,599,9287,9886
"9022","Winthrop","Suffolk County County","MA","Winthrop",2004,505,9069,9574
"9023","Winthrop","Suffolk County County","MA","Winthrop",2005,458,8970,9428
"9024","Winthrop","Suffolk County County","MA","Winthrop",2006,453,9548,10001
"9025","Winthrop","Suffolk County County","MA","Winthrop",2007,430,9731,10161
"9026","Winthrop","Suffolk County County","MA","Winthrop",2008,502,9656,10158
"9027","Winthrop","Suffolk County County","MA","Winthrop",2009,779,9646,10425
"9028","Winthrop","Suffolk County County","MA","Winthrop",2010,781,8906,9687
"9029","Winthrop","Suffolk County County","MA","Winthrop",2011,662,9067,9729
"9030","Winthrop","Suffolk County County","MA","Winthrop",2012,620,9166,9786
"9031","Woburn","Middlesex County County","MA","Woburn",1990,1291,20409,21700
"9032","Woburn","Middlesex County County","MA","Woburn",1991,1847,19934,21781
"9033","Woburn","Middlesex County County","MA","Woburn",1992,1854,19779,21633
"9034","Woburn","Middlesex County County","MA","Woburn",1993,1339,20059,21398
"9035","Woburn","Middlesex County County","MA","Woburn",1994,1271,20239,21510
"9036","Woburn","Middlesex County County","MA","Woburn",1995,1007,20484,21491
"9037","Woburn","Middlesex County County","MA","Woburn",1996,848,20914,21762
"9038","Woburn","Middlesex County County","MA","Woburn",1997,754,21533,22287
"9039","Woburn","Middlesex County County","MA","Woburn",1998,610,22024,22634
"9040","Woburn","Middlesex County County","MA","Woburn",1999,613,22285,22898
"9041","Woburn","Middlesex County County","MA","Woburn",2000,489,20975,21464
"9042","Woburn","Middlesex County County","MA","Woburn",2001,733,20976,21709
"9043","Woburn","Middlesex County County","MA","Woburn",2002,1117,20796,21913
"9044","Woburn","Middlesex County County","MA","Woburn",2003,1185,20410,21595
"9045","Woburn","Middlesex County County","MA","Woburn",2004,1021,20269,21290
"9046","Woburn","Middlesex County County","MA","Woburn",2005,933,20319,21252
"9047","Woburn","Middlesex County County","MA","Woburn",2006,945,20809,21754
"9048","Woburn","Middlesex County County","MA","Woburn",2007,890,20949,21839
"9049","Woburn","Middlesex County County","MA","Woburn",2008,1024,20911,21935
"9050","Woburn","Middlesex County County","MA","Woburn",2009,1716,20347,22063
"9051","Woburn","Middlesex County County","MA","Woburn",2010,1645,20195,21840
"9052","Woburn","Middlesex County County","MA","Woburn",2011,1356,20495,21851
"9053","Woburn","Middlesex County County","MA","Woburn",2012,1268,20720,21988
"9054","Worcester","Worcester County County","MA","Worcester",1990,6164,74802,80966
"9055","Worcester","Worcester County County","MA","Worcester",1991,8433,71439,79872
"9056","Worcester","Worcester County County","MA","Worcester",1992,7518,70763,78281
"9057","Worcester","Worcester County County","MA","Worcester",1993,5818,71979,77797
"9058","Worcester","Worcester County County","MA","Worcester",1994,4439,72850,77289
"9059","Worcester","Worcester County County","MA","Worcester",1995,4107,73269,77376
"9060","Worcester","Worcester County County","MA","Worcester",1996,3538,74077,77615
"9061","Worcester","Worcester County County","MA","Worcester",1997,3307,75699,79006
"9062","Worcester","Worcester County County","MA","Worcester",1998,2943,76865,79808
"9063","Worcester","Worcester County County","MA","Worcester",1999,2985,76208,79193
"9064","Worcester","Worcester County County","MA","Worcester",2000,2564,79653,82217
"9065","Worcester","Worcester County County","MA","Worcester",2001,3708,79428,83136
"9066","Worcester","Worcester County County","MA","Worcester",2002,5168,78882,84050
"9067","Worcester","Worcester County County","MA","Worcester",2003,5643,78444,84087
"9068","Worcester","Worcester County County","MA","Worcester",2004,5094,78352,83446
"9069","Worcester","Worcester County County","MA","Worcester",2005,4797,78076,82873
"9070","Worcester","Worcester County County","MA","Worcester",2006,4726,77958,82684
"9071","Worcester","Worcester County County","MA","Worcester",2007,4460,77543,82003
"9072","Worcester","Worcester County County","MA","Worcester",2008,5394,80007,85401
"9073","Worcester","Worcester County County","MA","Worcester",2009,8068,77511,85579
"9074","Worcester","Worcester County County","MA","Worcester",2010,8293,76921,85214
"9075","Worcester","Worcester County County","MA","Worcester",2011,7561,77590,85151
"9076","Worcester","Worcester County County","MA","Worcester",2012,7073,77564,84637
"9077",NA,"Worcester County County","MA","Worcester County County",1990,25611,339639,365250
"9078",NA,"Worcester County County","MA","Worcester County County",1991,35398,327667,363065
"9079",NA,"Worcester County County","MA","Worcester County County",1992,33051,328778,361829
"9080",NA,"Worcester County County","MA","Worcester County County",1993,26029,336648,362677
"9081",NA,"Worcester County County","MA","Worcester County County",1994,21042,342166,363208
"9082",NA,"Worcester County County","MA","Worcester County County",1995,19467,341643,361110
"9083",NA,"Worcester County County","MA","Worcester County County",1996,16613,346581,363194
"9084",NA,"Worcester County County","MA","Worcester County County",1997,15038,356561,371599
"9085",NA,"Worcester County County","MA","Worcester County County",1998,12974,362521,375495
"9086",NA,"Worcester County County","MA","Worcester County County",1999,12994,363635,376629
"9087",NA,"Worcester County County","MA","Worcester County County",2000,10753,377187,387940
"9088",NA,"Worcester County County","MA","Worcester County County",2001,15150,377842,392992
"9089",NA,"Worcester County County","MA","Worcester County County",2002,22501,376708,399209
"9090",NA,"Worcester County County","MA","Worcester County County",2003,24795,376222,401017
"9091",NA,"Worcester County County","MA","Worcester County County",2004,22384,376786,399170
"9092",NA,"Worcester County County","MA","Worcester County County",2005,20798,377659,398457
"9093",NA,"Worcester County County","MA","Worcester County County",2006,20548,381515,402063
"9094",NA,"Worcester County County","MA","Worcester County County",2007,19891,382018,401909
"9095",NA,"Worcester County County","MA","Worcester County County",2008,23543,380550,404093
"9096",NA,"Worcester County County","MA","Worcester County County",2009,36276,369837,406113
"9097",NA,"Worcester County County","MA","Worcester County County",2010,36788,369399,406187
"9098",NA,"Worcester County County","MA","Worcester County County",2011,32587,371812,404399
"9099",NA,"Worcester County County","MA","Worcester County County",2012,30197,372043,402240
"9100","Worthington","Hampshire County County","MA","Worthington",1990,24,562,586
"9101","Worthington","Hampshire County County","MA","Worthington",1991,44,541,585
"9102","Worthington","Hampshire County County","MA","Worthington",1992,51,609,660
"9103","Worthington","Hampshire County County","MA","Worthington",1993,46,612,658
"9104","Worthington","Hampshire County County","MA","Worthington",1994,39,650,689
"9105","Worthington","Hampshire County County","MA","Worthington",1995,37,682,719
"9106","Worthington","Hampshire County County","MA","Worthington",1996,41,665,706
"9107","Worthington","Hampshire County County","MA","Worthington",1997,34,669,703
"9108","Worthington","Hampshire County County","MA","Worthington",1998,22,703,725
"9109","Worthington","Hampshire County County","MA","Worthington",1999,30,767,797
"9110","Worthington","Hampshire County County","MA","Worthington",2000,18,667,685
"9111","Worthington","Hampshire County County","MA","Worthington",2001,22,672,694
"9112","Worthington","Hampshire County County","MA","Worthington",2002,27,670,697
"9113","Worthington","Hampshire County County","MA","Worthington",2003,32,668,700
"9114","Worthington","Hampshire County County","MA","Worthington",2004,38,666,704
"9115","Worthington","Hampshire County County","MA","Worthington",2005,33,665,698
"9116","Worthington","Hampshire County County","MA","Worthington",2006,38,666,704
"9117","Worthington","Hampshire County County","MA","Worthington",2007,32,661,693
"9118","Worthington","Hampshire County County","MA","Worthington",2008,39,656,695
"9119","Worthington","Hampshire County County","MA","Worthington",2009,50,628,678
"9120","Worthington","Hampshire County County","MA","Worthington",2010,46,570,616
"9121","Worthington","Hampshire County County","MA","Worthington",2011,38,563,601
"9122","Worthington","Hampshire County County","MA","Worthington",2012,45,564,609
"9123","Wrentham","Norfolk County County","MA","Wrentham",1990,252,4430,4682
"9124","Wrentham","Norfolk County County","MA","Wrentham",1991,337,4431,4768
"9125","Wrentham","Norfolk County County","MA","Wrentham",1992,361,4473,4834
"9126","Wrentham","Norfolk County County","MA","Wrentham",1993,311,4609,4920
"9127","Wrentham","Norfolk County County","MA","Wrentham",1994,236,4880,5116
"9128","Wrentham","Norfolk County County","MA","Wrentham",1995,214,4801,5015
"9129","Wrentham","Norfolk County County","MA","Wrentham",1996,208,4942,5150
"9130","Wrentham","Norfolk County County","MA","Wrentham",1997,154,5104,5258
"9131","Wrentham","Norfolk County County","MA","Wrentham",1998,145,5215,5360
"9132","Wrentham","Norfolk County County","MA","Wrentham",1999,158,5336,5494
"9133","Wrentham","Norfolk County County","MA","Wrentham",2000,126,5461,5587
"9134","Wrentham","Norfolk County County","MA","Wrentham",2001,173,5551,5724
"9135","Wrentham","Norfolk County County","MA","Wrentham",2002,261,5508,5769
"9136","Wrentham","Norfolk County County","MA","Wrentham",2003,307,5473,5780
"9137","Wrentham","Norfolk County County","MA","Wrentham",2004,279,5499,5778
"9138","Wrentham","Norfolk County County","MA","Wrentham",2005,248,5559,5807
"9139","Wrentham","Norfolk County County","MA","Wrentham",2006,255,5474,5729
"9140","Wrentham","Norfolk County County","MA","Wrentham",2007,229,5529,5758
"9141","Wrentham","Norfolk County County","MA","Wrentham",2008,289,5541,5830
"9142","Wrentham","Norfolk County County","MA","Wrentham",2009,435,5364,5799
"9143","Wrentham","Norfolk County County","MA","Wrentham",2010,443,5318,5761
"9144","Wrentham","Norfolk County County","MA","Wrentham",2011,386,5375,5761
"9145","Wrentham","Norfolk County County","MA","Wrentham",2012,339,5434,5773
"9146","Yarmouth","Barnstable County County","MA","Yarmouth",1990,676,9369,10045
"9147","Yarmouth","Barnstable County County","MA","Yarmouth",1991,958,9015,9973
"9148","Yarmouth","Barnstable County County","MA","Yarmouth",1992,1097,8891,9988
"9149","Yarmouth","Barnstable County County","MA","Yarmouth",1993,996,9126,10122
"9150","Yarmouth","Barnstable County County","MA","Yarmouth",1994,913,9250,10163
"9151","Yarmouth","Barnstable County County","MA","Yarmouth",1995,780,9610,10390
"9152","Yarmouth","Barnstable County County","MA","Yarmouth",1996,634,9812,10446
"9153","Yarmouth","Barnstable County County","MA","Yarmouth",1997,605,9906,10511
"9154","Yarmouth","Barnstable County County","MA","Yarmouth",1998,520,10041,10561
"9155","Yarmouth","Barnstable County County","MA","Yarmouth",1999,468,10407,10875
"9156","Yarmouth","Barnstable County County","MA","Yarmouth",2000,405,11246,11651
"9157","Yarmouth","Barnstable County County","MA","Yarmouth",2001,478,11317,11795
"9158","Yarmouth","Barnstable County County","MA","Yarmouth",2002,590,11489,12079
"9159","Yarmouth","Barnstable County County","MA","Yarmouth",2003,696,11653,12349
"9160","Yarmouth","Barnstable County County","MA","Yarmouth",2004,657,11714,12371
"9161","Yarmouth","Barnstable County County","MA","Yarmouth",2005,636,11617,12253
"9162","Yarmouth","Barnstable County County","MA","Yarmouth",2006,668,11602,12270
"9163","Yarmouth","Barnstable County County","MA","Yarmouth",2007,651,11504,12155
"9164","Yarmouth","Barnstable County County","MA","Yarmouth",2008,829,11378,12207
"9165","Yarmouth","Barnstable County County","MA","Yarmouth",2009,1186,11094,12280
"9166","Yarmouth","Barnstable County County","MA","Yarmouth",2010,1243,11227,12470
"9167","Yarmouth","Barnstable County County","MA","Yarmouth",2011,1112,11208,12320
"9168","Yarmouth","Barnstable County County","MA","Yarmouth",2012,1003,11396,12399
