,Municipal,County,State,Region,Year,Unemployment Rate Avg,No Unemployed Avg,No Employed Avg,No Labor Avg
38,Abington,Plymouth County,MA,Abington,1990,7.1,553,7229,7782
39,Abington,Plymouth County,MA,Abington,1991,10.5,818,6938,7756
40,Abington,Plymouth County,MA,Abington,1992,9.8,754,6935,7689
41,Abington,Plymouth County,MA,Abington,1993,7.6,589,7164,7753
42,Abington,Plymouth County,MA,Abington,1994,6.2,510,7690,8200
43,Abington,Plymouth County,MA,Abington,1995,5.6,458,7774,8232
44,Abington,Plymouth County,MA,Abington,1996,5,415,7868,8283
45,Abington,Plymouth County,MA,Abington,1997,4.4,371,8110,8481
46,Abington,Plymouth County,MA,Abington,1998,3.6,309,8163,8472
47,Abington,Plymouth County,MA,Abington,1999,3.1,265,8271,8536
48,Abington,Plymouth County,MA,Abington,2000,2.5,209,8207,8416
49,Abington,Plymouth County,MA,Abington,2001,3.1,269,8279,8548
50,Abington,Plymouth County,MA,Abington,2002,4.4,383,8283,8666
51,Abington,Plymouth County,MA,Abington,2003,5.2,464,8515,8979
52,Abington,Plymouth County,MA,Abington,2004,5.1,465,8602,9067
53,Abington,Plymouth County,MA,Abington,2005,4.8,441,8676,9117
54,Abington,Plymouth County,MA,Abington,2006,4.7,436,8803,9239
55,Abington,Plymouth County,MA,Abington,2007,4.6,430,8917,9347
56,Abington,Plymouth County,MA,Abington,2008,5.4,513,9030,9543
57,Abington,Plymouth County,MA,Abington,2009,8.6,821,8778,9599
58,Abington,Plymouth County,MA,Abington,2010,8.9,811,8349,9160
59,Abington,Plymouth County,MA,Abington,2011,7.8,708,8427,9135
60,Abington,Plymouth County,MA,Abington,2012,7,642,8502,9144
61,Acton,Middlesex County,MA,Acton,1990,3.1,322,10147,10469
62,Acton,Middlesex County,MA,Acton,1991,4.5,461,9727,10188
63,Acton,Middlesex County,MA,Acton,1992,5.1,523,9800,10323
64,Acton,Middlesex County,MA,Acton,1993,4.6,481,10056,10537
65,Acton,Middlesex County,MA,Acton,1994,3.7,389,10238,10627
66,Acton,Middlesex County,MA,Acton,1995,3.2,347,10469,10816
67,Acton,Middlesex County,MA,Acton,1996,2.1,230,10782,11012
68,Acton,Middlesex County,MA,Acton,1997,2,230,11118,11348
69,Acton,Middlesex County,MA,Acton,1998,1.7,193,11350,11543
70,Acton,Middlesex County,MA,Acton,1999,1.9,229,11531,11760
71,Acton,Middlesex County,MA,Acton,2000,1.6,185,11454,11639
72,Acton,Middlesex County,MA,Acton,2001,2.9,348,11559,11907
73,Acton,Middlesex County,MA,Acton,2002,4.9,590,11388,11978
74,Acton,Middlesex County,MA,Acton,2003,4.9,573,11213,11786
75,Acton,Middlesex County,MA,Acton,2004,3.7,435,11166,11601
76,Acton,Middlesex County,MA,Acton,2005,3.4,394,11231,11625
77,Acton,Middlesex County,MA,Acton,2006,3.4,388,11112,11500
78,Acton,Middlesex County,MA,Acton,2007,3,350,11255,11605
79,Acton,Middlesex County,MA,Acton,2008,3.5,414,11306,11720
80,Acton,Middlesex County,MA,Acton,2009,5.9,688,11066,11754
81,Acton,Middlesex County,MA,Acton,2010,5.6,683,11598,12281
82,Acton,Middlesex County,MA,Acton,2011,4.7,576,11769,12345
83,Acton,Middlesex County,MA,Acton,2012,4.3,535,11898,12433
84,Acushnet,Bristol County,MA,Acushnet,1990,8.1,426,4859,5285
85,Acushnet,Bristol County,MA,Acushnet,1991,12.1,654,4761,5415
86,Acushnet,Bristol County,MA,Acushnet,1992,10.5,571,4855,5426
87,Acushnet,Bristol County,MA,Acushnet,1993,9.5,523,4975,5498
88,Acushnet,Bristol County,MA,Acushnet,1994,8.9,492,5053,5545
89,Acushnet,Bristol County,MA,Acushnet,1995,8.8,470,4877,5347
90,Acushnet,Bristol County,MA,Acushnet,1996,7.5,395,4876,5271
91,Acushnet,Bristol County,MA,Acushnet,1997,6.4,347,5033,5380
92,Acushnet,Bristol County,MA,Acushnet,1998,5.1,285,5268,5553
93,Acushnet,Bristol County,MA,Acushnet,1999,4.3,241,5390,5631
94,Acushnet,Bristol County,MA,Acushnet,2000,3.4,189,5444,5633
95,Acushnet,Bristol County,MA,Acushnet,2001,4.1,234,5426,5660
96,Acushnet,Bristol County,MA,Acushnet,2002,5.6,325,5514,5839
97,Acushnet,Bristol County,MA,Acushnet,2003,6.4,374,5433,5807
98,Acushnet,Bristol County,MA,Acushnet,2004,5.5,321,5473,5794
99,Acushnet,Bristol County,MA,Acushnet,2005,5.8,341,5543,5884
100,Acushnet,Bristol County,MA,Acushnet,2006,5.7,343,5625,5968
101,Acushnet,Bristol County,MA,Acushnet,2007,5.4,322,5600,5922
102,Acushnet,Bristol County,MA,Acushnet,2008,6.4,373,5414,5787
103,Acushnet,Bristol County,MA,Acushnet,2009,9.9,579,5265,5844
104,Acushnet,Bristol County,MA,Acushnet,2010,10.7,617,5159,5776
105,Acushnet,Bristol County,MA,Acushnet,2011,9.3,533,5212,5745
106,Acushnet,Bristol County,MA,Acushnet,2012,8.2,471,5274,5745
107,Adams,Berkshire County,MA,Adams,1990,9.4,430,4158,4588
108,Adams,Berkshire County,MA,Adams,1991,16.2,761,3941,4702
109,Adams,Berkshire County,MA,Adams,1992,13.9,623,3853,4476
110,Adams,Berkshire County,MA,Adams,1993,12.4,543,3852,4395
111,Adams,Berkshire County,MA,Adams,1994,11.1,469,3763,4232
112,Adams,Berkshire County,MA,Adams,1995,8.2,335,3753,4088
113,Adams,Berkshire County,MA,Adams,1996,7.8,323,3799,4122
114,Adams,Berkshire County,MA,Adams,1997,7.2,295,3813,4108
115,Adams,Berkshire County,MA,Adams,1998,5.9,239,3807,4046
116,Adams,Berkshire County,MA,Adams,1999,5.7,232,3809,4041
117,Adams,Berkshire County,MA,Adams,2000,4,178,4259,4437
118,Adams,Berkshire County,MA,Adams,2001,5.2,233,4264,4497
119,Adams,Berkshire County,MA,Adams,2002,6.8,306,4227,4533
120,Adams,Berkshire County,MA,Adams,2003,7.8,351,4166,4517
121,Adams,Berkshire County,MA,Adams,2004,6.7,297,4125,4422
122,Adams,Berkshire County,MA,Adams,2005,6.1,269,4135,4404
123,Adams,Berkshire County,MA,Adams,2006,6,267,4155,4422
124,Adams,Berkshire County,MA,Adams,2007,6.4,284,4135,4419
125,Adams,Berkshire County,MA,Adams,2008,6.9,310,4181,4491
126,Adams,Berkshire County,MA,Adams,2009,10.2,462,4074,4536
127,Adams,Berkshire County,MA,Adams,2010,10,455,4114,4569
128,Adams,Berkshire County,MA,Adams,2011,9.1,411,4107,4518
129,Adams,Berkshire County,MA,Adams,2012,8.9,394,4053,4447
130,Agawam,Hampden County,MA,Agawam,1990,4.9,744,14394,15138
131,Agawam,Hampden County,MA,Agawam,1991,7.6,1145,13969,15114
132,Agawam,Hampden County,MA,Agawam,1992,8.3,1260,13941,15201
133,Agawam,Hampden County,MA,Agawam,1993,7.4,1116,13913,15029
134,Agawam,Hampden County,MA,Agawam,1994,6.6,984,14016,15000
135,Agawam,Hampden County,MA,Agawam,1995,5.4,781,13670,14451
136,Agawam,Hampden County,MA,Agawam,1996,4.3,617,13845,14462
137,Agawam,Hampden County,MA,Agawam,1997,3.9,582,14190,14772
138,Agawam,Hampden County,MA,Agawam,1998,3.3,490,14242,14732
139,Agawam,Hampden County,MA,Agawam,1999,3,446,14323,14769
140,Agawam,Hampden County,MA,Agawam,2000,2.6,416,15295,15711
141,Agawam,Hampden County,MA,Agawam,2001,3.2,513,15357,15870
142,Agawam,Hampden County,MA,Agawam,2002,4.7,752,15309,16061
143,Agawam,Hampden County,MA,Agawam,2003,5.4,875,15187,16062
144,Agawam,Hampden County,MA,Agawam,2004,4.9,786,15228,16014
145,Agawam,Hampden County,MA,Agawam,2005,4.6,737,15279,16016
146,Agawam,Hampden County,MA,Agawam,2006,4.7,748,15335,16083
147,Agawam,Hampden County,MA,Agawam,2007,4.4,696,15283,15979
148,Agawam,Hampden County,MA,Agawam,2008,5.2,826,15017,15843
149,Agawam,Hampden County,MA,Agawam,2009,7.9,1241,14533,15774
150,Agawam,Hampden County,MA,Agawam,2010,8.1,1282,14546,15828
151,Agawam,Hampden County,MA,Agawam,2011,7,1080,14400,15480
152,Agawam,Hampden County,MA,Agawam,2012,6.4,990,14409,15399
153,Alford,Berkshire County,MA,Alford,1990,2.9,6,199,205
154,Alford,Berkshire County,MA,Alford,1991,3.5,7,192,199
155,Alford,Berkshire County,MA,Alford,1992,3.1,6,188,194
156,Alford,Berkshire County,MA,Alford,1993,4,8,193,201
157,Alford,Berkshire County,MA,Alford,1994,2.5,5,192,197
158,Alford,Berkshire County,MA,Alford,1995,1.4,3,214,217
159,Alford,Berkshire County,MA,Alford,1996,1.8,4,219,223
160,Alford,Berkshire County,MA,Alford,1997,2.6,6,223,229
161,Alford,Berkshire County,MA,Alford,1998,2.2,5,220,225
162,Alford,Berkshire County,MA,Alford,1999,2.3,5,217,222
163,Alford,Berkshire County,MA,Alford,2000,1.9,4,211,215
164,Alford,Berkshire County,MA,Alford,2001,2.2,5,218,223
165,Alford,Berkshire County,MA,Alford,2002,3,7,223,230
166,Alford,Berkshire County,MA,Alford,2003,4.7,11,224,235
167,Alford,Berkshire County,MA,Alford,2004,3.1,7,221,228
168,Alford,Berkshire County,MA,Alford,2005,4.2,10,229,239
169,Alford,Berkshire County,MA,Alford,2006,4.1,10,231,241
170,Alford,Berkshire County,MA,Alford,2007,3.4,8,226,234
171,Alford,Berkshire County,MA,Alford,2008,3.4,8,225,233
172,Alford,Berkshire County,MA,Alford,2009,3.5,8,219,227
173,Alford,Berkshire County,MA,Alford,2010,4.5,13,277,290
174,Alford,Berkshire County,MA,Alford,2011,4.1,12,278,290
175,Alford,Berkshire County,MA,Alford,2012,3.2,9,276,285
176,Amesbury,Essex County,MA,Amesbury,1990,7.1,563,7391,7954
177,Amesbury,Essex County,MA,Amesbury,1991,8.7,674,7107,7781
178,Amesbury,Essex County,MA,Amesbury,1992,8.4,655,7097,7752
179,Amesbury,Essex County,MA,Amesbury,1993,7.5,601,7382,7983
180,Amesbury,Essex County,MA,Amesbury,1994,5.4,442,7712,8154
181,Amesbury,Essex County,MA,Amesbury,1995,4.8,383,7623,8006
182,Amesbury,Essex County,MA,Amesbury,1996,4.3,353,7818,8171
183,Amesbury,Essex County,MA,Amesbury,1997,4,338,8054,8392
184,Amesbury,Essex County,MA,Amesbury,1998,3.4,286,8220,8506
185,Amesbury,Essex County,MA,Amesbury,1999,3.2,274,8339,8613
186,Amesbury,Essex County,MA,Amesbury,2000,2.3,208,8882,9090
187,Amesbury,Essex County,MA,Amesbury,2001,3.5,323,8828,9151
188,Amesbury,Essex County,MA,Amesbury,2002,5.2,471,8566,9037
189,Amesbury,Essex County,MA,Amesbury,2003,5.7,505,8372,8877
190,Amesbury,Essex County,MA,Amesbury,2004,5,438,8279,8717
191,Amesbury,Essex County,MA,Amesbury,2005,4.5,388,8300,8688
192,Amesbury,Essex County,MA,Amesbury,2006,4.7,407,8325,8732
193,Amesbury,Essex County,MA,Amesbury,2007,4.3,373,8280,8653
194,Amesbury,Essex County,MA,Amesbury,2008,5.2,452,8236,8688
195,Amesbury,Essex County,MA,Amesbury,2009,7.9,691,8025,8716
196,Amesbury,Essex County,MA,Amesbury,2010,8.1,706,8016,8722
197,Amesbury,Essex County,MA,Amesbury,2011,6.8,597,8119,8716
198,Amesbury,Essex County,MA,Amesbury,2012,6.1,535,8226,8761
199,Amherst,Hampshire County,MA,Amherst,1990,4.2,752,17229,17981
200,Amherst,Hampshire County,MA,Amherst,1991,4.4,744,16166,16910
201,Amherst,Hampshire County,MA,Amherst,1992,3.2,546,16309,16855
202,Amherst,Hampshire County,MA,Amherst,1993,2.7,455,16674,17129
203,Amherst,Hampshire County,MA,Amherst,1994,2.3,402,16869,17271
204,Amherst,Hampshire County,MA,Amherst,1995,2.2,382,16921,17303
205,Amherst,Hampshire County,MA,Amherst,1996,1.9,324,17187,17511
206,Amherst,Hampshire County,MA,Amherst,1997,1.7,301,17564,17865
207,Amherst,Hampshire County,MA,Amherst,1998,1.6,298,18224,18522
208,Amherst,Hampshire County,MA,Amherst,1999,1.5,279,18309,18588
209,Amherst,Hampshire County,MA,Amherst,2000,1.9,354,17926,18280
210,Amherst,Hampshire County,MA,Amherst,2001,2.2,401,17871,18272
211,Amherst,Hampshire County,MA,Amherst,2002,2.7,498,17884,18382
212,Amherst,Hampshire County,MA,Amherst,2003,3.3,614,18094,18708
213,Amherst,Hampshire County,MA,Amherst,2004,3.3,618,18153,18771
214,Amherst,Hampshire County,MA,Amherst,2005,3.4,639,18087,18726
215,Amherst,Hampshire County,MA,Amherst,2006,3.3,617,18307,18924
216,Amherst,Hampshire County,MA,Amherst,2007,3.1,590,18514,19104
217,Amherst,Hampshire County,MA,Amherst,2008,3.9,745,18538,19283
218,Amherst,Hampshire County,MA,Amherst,2009,5.1,984,18287,19271
219,Amherst,Hampshire County,MA,Amherst,2010,5.5,1077,18640,19717
220,Amherst,Hampshire County,MA,Amherst,2011,4.8,955,18751,19706
221,Amherst,Hampshire County,MA,Amherst,2012,4.5,896,18919,19815
222,Andover,Essex County,MA,Andover,1990,4.5,685,14522,15207
223,Andover,Essex County,MA,Andover,1991,6.5,997,14413,15410
224,Andover,Essex County,MA,Andover,1992,6.3,997,14787,15784
225,Andover,Essex County,MA,Andover,1993,5.1,823,15162,15985
226,Andover,Essex County,MA,Andover,1994,4.9,807,15630,16437
227,Andover,Essex County,MA,Andover,1995,3.8,612,15600,16212
228,Andover,Essex County,MA,Andover,1996,3.2,527,16036,16563
229,Andover,Essex County,MA,Andover,1997,3.1,520,16204,16724
230,Andover,Essex County,MA,Andover,1998,2.4,414,16681,17095
231,Andover,Essex County,MA,Andover,1999,2.5,437,17038,17475
232,Andover,Essex County,MA,Andover,2000,2.1,337,16032,16369
233,Andover,Essex County,MA,Andover,2001,3.1,521,16138,16659
234,Andover,Essex County,MA,Andover,2002,5.1,862,15949,16811
235,Andover,Essex County,MA,Andover,2003,5.2,865,15755,16620
236,Andover,Essex County,MA,Andover,2004,4.5,740,15825,16565
237,Andover,Essex County,MA,Andover,2005,4,672,16088,16760
238,Andover,Essex County,MA,Andover,2006,4.1,691,16039,16730
239,Andover,Essex County,MA,Andover,2007,4.1,692,16100,16792
240,Andover,Essex County,MA,Andover,2008,4.1,697,16144,16841
241,Andover,Essex County,MA,Andover,2009,6.7,1119,15655,16774
242,Andover,Essex County,MA,Andover,2010,6.4,1066,15657,16723
243,Andover,Essex County,MA,Andover,2011,5.7,952,15845,16797
244,Andover,Essex County,MA,Andover,2012,4.9,834,16018,16852
245,Aquinnah,Dukes County,MA,Aquinnah,1990,8.8,8,83,91
246,Aquinnah,Dukes County,MA,Aquinnah,1991,20.6,21,81,102
247,Aquinnah,Dukes County,MA,Aquinnah,1992,17.4,16,76,92
248,Aquinnah,Dukes County,MA,Aquinnah,1993,17.6,18,84,102
249,Aquinnah,Dukes County,MA,Aquinnah,1994,11.3,12,94,106
250,Aquinnah,Dukes County,MA,Aquinnah,1995,10.1,11,98,109
251,Aquinnah,Dukes County,MA,Aquinnah,1996,12,14,103,117
252,Aquinnah,Dukes County,MA,Aquinnah,1997,13.7,17,107,124
253,Aquinnah,Dukes County,MA,Aquinnah,1998,8.1,9,102,111
254,Aquinnah,Dukes County,MA,Aquinnah,1999,7.1,8,105,113
255,Aquinnah,Dukes County,MA,Aquinnah,2000,2.2,5,225,230
256,Aquinnah,Dukes County,MA,Aquinnah,2001,2.6,6,225,231
257,Aquinnah,Dukes County,MA,Aquinnah,2002,4.1,10,235,245
258,Aquinnah,Dukes County,MA,Aquinnah,2003,6.6,17,242,259
259,Aquinnah,Dukes County,MA,Aquinnah,2004,5.4,14,245,259
260,Aquinnah,Dukes County,MA,Aquinnah,2005,5.1,13,240,253
261,Aquinnah,Dukes County,MA,Aquinnah,2006,4.7,12,242,254
262,Aquinnah,Dukes County,MA,Aquinnah,2007,3.9,10,246,256
263,Aquinnah,Dukes County,MA,Aquinnah,2008,5,13,248,261
264,Aquinnah,Dukes County,MA,Aquinnah,2009,4.7,12,246,258
265,Aquinnah,Dukes County,MA,Aquinnah,2010,5.6,12,202,214
266,Aquinnah,Dukes County,MA,Aquinnah,2011,7.7,17,203,220
267,Aquinnah,Dukes County,MA,Aquinnah,2012,4.2,9,205,214
268,Arlington,Middlesex County,MA,Arlington,1990,3.8,989,25245,26234
269,Arlington,Middlesex County,MA,Arlington,1991,5.2,1316,24087,25403
270,Arlington,Middlesex County,MA,Arlington,1992,5.6,1413,23857,25270
271,Arlington,Middlesex County,MA,Arlington,1993,4.9,1220,23929,25149
272,Arlington,Middlesex County,MA,Arlington,1994,3.9,981,24239,25220
273,Arlington,Middlesex County,MA,Arlington,1995,3.5,885,24496,25381
274,Arlington,Middlesex County,MA,Arlington,1996,2.6,671,24895,25566
275,Arlington,Middlesex County,MA,Arlington,1997,2.4,621,25406,26027
276,Arlington,Middlesex County,MA,Arlington,1998,1.9,504,25672,26176
277,Arlington,Middlesex County,MA,Arlington,1999,1.9,499,25752,26251
278,Arlington,Middlesex County,MA,Arlington,2000,2,508,24778,25286
279,Arlington,Middlesex County,MA,Arlington,2001,3,762,24594,25356
280,Arlington,Middlesex County,MA,Arlington,2002,4.7,1181,23996,25177
281,Arlington,Middlesex County,MA,Arlington,2003,4.8,1193,23524,24717
282,Arlington,Middlesex County,MA,Arlington,2004,3.8,930,23393,24323
283,Arlington,Middlesex County,MA,Arlington,2005,3.5,850,23457,24307
284,Arlington,Middlesex County,MA,Arlington,2006,3.3,791,23094,23885
285,Arlington,Middlesex County,MA,Arlington,2007,3.1,756,23264,24020
286,Arlington,Middlesex County,MA,Arlington,2008,3.7,901,23244,24145
287,Arlington,Middlesex County,MA,Arlington,2009,6.1,1462,22652,24114
288,Arlington,Middlesex County,MA,Arlington,2010,5.7,1420,23613,25033
289,Arlington,Middlesex County,MA,Arlington,2011,4.7,1173,23961,25134
290,Arlington,Middlesex County,MA,Arlington,2012,4.2,1067,24224,25291
291,Ashburnham,Worcester County,MA,Ashburnham,1990,8.6,255,2705,2960
292,Ashburnham,Worcester County,MA,Ashburnham,1991,10.5,316,2699,3015
293,Ashburnham,Worcester County,MA,Ashburnham,1992,8.6,256,2731,2987
294,Ashburnham,Worcester County,MA,Ashburnham,1993,6.9,211,2863,3074
295,Ashburnham,Worcester County,MA,Ashburnham,1994,6.2,188,2860,3048
296,Ashburnham,Worcester County,MA,Ashburnham,1995,6.2,177,2694,2871
297,Ashburnham,Worcester County,MA,Ashburnham,1996,5.7,164,2701,2865
298,Ashburnham,Worcester County,MA,Ashburnham,1997,5.2,152,2768,2920
299,Ashburnham,Worcester County,MA,Ashburnham,1998,3.6,105,2775,2880
300,Ashburnham,Worcester County,MA,Ashburnham,1999,3.8,110,2790,2900
301,Ashburnham,Worcester County,MA,Ashburnham,2000,2.7,82,2940,3022
302,Ashburnham,Worcester County,MA,Ashburnham,2001,4.1,126,2934,3060
303,Ashburnham,Worcester County,MA,Ashburnham,2002,5.9,183,2931,3114
304,Ashburnham,Worcester County,MA,Ashburnham,2003,6.4,200,2947,3147
305,Ashburnham,Worcester County,MA,Ashburnham,2004,6.3,198,2952,3150
306,Ashburnham,Worcester County,MA,Ashburnham,2005,5.7,179,2959,3138
307,Ashburnham,Worcester County,MA,Ashburnham,2006,5.7,180,2993,3173
308,Ashburnham,Worcester County,MA,Ashburnham,2007,5.4,172,2987,3159
309,Ashburnham,Worcester County,MA,Ashburnham,2008,6.2,195,2954,3149
310,Ashburnham,Worcester County,MA,Ashburnham,2009,9.3,291,2830,3121
311,Ashburnham,Worcester County,MA,Ashburnham,2010,9.5,305,2899,3204
312,Ashburnham,Worcester County,MA,Ashburnham,2011,8.8,279,2898,3177
313,Ashburnham,Worcester County,MA,Ashburnham,2012,7.6,239,2896,3135
314,Ashby,Middlesex County,MA,Ashby,1990,6.7,103,1425,1528
315,Ashby,Middlesex County,MA,Ashby,1991,9.9,156,1415,1571
316,Ashby,Middlesex County,MA,Ashby,1992,7.8,124,1458,1582
317,Ashby,Middlesex County,MA,Ashby,1993,4.8,76,1507,1583
318,Ashby,Middlesex County,MA,Ashby,1994,5,82,1557,1639
319,Ashby,Middlesex County,MA,Ashby,1995,4.8,75,1502,1577
320,Ashby,Middlesex County,MA,Ashby,1996,5.3,84,1516,1600
321,Ashby,Middlesex County,MA,Ashby,1997,4.3,70,1558,1628
322,Ashby,Middlesex County,MA,Ashby,1998,3.4,55,1564,1619
323,Ashby,Middlesex County,MA,Ashby,1999,4,65,1571,1636
324,Ashby,Middlesex County,MA,Ashby,2000,2.6,41,1552,1593
325,Ashby,Middlesex County,MA,Ashby,2001,3.5,56,1537,1593
326,Ashby,Middlesex County,MA,Ashby,2002,5.5,88,1521,1609
327,Ashby,Middlesex County,MA,Ashby,2003,6.1,99,1513,1612
328,Ashby,Middlesex County,MA,Ashby,2004,6,96,1509,1605
329,Ashby,Middlesex County,MA,Ashby,2005,5.4,85,1494,1579
330,Ashby,Middlesex County,MA,Ashby,2006,5.5,88,1514,1602
331,Ashby,Middlesex County,MA,Ashby,2007,5.1,81,1522,1603
332,Ashby,Middlesex County,MA,Ashby,2008,5.9,94,1492,1586
333,Ashby,Middlesex County,MA,Ashby,2009,9.4,156,1502,1658
334,Ashby,Middlesex County,MA,Ashby,2010,9.2,154,1511,1665
335,Ashby,Middlesex County,MA,Ashby,2011,8.2,135,1520,1655
336,Ashby,Middlesex County,MA,Ashby,2012,8.2,135,1519,1654
337,Ashfield,Franklin County,MA,Ashfield,1990,5.1,52,963,1015
338,Ashfield,Franklin County,MA,Ashfield,1991,7,72,955,1027
339,Ashfield,Franklin County,MA,Ashfield,1992,6,58,911,969
340,Ashfield,Franklin County,MA,Ashfield,1993,4.8,47,938,985
341,Ashfield,Franklin County,MA,Ashfield,1994,4.3,43,965,1008
342,Ashfield,Franklin County,MA,Ashfield,1995,3.4,34,979,1013
343,Ashfield,Franklin County,MA,Ashfield,1996,3.8,39,984,1023
344,Ashfield,Franklin County,MA,Ashfield,1997,3.3,34,1004,1038
345,Ashfield,Franklin County,MA,Ashfield,1998,2.4,25,1024,1049
346,Ashfield,Franklin County,MA,Ashfield,1999,2.2,23,1042,1065
347,Ashfield,Franklin County,MA,Ashfield,2000,2,22,1080,1102
348,Ashfield,Franklin County,MA,Ashfield,2001,2.4,26,1080,1106
349,Ashfield,Franklin County,MA,Ashfield,2002,3.3,37,1079,1116
350,Ashfield,Franklin County,MA,Ashfield,2003,3.9,43,1070,1113
351,Ashfield,Franklin County,MA,Ashfield,2004,3.6,40,1072,1112
352,Ashfield,Franklin County,MA,Ashfield,2005,3.1,35,1079,1114
353,Ashfield,Franklin County,MA,Ashfield,2006,3.7,42,1084,1126
354,Ashfield,Franklin County,MA,Ashfield,2007,3.6,41,1083,1124
355,Ashfield,Franklin County,MA,Ashfield,2008,3.8,43,1077,1120
356,Ashfield,Franklin County,MA,Ashfield,2009,5.6,61,1029,1090
357,Ashfield,Franklin County,MA,Ashfield,2010,6.2,65,983,1048
358,Ashfield,Franklin County,MA,Ashfield,2011,4.8,49,975,1024
359,Ashfield,Franklin County,MA,Ashfield,2012,4.6,47,976,1023
360,Ashland,Middlesex County,MA,Ashland,1990,5.3,399,7188,7587
361,Ashland,Middlesex County,MA,Ashland,1991,7.5,572,7011,7583
362,Ashland,Middlesex County,MA,Ashland,1992,7.6,575,7029,7604
363,Ashland,Middlesex County,MA,Ashland,1993,6.1,468,7232,7700
364,Ashland,Middlesex County,MA,Ashland,1994,4.9,385,7505,7890
365,Ashland,Middlesex County,MA,Ashland,1995,4.2,324,7477,7801
366,Ashland,Middlesex County,MA,Ashland,1996,3.5,280,7734,8014
367,Ashland,Middlesex County,MA,Ashland,1997,2.9,240,8051,8291
368,Ashland,Middlesex County,MA,Ashland,1998,2.4,204,8371,8575
369,Ashland,Middlesex County,MA,Ashland,1999,2.4,215,8630,8845
370,Ashland,Middlesex County,MA,Ashland,2000,2.2,193,8659,8852
371,Ashland,Middlesex County,MA,Ashland,2001,3.1,281,8864,9145
372,Ashland,Middlesex County,MA,Ashland,2002,4.9,454,8763,9217
373,Ashland,Middlesex County,MA,Ashland,2003,5,455,8659,9114
374,Ashland,Middlesex County,MA,Ashland,2004,4.2,382,8762,9144
375,Ashland,Middlesex County,MA,Ashland,2005,3.7,343,8914,9257
376,Ashland,Middlesex County,MA,Ashland,2006,3.6,341,9039,9380
377,Ashland,Middlesex County,MA,Ashland,2007,3.4,325,9218,9543
378,Ashland,Middlesex County,MA,Ashland,2008,4.1,396,9309,9705
379,Ashland,Middlesex County,MA,Ashland,2009,6.9,638,8638,9276
380,Ashland,Middlesex County,MA,Ashland,2010,6,587,9223,9810
381,Ashland,Middlesex County,MA,Ashland,2011,5,491,9315,9806
382,Ashland,Middlesex County,MA,Ashland,2012,4.8,471,9400,9871
383,Athol,Worcester County,MA,Athol,1990,10.1,531,4734,5265
384,Athol,Worcester County,MA,Athol,1991,14.6,765,4475,5240
385,Athol,Worcester County,MA,Athol,1992,14,723,4441,5164
386,Athol,Worcester County,MA,Athol,1993,10.5,542,4610,5152
387,Athol,Worcester County,MA,Athol,1994,8.9,445,4544,4989
388,Athol,Worcester County,MA,Athol,1995,7.9,372,4331,4703
389,Athol,Worcester County,MA,Athol,1996,7.1,326,4271,4597
390,Athol,Worcester County,MA,Athol,1997,7,328,4345,4673
391,Athol,Worcester County,MA,Athol,1998,5.7,265,4387,4652
392,Athol,Worcester County,MA,Athol,1999,5.4,251,4368,4619
393,Athol,Worcester County,MA,Athol,2000,3.1,170,5239,5409
394,Athol,Worcester County,MA,Athol,2001,4.6,248,5150,5398
395,Athol,Worcester County,MA,Athol,2002,6,331,5165,5496
396,Athol,Worcester County,MA,Athol,2003,7.1,391,5125,5516
397,Athol,Worcester County,MA,Athol,2004,6.6,360,5061,5421
398,Athol,Worcester County,MA,Athol,2005,6.1,326,5022,5348
399,Athol,Worcester County,MA,Athol,2006,6.2,327,4982,5309
400,Athol,Worcester County,MA,Athol,2007,6.6,349,4931,5280
401,Athol,Worcester County,MA,Athol,2008,7.2,386,4973,5359
402,Athol,Worcester County,MA,Athol,2009,11,605,4880,5485
403,Athol,Worcester County,MA,Athol,2010,11.5,614,4720,5334
404,Athol,Worcester County,MA,Athol,2011,10.1,528,4711,5239
405,Athol,Worcester County,MA,Athol,2012,9.2,478,4727,5205
406,Attleboro,Bristol County,MA,Attleboro,1990,7.7,1656,19919,21575
407,Attleboro,Bristol County,MA,Attleboro,1991,11.5,2485,19164,21649
408,Attleboro,Bristol County,MA,Attleboro,1992,10.9,2365,19259,21624
409,Attleboro,Bristol County,MA,Attleboro,1993,8.3,1788,19685,21473
410,Attleboro,Bristol County,MA,Attleboro,1994,7.5,1616,20056,21672
411,Attleboro,Bristol County,MA,Attleboro,1995,6.9,1509,20279,21788
412,Attleboro,Bristol County,MA,Attleboro,1996,5.8,1255,20441,21696
413,Attleboro,Bristol County,MA,Attleboro,1997,5.2,1146,20910,22056
414,Attleboro,Bristol County,MA,Attleboro,1998,3.9,868,21292,22160
415,Attleboro,Bristol County,MA,Attleboro,1999,3.5,781,21560,22341
416,Attleboro,Bristol County,MA,Attleboro,2000,3.3,773,22870,23643
417,Attleboro,Bristol County,MA,Attleboro,2001,4.6,1099,22824,23923
418,Attleboro,Bristol County,MA,Attleboro,2002,6,1468,23113,24581
419,Attleboro,Bristol County,MA,Attleboro,2003,5.9,1454,23339,24793
420,Attleboro,Bristol County,MA,Attleboro,2004,5.7,1406,23394,24800
421,Attleboro,Bristol County,MA,Attleboro,2005,5.4,1328,23491,24819
422,Attleboro,Bristol County,MA,Attleboro,2006,5.2,1290,23682,24972
423,Attleboro,Bristol County,MA,Attleboro,2007,4.9,1220,23649,24869
424,Attleboro,Bristol County,MA,Attleboro,2008,6.4,1588,23145,24733
425,Attleboro,Bristol County,MA,Attleboro,2009,10.4,2605,22453,25058
426,Attleboro,Bristol County,MA,Attleboro,2010,10.1,2515,22387,24902
427,Attleboro,Bristol County,MA,Attleboro,2011,9.3,2309,22551,24860
428,Attleboro,Bristol County,MA,Attleboro,2012,8.9,2220,22586,24806
429,Auburn,Worcester County,MA,Auburn,1990,6.9,591,7929,8520
430,Auburn,Worcester County,MA,Auburn,1991,8.7,737,7718,8455
431,Auburn,Worcester County,MA,Auburn,1992,7.8,655,7696,8351
432,Auburn,Worcester County,MA,Auburn,1993,6,497,7848,8345
433,Auburn,Worcester County,MA,Auburn,1994,4.7,395,8017,8412
434,Auburn,Worcester County,MA,Auburn,1995,4.4,359,7879,8238
435,Auburn,Worcester County,MA,Auburn,1996,3.6,294,7986,8280
436,Auburn,Worcester County,MA,Auburn,1997,3.1,262,8258,8520
437,Auburn,Worcester County,MA,Auburn,1998,2.6,227,8558,8785
438,Auburn,Worcester County,MA,Auburn,1999,2.5,220,8628,8848
439,Auburn,Worcester County,MA,Auburn,2000,2.5,220,8484,8704
440,Auburn,Worcester County,MA,Auburn,2001,3,260,8497,8757
441,Auburn,Worcester County,MA,Auburn,2002,4.8,429,8459,8888
442,Auburn,Worcester County,MA,Auburn,2003,5.4,481,8443,8924
443,Auburn,Worcester County,MA,Auburn,2004,4.7,413,8427,8840
444,Auburn,Worcester County,MA,Auburn,2005,4.3,381,8411,8792
445,Auburn,Worcester County,MA,Auburn,2006,4.1,363,8454,8817
446,Auburn,Worcester County,MA,Auburn,2007,4.3,384,8456,8840
447,Auburn,Worcester County,MA,Auburn,2008,4.9,428,8289,8717
448,Auburn,Worcester County,MA,Auburn,2009,8,698,8058,8756
449,Auburn,Worcester County,MA,Auburn,2010,8.2,713,7947,8660
450,Auburn,Worcester County,MA,Auburn,2011,7,602,8017,8619
451,Auburn,Worcester County,MA,Auburn,2012,6.9,593,8015,8608
452,Avon,Norfolk County,MA,Avon,1990,7.4,187,2344,2531
453,Avon,Norfolk County,MA,Avon,1991,12.2,311,2247,2558
454,Avon,Norfolk County,MA,Avon,1992,11.2,280,2220,2500
455,Avon,Norfolk County,MA,Avon,1993,8.2,202,2271,2473
456,Avon,Norfolk County,MA,Avon,1994,7.6,194,2343,2537
457,Avon,Norfolk County,MA,Avon,1995,6.3,163,2425,2588
458,Avon,Norfolk County,MA,Avon,1996,6,154,2433,2587
459,Avon,Norfolk County,MA,Avon,1997,4.8,126,2491,2617
460,Avon,Norfolk County,MA,Avon,1998,3.8,98,2497,2595
461,Avon,Norfolk County,MA,Avon,1999,3.4,88,2509,2597
462,Avon,Norfolk County,MA,Avon,2000,2.9,68,2302,2370
463,Avon,Norfolk County,MA,Avon,2001,3.5,82,2281,2363
464,Avon,Norfolk County,MA,Avon,2002,5.3,126,2232,2358
465,Avon,Norfolk County,MA,Avon,2003,6.3,146,2165,2311
466,Avon,Norfolk County,MA,Avon,2004,5.9,134,2148,2282
467,Avon,Norfolk County,MA,Avon,2005,5.6,126,2133,2259
468,Avon,Norfolk County,MA,Avon,2006,5.4,124,2154,2278
469,Avon,Norfolk County,MA,Avon,2007,5.2,118,2172,2290
470,Avon,Norfolk County,MA,Avon,2008,6.1,139,2155,2294
471,Avon,Norfolk County,MA,Avon,2009,9.8,229,2119,2348
472,Avon,Norfolk County,MA,Avon,2010,9.1,212,2107,2319
473,Avon,Norfolk County,MA,Avon,2011,7.8,180,2131,2311
474,Avon,Norfolk County,MA,Avon,2012,7,162,2149,2311
475,Ayer,Middlesex County,MA,Ayer,1990,6.8,241,3325,3566
476,Ayer,Middlesex County,MA,Ayer,1991,9.4,338,3249,3587
477,Ayer,Middlesex County,MA,Ayer,1992,9.1,325,3243,3568
478,Ayer,Middlesex County,MA,Ayer,1993,8.3,300,3295,3595
479,Ayer,Middlesex County,MA,Ayer,1994,7.5,273,3367,3640
480,Ayer,Middlesex County,MA,Ayer,1995,6.1,227,3480,3707
481,Ayer,Middlesex County,MA,Ayer,1996,4.6,174,3587,3761
482,Ayer,Middlesex County,MA,Ayer,1997,3.5,133,3706,3839
483,Ayer,Middlesex County,MA,Ayer,1998,3.2,126,3761,3887
484,Ayer,Middlesex County,MA,Ayer,1999,3.3,133,3856,3989
485,Ayer,Middlesex County,MA,Ayer,2000,2.4,99,4090,4189
486,Ayer,Middlesex County,MA,Ayer,2001,3.8,163,4083,4246
487,Ayer,Middlesex County,MA,Ayer,2002,5.6,237,3993,4230
488,Ayer,Middlesex County,MA,Ayer,2003,6.2,260,3913,4173
489,Ayer,Middlesex County,MA,Ayer,2004,5.3,216,3895,4111
490,Ayer,Middlesex County,MA,Ayer,2005,5.1,213,3945,4158
491,Ayer,Middlesex County,MA,Ayer,2006,4.5,190,4018,4208
492,Ayer,Middlesex County,MA,Ayer,2007,4.3,188,4140,4328
493,Ayer,Middlesex County,MA,Ayer,2008,5.2,227,4174,4401
494,Ayer,Middlesex County,MA,Ayer,2009,7.9,349,4091,4440
495,Ayer,Middlesex County,MA,Ayer,2010,8.2,352,3926,4278
496,Ayer,Middlesex County,MA,Ayer,2011,7.3,312,3982,4294
497,Ayer,Middlesex County,MA,Ayer,2012,6.4,277,4026,4303
498,Barnstable,Barnstable County,MA,Barnstable,1990,9,2023,20340,22363
499,Barnstable,Barnstable County,MA,Barnstable,1991,10.9,2390,19553,21943
500,Barnstable,Barnstable County,MA,Barnstable,1992,10.5,2268,19351,21619
501,Barnstable,Barnstable County,MA,Barnstable,1993,9,1965,19866,21831
502,Barnstable,Barnstable County,MA,Barnstable,1994,8,1761,20265,22026
503,Barnstable,Barnstable County,MA,Barnstable,1995,6.2,1378,20986,22364
504,Barnstable,Barnstable County,MA,Barnstable,1996,5.5,1255,21461,22716
505,Barnstable,Barnstable County,MA,Barnstable,1997,5,1164,21887,23051
506,Barnstable,Barnstable County,MA,Barnstable,1998,4,942,22396,23338
507,Barnstable,Barnstable County,MA,Barnstable,1999,3.6,857,23212,24069
508,Barnstable,Barnstable County,MA,Barnstable,2000,3,762,24628,25390
509,Barnstable,Barnstable County,MA,Barnstable,2001,3.4,873,24817,25690
510,Barnstable,Barnstable County,MA,Barnstable,2002,4.2,1115,25248,26363
511,Barnstable,Barnstable County,MA,Barnstable,2003,4.7,1265,25677,26942
512,Barnstable,Barnstable County,MA,Barnstable,2004,4.5,1217,25854,27071
513,Barnstable,Barnstable County,MA,Barnstable,2005,4.5,1204,25626,26830
514,Barnstable,Barnstable County,MA,Barnstable,2006,4.4,1190,25631,26821
515,Barnstable,Barnstable County,MA,Barnstable,2007,4.2,1125,25430,26555
516,Barnstable,Barnstable County,MA,Barnstable,2008,5.2,1370,25098,26468
517,Barnstable,Barnstable County,MA,Barnstable,2009,7.8,2070,24449,26519
518,Barnstable,Barnstable County,MA,Barnstable,2010,8.1,2126,24215,26341
519,Barnstable,Barnstable County,MA,Barnstable,2011,7.3,1907,24174,26081
520,Barnstable,Barnstable County,MA,Barnstable,2012,6.6,1748,24579,26327
544,Barre,Worcester County,MA,Barre,1990,8.4,197,2137,2334
545,Barre,Worcester County,MA,Barre,1991,11.3,267,2086,2353
546,Barre,Worcester County,MA,Barre,1992,11.6,277,2121,2398
547,Barre,Worcester County,MA,Barre,1993,8.8,213,2202,2415
548,Barre,Worcester County,MA,Barre,1994,6.9,164,2229,2393
549,Barre,Worcester County,MA,Barre,1995,5.5,129,2203,2332
550,Barre,Worcester County,MA,Barre,1996,4.3,100,2251,2351
551,Barre,Worcester County,MA,Barre,1997,4.8,117,2325,2442
552,Barre,Worcester County,MA,Barre,1998,4.3,107,2389,2496
553,Barre,Worcester County,MA,Barre,1999,3.6,90,2388,2478
554,Barre,Worcester County,MA,Barre,2000,3.1,81,2566,2647
555,Barre,Worcester County,MA,Barre,2001,4,109,2588,2697
556,Barre,Worcester County,MA,Barre,2002,5.8,160,2585,2745
557,Barre,Worcester County,MA,Barre,2003,6.3,174,2587,2761
558,Barre,Worcester County,MA,Barre,2004,6.2,171,2587,2758
559,Barre,Worcester County,MA,Barre,2005,5.5,152,2590,2742
560,Barre,Worcester County,MA,Barre,2006,5.3,150,2694,2844
561,Barre,Worcester County,MA,Barre,2007,5.4,154,2708,2862
562,Barre,Worcester County,MA,Barre,2008,6.5,184,2649,2833
563,Barre,Worcester County,MA,Barre,2009,9.5,271,2578,2849
564,Barre,Worcester County,MA,Barre,2010,10.1,279,2487,2766
565,Barre,Worcester County,MA,Barre,2011,8.7,240,2509,2749
566,Barre,Worcester County,MA,Barre,2012,8.3,227,2508,2735
567,Becket,Berkshire County,MA,Becket,1990,5.7,43,715,758
568,Becket,Berkshire County,MA,Becket,1991,9.5,73,696,769
569,Becket,Berkshire County,MA,Becket,1992,7.3,60,764,824
570,Becket,Berkshire County,MA,Becket,1993,5.4,45,784,829
571,Becket,Berkshire County,MA,Becket,1994,5.2,47,863,910
572,Becket,Berkshire County,MA,Becket,1995,5.3,47,848,895
573,Becket,Berkshire County,MA,Becket,1996,4.1,35,825,860
574,Becket,Berkshire County,MA,Becket,1997,5.7,50,832,882
575,Becket,Berkshire County,MA,Becket,1998,3.9,36,878,914
576,Becket,Berkshire County,MA,Becket,1999,2.8,27,949,976
577,Becket,Berkshire County,MA,Becket,2000,2.4,22,907,929
578,Becket,Berkshire County,MA,Becket,2001,2.7,25,906,931
579,Becket,Berkshire County,MA,Becket,2002,3.1,30,923,953
580,Becket,Berkshire County,MA,Becket,2003,4.2,41,928,969
581,Becket,Berkshire County,MA,Becket,2004,3.9,38,937,975
582,Becket,Berkshire County,MA,Becket,2005,4.1,41,959,1000
583,Becket,Berkshire County,MA,Becket,2006,4.4,46,988,1034
584,Becket,Berkshire County,MA,Becket,2007,4.7,49,990,1039
585,Becket,Berkshire County,MA,Becket,2008,5.8,61,985,1046
586,Becket,Berkshire County,MA,Becket,2009,9.1,96,958,1054
587,Becket,Berkshire County,MA,Becket,2010,9.3,94,912,1006
588,Becket,Berkshire County,MA,Becket,2011,7.8,78,920,998
589,Becket,Berkshire County,MA,Becket,2012,7.5,74,915,989
590,Bedford,Middlesex County,MA,Bedford,1990,4.3,302,6643,6945
591,Bedford,Middlesex County,MA,Bedford,1991,5.7,397,6555,6952
592,Bedford,Middlesex County,MA,Bedford,1992,6.3,428,6401,6829
593,Bedford,Middlesex County,MA,Bedford,1993,5.2,345,6290,6635
594,Bedford,Middlesex County,MA,Bedford,1994,4.2,284,6405,6689
595,Bedford,Middlesex County,MA,Bedford,1995,3.5,246,6834,7080
596,Bedford,Middlesex County,MA,Bedford,1996,2.9,214,7043,7257
597,Bedford,Middlesex County,MA,Bedford,1997,2.2,162,7270,7432
598,Bedford,Middlesex County,MA,Bedford,1998,2,146,7328,7474
599,Bedford,Middlesex County,MA,Bedford,1999,1.9,145,7412,7557
600,Bedford,Middlesex County,MA,Bedford,2000,2.4,158,6548,6706
601,Bedford,Middlesex County,MA,Bedford,2001,3.5,237,6532,6769
602,Bedford,Middlesex County,MA,Bedford,2002,5.2,351,6366,6717
603,Bedford,Middlesex County,MA,Bedford,2003,5.4,358,6274,6632
604,Bedford,Middlesex County,MA,Bedford,2004,4.2,274,6258,6532
605,Bedford,Middlesex County,MA,Bedford,2005,3.7,241,6300,6541
606,Bedford,Middlesex County,MA,Bedford,2006,3.9,257,6403,6660
607,Bedford,Middlesex County,MA,Bedford,2007,3.3,221,6571,6792
608,Bedford,Middlesex County,MA,Bedford,2008,4,287,6809,7096
609,Bedford,Middlesex County,MA,Bedford,2009,6.3,446,6663,7109
610,Bedford,Middlesex County,MA,Bedford,2010,6,417,6522,6939
611,Bedford,Middlesex County,MA,Bedford,2011,5.7,398,6616,7014
612,Bedford,Middlesex County,MA,Bedford,2012,5,350,6689,7039
613,Belchertown,Hampshire County,MA,Belchertown,1990,5,298,5711,6009
614,Belchertown,Hampshire County,MA,Belchertown,1991,7,425,5647,6072
615,Belchertown,Hampshire County,MA,Belchertown,1992,7.5,460,5706,6166
616,Belchertown,Hampshire County,MA,Belchertown,1993,6.6,406,5777,6183
617,Belchertown,Hampshire County,MA,Belchertown,1994,5.3,338,6029,6367
618,Belchertown,Hampshire County,MA,Belchertown,1995,4.2,262,5987,6249
619,Belchertown,Hampshire County,MA,Belchertown,1996,3.4,215,6162,6377
620,Belchertown,Hampshire County,MA,Belchertown,1997,3.1,204,6362,6566
621,Belchertown,Hampshire County,MA,Belchertown,1998,2.9,197,6486,6683
622,Belchertown,Hampshire County,MA,Belchertown,1999,2.6,180,6621,6801
623,Belchertown,Hampshire County,MA,Belchertown,2000,2.1,161,7468,7629
624,Belchertown,Hampshire County,MA,Belchertown,2001,2.6,202,7563,7765
625,Belchertown,Hampshire County,MA,Belchertown,2002,3.6,286,7630,7916
626,Belchertown,Hampshire County,MA,Belchertown,2003,4.4,349,7670,8019
627,Belchertown,Hampshire County,MA,Belchertown,2004,4.6,371,7777,8148
628,Belchertown,Hampshire County,MA,Belchertown,2005,5.1,422,7881,8303
629,Belchertown,Hampshire County,MA,Belchertown,2006,4.5,380,8018,8398
630,Belchertown,Hampshire County,MA,Belchertown,2007,3.9,326,7965,8291
631,Belchertown,Hampshire County,MA,Belchertown,2008,4.3,358,8041,8399
632,Belchertown,Hampshire County,MA,Belchertown,2009,6.3,514,7696,8210
633,Belchertown,Hampshire County,MA,Belchertown,2010,6.8,574,7920,8494
634,Belchertown,Hampshire County,MA,Belchertown,2011,5.7,474,7820,8294
635,Belchertown,Hampshire County,MA,Belchertown,2012,5.5,458,7825,8283
636,Bellingham,Norfolk County,MA,Bellingham,1990,7.5,668,8212,8880
637,Bellingham,Norfolk County,MA,Bellingham,1991,9.7,860,7973,8833
638,Bellingham,Norfolk County,MA,Bellingham,1992,9.1,794,7931,8725
639,Bellingham,Norfolk County,MA,Bellingham,1993,7.4,649,8069,8718
640,Bellingham,Norfolk County,MA,Bellingham,1994,6.3,552,8235,8787
641,Bellingham,Norfolk County,MA,Bellingham,1995,5.6,504,8419,8923
642,Bellingham,Norfolk County,MA,Bellingham,1996,4.6,419,8616,9035
643,Bellingham,Norfolk County,MA,Bellingham,1997,4.2,387,8883,9270
644,Bellingham,Norfolk County,MA,Bellingham,1998,3.1,288,9086,9374
645,Bellingham,Norfolk County,MA,Bellingham,1999,3.1,296,9246,9542
646,Bellingham,Norfolk County,MA,Bellingham,2000,2.9,262,8926,9188
647,Bellingham,Norfolk County,MA,Bellingham,2001,4,373,8896,9269
648,Bellingham,Norfolk County,MA,Bellingham,2002,5.4,508,8933,9441
649,Bellingham,Norfolk County,MA,Bellingham,2003,5.7,546,9034,9580
650,Bellingham,Norfolk County,MA,Bellingham,2004,5,478,9103,9581
651,Bellingham,Norfolk County,MA,Bellingham,2005,4.5,436,9174,9610
652,Bellingham,Norfolk County,MA,Bellingham,2006,4.8,473,9335,9808
653,Bellingham,Norfolk County,MA,Bellingham,2007,4.6,449,9365,9814
654,Bellingham,Norfolk County,MA,Bellingham,2008,5.8,563,9222,9785
655,Bellingham,Norfolk County,MA,Bellingham,2009,9.7,943,8767,9710
656,Bellingham,Norfolk County,MA,Bellingham,2010,9.9,991,9002,9993
657,Bellingham,Norfolk County,MA,Bellingham,2011,8.9,895,9121,10016
658,Bellingham,Norfolk County,MA,Bellingham,2012,8.2,815,9135,9950
659,Belmont,Middlesex County,MA,Belmont,1990,3.2,437,13097,13534
660,Belmont,Middlesex County,MA,Belmont,1991,4.6,599,12484,13083
661,Belmont,Middlesex County,MA,Belmont,1992,4.6,589,12347,12936
662,Belmont,Middlesex County,MA,Belmont,1993,4.2,549,12524,13073
663,Belmont,Middlesex County,MA,Belmont,1994,3.7,481,12652,13133
664,Belmont,Middlesex County,MA,Belmont,1995,3,396,12631,13027
665,Belmont,Middlesex County,MA,Belmont,1996,2.5,327,12827,13154
666,Belmont,Middlesex County,MA,Belmont,1997,2,271,13084,13355
667,Belmont,Middlesex County,MA,Belmont,1998,1.6,208,13166,13374
668,Belmont,Middlesex County,MA,Belmont,1999,1.7,226,13214,13440
669,Belmont,Middlesex County,MA,Belmont,2000,1.8,246,13124,13370
670,Belmont,Middlesex County,MA,Belmont,2001,3,400,13022,13422
671,Belmont,Middlesex County,MA,Belmont,2002,4.2,552,12713,13265
672,Belmont,Middlesex County,MA,Belmont,2003,4.5,590,12436,13026
673,Belmont,Middlesex County,MA,Belmont,2004,3.5,447,12335,12782
674,Belmont,Middlesex County,MA,Belmont,2005,3.2,409,12342,12751
675,Belmont,Middlesex County,MA,Belmont,2006,3.2,401,12147,12548
676,Belmont,Middlesex County,MA,Belmont,2007,2.9,367,12237,12604
677,Belmont,Middlesex County,MA,Belmont,2008,3.5,450,12248,12698
678,Belmont,Middlesex County,MA,Belmont,2009,5.8,730,11955,12685
679,Belmont,Middlesex County,MA,Belmont,2010,5.5,740,12649,13389
680,Belmont,Middlesex County,MA,Belmont,2011,4.7,628,12836,13464
681,Belmont,Middlesex County,MA,Belmont,2012,4.4,599,12977,13576
682,Berkley,Bristol County,MA,Berkley,1990,7.3,174,2226,2400
683,Berkley,Bristol County,MA,Berkley,1991,10,251,2268,2519
684,Berkley,Bristol County,MA,Berkley,1992,9.4,248,2384,2632
685,Berkley,Bristol County,MA,Berkley,1993,7.3,201,2568,2769
686,Berkley,Bristol County,MA,Berkley,1994,6.4,189,2779,2968
687,Berkley,Bristol County,MA,Berkley,1995,5.9,165,2627,2792
688,Berkley,Bristol County,MA,Berkley,1996,5,143,2727,2870
689,Berkley,Bristol County,MA,Berkley,1997,4.6,138,2833,2971
690,Berkley,Bristol County,MA,Berkley,1998,3.4,104,2918,3022
691,Berkley,Bristol County,MA,Berkley,1999,3,93,2984,3077
692,Berkley,Bristol County,MA,Berkley,2000,2.3,76,3263,3339
693,Berkley,Bristol County,MA,Berkley,2001,2.9,100,3319,3419
694,Berkley,Bristol County,MA,Berkley,2002,3.9,138,3415,3553
695,Berkley,Bristol County,MA,Berkley,2003,4.8,174,3466,3640
696,Berkley,Bristol County,MA,Berkley,2004,4.4,159,3480,3639
697,Berkley,Bristol County,MA,Berkley,2005,4.2,157,3557,3714
698,Berkley,Bristol County,MA,Berkley,2006,4.3,161,3610,3771
699,Berkley,Bristol County,MA,Berkley,2007,4,152,3665,3817
700,Berkley,Bristol County,MA,Berkley,2008,5.2,200,3676,3876
701,Berkley,Bristol County,MA,Berkley,2009,7.9,305,3569,3874
702,Berkley,Bristol County,MA,Berkley,2010,8.1,307,3494,3801
703,Berkley,Bristol County,MA,Berkley,2011,7.1,269,3530,3799
704,Berkley,Bristol County,MA,Berkley,2012,6.7,253,3519,3772
728,Berlin,Worcester County,MA,Berlin,1990,6.1,83,1286,1369
729,Berlin,Worcester County,MA,Berlin,1991,7.8,105,1239,1344
730,Berlin,Worcester County,MA,Berlin,1992,8.4,114,1250,1364
731,Berlin,Worcester County,MA,Berlin,1993,6.9,95,1277,1372
732,Berlin,Worcester County,MA,Berlin,1994,5.7,79,1301,1380
733,Berlin,Worcester County,MA,Berlin,1995,6.1,83,1286,1369
734,Berlin,Worcester County,MA,Berlin,1996,4.2,57,1316,1373
735,Berlin,Worcester County,MA,Berlin,1997,4,57,1361,1418
736,Berlin,Worcester County,MA,Berlin,1998,2.6,38,1397,1435
737,Berlin,Worcester County,MA,Berlin,1999,3.1,46,1432,1478
738,Berlin,Worcester County,MA,Berlin,2000,2.8,37,1304,1341
739,Berlin,Worcester County,MA,Berlin,2001,3.8,52,1331,1383
740,Berlin,Worcester County,MA,Berlin,2002,6.4,93,1364,1457
741,Berlin,Worcester County,MA,Berlin,2003,6,89,1389,1478
742,Berlin,Worcester County,MA,Berlin,2004,4.5,66,1405,1471
743,Berlin,Worcester County,MA,Berlin,2005,4.7,71,1433,1504
744,Berlin,Worcester County,MA,Berlin,2006,4.3,65,1457,1522
745,Berlin,Worcester County,MA,Berlin,2007,4.4,67,1464,1531
746,Berlin,Worcester County,MA,Berlin,2008,4.4,72,1562,1634
747,Berlin,Worcester County,MA,Berlin,2009,7.4,122,1537,1659
748,Berlin,Worcester County,MA,Berlin,2010,7.8,126,1481,1607
749,Berlin,Worcester County,MA,Berlin,2011,6.3,100,1485,1585
750,Berlin,Worcester County,MA,Berlin,2012,5.6,89,1499,1588
751,Bernardston,Franklin County,MA,Bernardston,1990,5.8,63,1028,1091
752,Bernardston,Franklin County,MA,Bernardston,1991,8.6,97,1028,1125
753,Bernardston,Franklin County,MA,Bernardston,1992,7.3,78,989,1067
754,Bernardston,Franklin County,MA,Bernardston,1993,6.6,68,960,1028
755,Bernardston,Franklin County,MA,Bernardston,1994,6.5,70,1002,1072
756,Bernardston,Franklin County,MA,Bernardston,1995,4.9,54,1050,1104
757,Bernardston,Franklin County,MA,Bernardston,1996,3.6,40,1059,1099
758,Bernardston,Franklin County,MA,Bernardston,1997,4.1,47,1088,1135
759,Bernardston,Franklin County,MA,Bernardston,1998,3.3,38,1107,1145
760,Bernardston,Franklin County,MA,Bernardston,1999,3.5,41,1132,1173
761,Bernardston,Franklin County,MA,Bernardston,2000,2.7,32,1164,1196
762,Bernardston,Franklin County,MA,Bernardston,2001,3.5,42,1163,1205
763,Bernardston,Franklin County,MA,Bernardston,2002,4.2,52,1182,1234
764,Bernardston,Franklin County,MA,Bernardston,2003,4.6,58,1190,1248
765,Bernardston,Franklin County,MA,Bernardston,2004,4.6,57,1180,1237
766,Bernardston,Franklin County,MA,Bernardston,2005,4.4,55,1191,1246
767,Bernardston,Franklin County,MA,Bernardston,2006,4.3,54,1196,1250
768,Bernardston,Franklin County,MA,Bernardston,2007,3.6,44,1183,1227
769,Bernardston,Franklin County,MA,Bernardston,2008,4.4,54,1168,1222
770,Bernardston,Franklin County,MA,Bernardston,2009,7.3,90,1136,1226
771,Bernardston,Franklin County,MA,Bernardston,2010,8.2,99,1103,1202
772,Bernardston,Franklin County,MA,Bernardston,2011,7.1,85,1104,1189
773,Bernardston,Franklin County,MA,Bernardston,2012,5.9,69,1107,1176
774,Beverly,Essex County,MA,Beverly,1990,5.1,1087,20193,21280
775,Beverly,Essex County,MA,Beverly,1991,7,1474,19583,21057
776,Beverly,Essex County,MA,Beverly,1992,7.7,1614,19470,21084
777,Beverly,Essex County,MA,Beverly,1993,5.6,1166,19728,20894
778,Beverly,Essex County,MA,Beverly,1994,4.7,991,20064,21055
779,Beverly,Essex County,MA,Beverly,1995,3.9,817,20120,20937
780,Beverly,Essex County,MA,Beverly,1996,3.4,731,20508,21239
781,Beverly,Essex County,MA,Beverly,1997,3,655,21100,21755
782,Beverly,Essex County,MA,Beverly,1998,2.6,575,21486,22061
783,Beverly,Essex County,MA,Beverly,1999,2.5,556,21675,22231
784,Beverly,Essex County,MA,Beverly,2000,2.2,476,21310,21786
785,Beverly,Essex County,MA,Beverly,2001,3.1,687,21346,22033
786,Beverly,Essex County,MA,Beverly,2002,4.6,1023,21041,22064
787,Beverly,Essex County,MA,Beverly,2003,5,1096,20726,21822
788,Beverly,Essex County,MA,Beverly,2004,4.9,1057,20629,21686
789,Beverly,Essex County,MA,Beverly,2005,4.3,931,20710,21641
790,Beverly,Essex County,MA,Beverly,2006,4.2,886,20412,21298
791,Beverly,Essex County,MA,Beverly,2007,3.9,836,20416,21252
792,Beverly,Essex County,MA,Beverly,2008,4.8,1019,20356,21375
793,Beverly,Essex County,MA,Beverly,2009,7.5,1584,19583,21167
794,Beverly,Essex County,MA,Beverly,2010,7.4,1590,19871,21461
795,Beverly,Essex County,MA,Beverly,2011,6.4,1380,20105,21485
796,Beverly,Essex County,MA,Beverly,2012,5.8,1255,20325,21580
797,Billerica,Middlesex County,MA,Billerica,1990,6.3,1435,21287,22722
798,Billerica,Middlesex County,MA,Billerica,1991,8.8,1977,20558,22535
799,Billerica,Middlesex County,MA,Billerica,1992,9.6,2178,20514,22692
800,Billerica,Middlesex County,MA,Billerica,1993,8.1,1831,20663,22494
801,Billerica,Middlesex County,MA,Billerica,1994,6.6,1467,20820,22287
802,Billerica,Middlesex County,MA,Billerica,1995,5.5,1208,20807,22015
803,Billerica,Middlesex County,MA,Billerica,1996,4.6,1036,21577,22613
804,Billerica,Middlesex County,MA,Billerica,1997,3.8,889,22518,23407
805,Billerica,Middlesex County,MA,Billerica,1998,3.1,744,23221,23965
806,Billerica,Middlesex County,MA,Billerica,1999,3.2,781,23977,24758
807,Billerica,Middlesex County,MA,Billerica,2000,2.5,557,21528,22085
808,Billerica,Middlesex County,MA,Billerica,2001,3.6,816,21620,22436
809,Billerica,Middlesex County,MA,Billerica,2002,5.9,1331,21307,22638
810,Billerica,Middlesex County,MA,Billerica,2003,6.3,1406,20993,22399
811,Billerica,Middlesex County,MA,Billerica,2004,5.4,1201,21142,22343
812,Billerica,Middlesex County,MA,Billerica,2005,4.6,1026,21299,22325
813,Billerica,Middlesex County,MA,Billerica,2006,4.3,1000,22039,23039
814,Billerica,Middlesex County,MA,Billerica,2007,4.2,979,22373,23352
815,Billerica,Middlesex County,MA,Billerica,2008,4.8,1129,22211,23340
816,Billerica,Middlesex County,MA,Billerica,2009,8.2,1827,20546,22373
817,Billerica,Middlesex County,MA,Billerica,2010,8,1811,20893,22704
818,Billerica,Middlesex County,MA,Billerica,2011,6.7,1520,21114,22634
819,Billerica,Middlesex County,MA,Billerica,2012,6.3,1427,21347,22774
820,Blackstone,Worcester County,MA,Blackstone,1990,8.9,400,4115,4515
821,Blackstone,Worcester County,MA,Blackstone,1991,11.6,530,4034,4564
822,Blackstone,Worcester County,MA,Blackstone,1992,12.2,554,4003,4557
823,Blackstone,Worcester County,MA,Blackstone,1993,8.7,391,4087,4478
824,Blackstone,Worcester County,MA,Blackstone,1994,7.2,325,4213,4538
825,Blackstone,Worcester County,MA,Blackstone,1995,7,311,4145,4456
826,Blackstone,Worcester County,MA,Blackstone,1996,6.6,296,4222,4518
827,Blackstone,Worcester County,MA,Blackstone,1997,5.3,242,4345,4587
828,Blackstone,Worcester County,MA,Blackstone,1998,3.9,182,4434,4616
829,Blackstone,Worcester County,MA,Blackstone,1999,3.8,179,4508,4687
830,Blackstone,Worcester County,MA,Blackstone,2000,3.1,158,4914,5072
831,Blackstone,Worcester County,MA,Blackstone,2001,4.2,218,4913,5131
832,Blackstone,Worcester County,MA,Blackstone,2002,5.8,304,4955,5259
833,Blackstone,Worcester County,MA,Blackstone,2003,5.7,300,4994,5294
834,Blackstone,Worcester County,MA,Blackstone,2004,5.2,275,5003,5278
835,Blackstone,Worcester County,MA,Blackstone,2005,5,267,5035,5302
836,Blackstone,Worcester County,MA,Blackstone,2006,5.5,294,5074,5368
837,Blackstone,Worcester County,MA,Blackstone,2007,5.1,272,5093,5365
838,Blackstone,Worcester County,MA,Blackstone,2008,6.7,357,5005,5362
839,Blackstone,Worcester County,MA,Blackstone,2009,10.1,582,5152,5734
840,Blackstone,Worcester County,MA,Blackstone,2010,10.6,562,4760,5322
841,Blackstone,Worcester County,MA,Blackstone,2011,9.7,518,4805,5323
842,Blackstone,Worcester County,MA,Blackstone,2012,9.3,491,4812,5303
843,Blandford,Hampden County,MA,Blandford,1990,5,32,611,643
844,Blandford,Hampden County,MA,Blandford,1991,9.5,60,573,633
845,Blandford,Hampden County,MA,Blandford,1992,8.9,61,628,689
846,Blandford,Hampden County,MA,Blandford,1993,7.2,50,642,692
847,Blandford,Hampden County,MA,Blandford,1994,6.2,46,694,740
848,Blandford,Hampden County,MA,Blandford,1995,5.6,41,689,730
849,Blandford,Hampden County,MA,Blandford,1996,4.2,29,665,694
850,Blandford,Hampden County,MA,Blandford,1997,3.9,27,667,694
851,Blandford,Hampden County,MA,Blandford,1998,3.2,23,694,717
852,Blandford,Hampden County,MA,Blandford,1999,3.6,28,749,777
853,Blandford,Hampden County,MA,Blandford,2000,2.9,21,691,712
854,Blandford,Hampden County,MA,Blandford,2001,3.5,25,696,721
855,Blandford,Hampden County,MA,Blandford,2002,4.5,33,698,731
856,Blandford,Hampden County,MA,Blandford,2003,5.3,39,695,734
857,Blandford,Hampden County,MA,Blandford,2004,5.9,44,705,749
858,Blandford,Hampden County,MA,Blandford,2005,4.7,35,709,744
859,Blandford,Hampden County,MA,Blandford,2006,4.3,32,719,751
860,Blandford,Hampden County,MA,Blandford,2007,4.1,31,723,754
861,Blandford,Hampden County,MA,Blandford,2008,3.9,29,711,740
862,Blandford,Hampden County,MA,Blandford,2009,6.7,50,693,743
863,Blandford,Hampden County,MA,Blandford,2010,7.7,55,661,716
864,Blandford,Hampden County,MA,Blandford,2011,7,49,654,703
865,Blandford,Hampden County,MA,Blandford,2012,5.3,37,655,692
866,Bolton,Worcester County,MA,Bolton,1990,5.2,94,1710,1804
867,Bolton,Worcester County,MA,Bolton,1991,6.8,125,1703,1828
868,Bolton,Worcester County,MA,Bolton,1992,6.1,111,1715,1826
869,Bolton,Worcester County,MA,Bolton,1993,5.4,102,1782,1884
870,Bolton,Worcester County,MA,Bolton,1994,4.6,91,1904,1995
871,Bolton,Worcester County,MA,Bolton,1995,4.2,76,1742,1818
872,Bolton,Worcester County,MA,Bolton,1996,3,56,1784,1840
873,Bolton,Worcester County,MA,Bolton,1997,2.9,56,1843,1899
874,Bolton,Worcester County,MA,Bolton,1998,2.7,52,1889,1941
875,Bolton,Worcester County,MA,Bolton,1999,3.2,63,1929,1992
876,Bolton,Worcester County,MA,Bolton,2000,1.9,46,2374,2420
877,Bolton,Worcester County,MA,Bolton,2001,3.3,82,2398,2480
878,Bolton,Worcester County,MA,Bolton,2002,5.4,137,2383,2520
879,Bolton,Worcester County,MA,Bolton,2003,4.9,122,2389,2511
880,Bolton,Worcester County,MA,Bolton,2004,4.5,113,2411,2524
881,Bolton,Worcester County,MA,Bolton,2005,3.7,94,2462,2556
882,Bolton,Worcester County,MA,Bolton,2006,4,104,2478,2582
883,Bolton,Worcester County,MA,Bolton,2007,3.6,94,2525,2619
884,Bolton,Worcester County,MA,Bolton,2008,3.9,103,2512,2615
885,Bolton,Worcester County,MA,Bolton,2009,6.4,166,2436,2602
886,Bolton,Worcester County,MA,Bolton,2010,6.4,181,2633,2814
887,Bolton,Worcester County,MA,Bolton,2011,5.5,153,2654,2807
888,Bolton,Worcester County,MA,Bolton,2012,4.3,120,2683,2803
889,Boston,Suffolk County,MA,Boston,1990,6,18133,286374,304507
890,Boston,Suffolk County,MA,Boston,1991,8.4,24891,271660,296551
891,Boston,Suffolk County,MA,Boston,1992,8.3,23992,265307,289299
892,Boston,Suffolk County,MA,Boston,1993,7,19986,267080,287066
893,Boston,Suffolk County,MA,Boston,1994,6,17195,268809,286004
894,Boston,Suffolk County,MA,Boston,1995,5.4,15934,277847,293781
895,Boston,Suffolk County,MA,Boston,1996,4.7,13888,281244,295132
896,Boston,Suffolk County,MA,Boston,1997,4.3,12719,286537,299256
897,Boston,Suffolk County,MA,Boston,1998,3.5,10464,289584,300048
898,Boston,Suffolk County,MA,Boston,1999,3.4,10216,291680,301896
899,Boston,Suffolk County,MA,Boston,2000,3,9216,295008,304224
900,Boston,Suffolk County,MA,Boston,2001,4.1,12640,294165,306805
901,Boston,Suffolk County,MA,Boston,2002,5.9,17871,286918,304789
902,Boston,Suffolk County,MA,Boston,2003,6.4,19058,278948,298006
903,Boston,Suffolk County,MA,Boston,2004,5.6,16410,274159,290569
904,Boston,Suffolk County,MA,Boston,2005,5.2,14951,272483,287434
905,Boston,Suffolk County,MA,Boston,2006,4.9,15135,295598,310733
906,Boston,Suffolk County,MA,Boston,2007,4.4,13853,302153,316006
907,Boston,Suffolk County,MA,Boston,2008,5.1,16609,307404,324013
908,Boston,Suffolk County,MA,Boston,2009,7.6,24660,300082,324742
909,Boston,Suffolk County,MA,Boston,2010,7.9,25106,291571,316677
910,Boston,Suffolk County,MA,Boston,2011,6.9,22101,296374,318475
911,Boston,Suffolk County,MA,Boston,2012,6.4,20626,299620,320246
912,Bourne,Barnstable County,MA,Bourne,1990,7.2,579,7454,8033
913,Bourne,Barnstable County,MA,Bourne,1991,10.3,839,7306,8145
914,Bourne,Barnstable County,MA,Bourne,1992,10.5,858,7289,8147
915,Bourne,Barnstable County,MA,Bourne,1993,8.3,694,7679,8373
916,Bourne,Barnstable County,MA,Bourne,1994,7.8,664,7801,8465
917,Bourne,Barnstable County,MA,Bourne,1995,6.6,564,8001,8565
918,Bourne,Barnstable County,MA,Bourne,1996,5.5,474,8185,8659
919,Bourne,Barnstable County,MA,Bourne,1997,4.8,429,8446,8875
920,Bourne,Barnstable County,MA,Bourne,1998,4.7,420,8580,9000
921,Bourne,Barnstable County,MA,Bourne,1999,4.1,368,8696,9064
922,Bourne,Barnstable County,MA,Bourne,2000,3.1,301,9263,9564
923,Bourne,Barnstable County,MA,Bourne,2001,3.6,348,9392,9740
924,Bourne,Barnstable County,MA,Bourne,2002,4.8,484,9600,10084
925,Bourne,Barnstable County,MA,Bourne,2003,5.4,563,9827,10390
926,Bourne,Barnstable County,MA,Bourne,2004,5.2,547,9967,10514
927,Bourne,Barnstable County,MA,Bourne,2005,5,522,9943,10465
928,Bourne,Barnstable County,MA,Bourne,2006,4.9,519,9971,10490
929,Bourne,Barnstable County,MA,Bourne,2007,4.9,514,9923,10437
930,Bourne,Barnstable County,MA,Bourne,2008,6,641,10103,10744
931,Bourne,Barnstable County,MA,Bourne,2009,8.6,924,9821,10745
932,Bourne,Barnstable County,MA,Bourne,2010,9.1,1011,10148,11159
933,Bourne,Barnstable County,MA,Bourne,2011,8.2,911,10132,11043
934,Bourne,Barnstable County,MA,Bourne,2012,7.5,837,10302,11139
935,Boxborough,Middlesex County,MA,Boxborough,1990,3.9,81,1998,2079
936,Boxborough,Middlesex County,MA,Boxborough,1991,5,104,1959,2063
937,Boxborough,Middlesex County,MA,Boxborough,1992,5.6,124,2088,2212
938,Boxborough,Middlesex County,MA,Boxborough,1993,4.5,104,2223,2327
939,Boxborough,Middlesex County,MA,Boxborough,1994,4.1,106,2450,2556
940,Boxborough,Middlesex County,MA,Boxborough,1995,3.9,94,2300,2394
941,Boxborough,Middlesex County,MA,Boxborough,1996,2.7,66,2382,2448
942,Boxborough,Middlesex County,MA,Boxborough,1997,2.3,58,2482,2540
943,Boxborough,Middlesex County,MA,Boxborough,1998,2,52,2515,2567
944,Boxborough,Middlesex County,MA,Boxborough,1999,1.8,47,2579,2626
945,Boxborough,Middlesex County,MA,Boxborough,2000,1.6,47,2829,2876
946,Boxborough,Middlesex County,MA,Boxborough,2001,3,87,2838,2925
947,Boxborough,Middlesex County,MA,Boxborough,2002,5.2,152,2791,2943
948,Boxborough,Middlesex County,MA,Boxborough,2003,5,148,2794,2942
949,Boxborough,Middlesex County,MA,Boxborough,2004,3.8,112,2817,2929
950,Boxborough,Middlesex County,MA,Boxborough,2005,3.6,107,2857,2964
951,Boxborough,Middlesex County,MA,Boxborough,2006,3.4,99,2831,2930
952,Boxborough,Middlesex County,MA,Boxborough,2007,3.1,93,2860,2953
953,Boxborough,Middlesex County,MA,Boxborough,2008,3.5,105,2859,2964
954,Boxborough,Middlesex County,MA,Boxborough,2009,6.1,180,2789,2969
955,Boxborough,Middlesex County,MA,Boxborough,2010,6.3,183,2731,2914
956,Boxborough,Middlesex County,MA,Boxborough,2011,5.4,158,2772,2930
957,Boxborough,Middlesex County,MA,Boxborough,2012,5,147,2802,2949
958,Boxford,Essex County,MA,Boxford,1990,3.5,120,3311,3431
959,Boxford,Essex County,MA,Boxford,1991,4.9,170,3305,3475
960,Boxford,Essex County,MA,Boxford,1992,4.4,156,3400,3556
961,Boxford,Essex County,MA,Boxford,1993,4.4,162,3548,3710
962,Boxford,Essex County,MA,Boxford,1994,3.8,149,3767,3916
963,Boxford,Essex County,MA,Boxford,1995,2.9,136,4504,4640
964,Boxford,Essex County,MA,Boxford,1996,2.1,101,4711,4812
965,Boxford,Essex County,MA,Boxford,1997,1.9,96,4856,4952
966,Boxford,Essex County,MA,Boxford,1998,1.6,84,5027,5111
967,Boxford,Essex County,MA,Boxford,1999,1.8,94,5209,5303
968,Boxford,Essex County,MA,Boxford,2000,1.9,77,4025,4102
969,Boxford,Essex County,MA,Boxford,2001,2.8,117,4086,4203
970,Boxford,Essex County,MA,Boxford,2002,4.1,175,4051,4226
971,Boxford,Essex County,MA,Boxford,2003,4.3,182,4006,4188
972,Boxford,Essex County,MA,Boxford,2004,3.9,164,3999,4163
973,Boxford,Essex County,MA,Boxford,2005,3.4,142,4022,4164
974,Boxford,Essex County,MA,Boxford,2006,3.6,146,3955,4101
975,Boxford,Essex County,MA,Boxford,2007,3.4,142,3985,4127
976,Boxford,Essex County,MA,Boxford,2008,3.9,160,3988,4148
977,Boxford,Essex County,MA,Boxford,2009,5.9,241,3876,4117
978,Boxford,Essex County,MA,Boxford,2010,6.2,250,3796,4046
979,Boxford,Essex County,MA,Boxford,2011,5.4,221,3841,4062
980,Boxford,Essex County,MA,Boxford,2012,4.7,191,3883,4074
981,Boylston,Worcester County,MA,Boylston,1990,6.5,127,1828,1955
982,Boylston,Worcester County,MA,Boylston,1991,10.2,203,1778,1981
983,Boylston,Worcester County,MA,Boylston,1992,8.8,173,1782,1955
984,Boylston,Worcester County,MA,Boylston,1993,7,137,1823,1960
985,Boylston,Worcester County,MA,Boylston,1994,6.2,121,1835,1956
986,Boylston,Worcester County,MA,Boylston,1995,5,102,1932,2034
987,Boylston,Worcester County,MA,Boylston,1996,3.9,81,1978,2059
988,Boylston,Worcester County,MA,Boylston,1997,3.6,77,2043,2120
989,Boylston,Worcester County,MA,Boylston,1998,3.2,70,2096,2166
990,Boylston,Worcester County,MA,Boylston,1999,3.4,73,2105,2178
991,Boylston,Worcester County,MA,Boylston,2000,2.2,48,2147,2195
992,Boylston,Worcester County,MA,Boylston,2001,3.1,70,2155,2225
993,Boylston,Worcester County,MA,Boylston,2002,5.1,115,2147,2262
994,Boylston,Worcester County,MA,Boylston,2003,5.7,129,2154,2283
995,Boylston,Worcester County,MA,Boylston,2004,5,113,2159,2272
996,Boylston,Worcester County,MA,Boylston,2005,4.9,112,2193,2305
997,Boylston,Worcester County,MA,Boylston,2006,4.2,98,2230,2328
998,Boylston,Worcester County,MA,Boylston,2007,3.8,90,2257,2347
999,Boylston,Worcester County,MA,Boylston,2008,4.7,108,2214,2322
1000,Boylston,Worcester County,MA,Boylston,2009,7.4,173,2160,2333
1001,Boylston,Worcester County,MA,Boylston,2010,8.1,189,2146,2335
1002,Boylston,Worcester County,MA,Boylston,2011,6.8,158,2166,2324
1003,Boylston,Worcester County,MA,Boylston,2012,6.6,152,2165,2317
1004,Braintree,Norfolk County,MA,Braintree,1990,5.6,1018,17114,18132
1005,Braintree,Norfolk County,MA,Braintree,1991,8.3,1494,16569,18063
1006,Braintree,Norfolk County,MA,Braintree,1992,8.2,1483,16509,17992
1007,Braintree,Norfolk County,MA,Braintree,1993,6.8,1206,16529,17735
1008,Braintree,Norfolk County,MA,Braintree,1994,5.9,1047,16751,17798
1009,Braintree,Norfolk County,MA,Braintree,1995,5.1,930,17299,18229
1010,Braintree,Norfolk County,MA,Braintree,1996,4.1,747,17654,18401
1011,Braintree,Norfolk County,MA,Braintree,1997,3.6,673,18116,18789
1012,Braintree,Norfolk County,MA,Braintree,1998,2.8,534,18378,18912
1013,Braintree,Norfolk County,MA,Braintree,1999,2.4,457,18475,18932
1014,Braintree,Norfolk County,MA,Braintree,2000,2.4,434,17744,18178
1015,Braintree,Norfolk County,MA,Braintree,2001,3.2,584,17669,18253
1016,Braintree,Norfolk County,MA,Braintree,2002,4.6,844,17350,18194
1017,Braintree,Norfolk County,MA,Braintree,2003,5.6,1004,17019,18023
1018,Braintree,Norfolk County,MA,Braintree,2004,5.1,919,17112,18031
1019,Braintree,Norfolk County,MA,Braintree,2005,4.5,815,17190,18005
1020,Braintree,Norfolk County,MA,Braintree,2006,4.6,817,17133,17950
1021,Braintree,Norfolk County,MA,Braintree,2007,4.3,783,17422,18205
1022,Braintree,Norfolk County,MA,Braintree,2008,5.1,958,17881,18839
1023,Braintree,Norfolk County,MA,Braintree,2009,7.6,1428,17284,18712
1024,Braintree,Norfolk County,MA,Braintree,2010,7.8,1494,17670,19164
1025,Braintree,Norfolk County,MA,Braintree,2011,6.5,1251,17868,19119
1026,Braintree,Norfolk County,MA,Braintree,2012,6,1160,18063,19223
1027,Brewster,Barnstable County,MA,Brewster,1990,5.9,261,4174,4435
1028,Brewster,Barnstable County,MA,Brewster,1991,7.7,340,4102,4442
1029,Brewster,Barnstable County,MA,Brewster,1992,7.7,341,4083,4424
1030,Brewster,Barnstable County,MA,Brewster,1993,6.5,297,4268,4565
1031,Brewster,Barnstable County,MA,Brewster,1994,5.7,262,4372,4634
1032,Brewster,Barnstable County,MA,Brewster,1995,4.6,210,4376,4586
1033,Brewster,Barnstable County,MA,Brewster,1996,4.1,193,4521,4714
1034,Brewster,Barnstable County,MA,Brewster,1997,3.8,181,4616,4797
1035,Brewster,Barnstable County,MA,Brewster,1998,3.5,170,4719,4889
1036,Brewster,Barnstable County,MA,Brewster,1999,2.5,128,4947,5075
1037,Brewster,Barnstable County,MA,Brewster,2000,2.8,148,5145,5293
1038,Brewster,Barnstable County,MA,Brewster,2001,3.1,166,5206,5372
1039,Brewster,Barnstable County,MA,Brewster,2002,3.6,199,5306,5505
1040,Brewster,Barnstable County,MA,Brewster,2003,4.2,235,5413,5648
1041,Brewster,Barnstable County,MA,Brewster,2004,4.1,235,5460,5695
1042,Brewster,Barnstable County,MA,Brewster,2005,4,225,5425,5650
1043,Brewster,Barnstable County,MA,Brewster,2006,4,227,5424,5651
1044,Brewster,Barnstable County,MA,Brewster,2007,4,223,5392,5615
1045,Brewster,Barnstable County,MA,Brewster,2008,5,280,5338,5618
1046,Brewster,Barnstable County,MA,Brewster,2009,7.4,419,5210,5629
1047,Brewster,Barnstable County,MA,Brewster,2010,8.1,457,5202,5659
1048,Brewster,Barnstable County,MA,Brewster,2011,7.4,412,5193,5605
1049,Brewster,Barnstable County,MA,Brewster,2012,6.4,361,5280,5641
1050,Bridgewater,Plymouth County,MA,Bridgewater,1990,6.4,693,10103,10796
1051,Bridgewater,Plymouth County,MA,Bridgewater,1991,9.3,997,9687,10684
1052,Bridgewater,Plymouth County,MA,Bridgewater,1992,9.5,1006,9533,10539
1053,Bridgewater,Plymouth County,MA,Bridgewater,1993,7.1,784,10251,11035
1054,Bridgewater,Plymouth County,MA,Bridgewater,1994,5.9,694,11061,11755
1055,Bridgewater,Plymouth County,MA,Bridgewater,1995,5.1,611,11264,11875
1056,Bridgewater,Plymouth County,MA,Bridgewater,1996,4.1,489,11467,11956
1057,Bridgewater,Plymouth County,MA,Bridgewater,1997,3.5,431,11945,12376
1058,Bridgewater,Plymouth County,MA,Bridgewater,1998,2.9,361,12077,12438
1059,Bridgewater,Plymouth County,MA,Bridgewater,1999,2.9,365,12391,12756
1060,Bridgewater,Plymouth County,MA,Bridgewater,2000,2.3,305,12846,13151
1061,Bridgewater,Plymouth County,MA,Bridgewater,2001,3,399,12726,13125
1062,Bridgewater,Plymouth County,MA,Bridgewater,2002,4.4,579,12607,13186
1063,Bridgewater,Plymouth County,MA,Bridgewater,2003,5.1,660,12354,13014
1064,Bridgewater,Plymouth County,MA,Bridgewater,2004,5,657,12380,13037
1065,Bridgewater,Plymouth County,MA,Bridgewater,2005,4.7,612,12415,13027
1066,Bridgewater,Plymouth County,MA,Bridgewater,2006,4.5,596,12564,13160
1067,Bridgewater,Plymouth County,MA,Bridgewater,2007,4.5,591,12647,13238
1068,Bridgewater,Plymouth County,MA,Bridgewater,2008,5.2,699,12686,13385
1069,Bridgewater,Plymouth County,MA,Bridgewater,2009,7.6,1064,12967,14031
1070,Bridgewater,Plymouth County,MA,Bridgewater,2010,8,1097,12619,13716
1071,Bridgewater,Plymouth County,MA,Bridgewater,2011,7.3,1006,12728,13734
1072,Bridgewater,Plymouth County,MA,Bridgewater,2012,6.7,923,12841,13764
1073,Brimfield,Hampden County,MA,Brimfield,1990,6,87,1374,1461
1074,Brimfield,Hampden County,MA,Brimfield,1991,9.1,136,1352,1488
1075,Brimfield,Hampden County,MA,Brimfield,1992,10.6,153,1296,1449
1076,Brimfield,Hampden County,MA,Brimfield,1993,9.1,130,1304,1434
1077,Brimfield,Hampden County,MA,Brimfield,1994,7.5,107,1318,1425
1078,Brimfield,Hampden County,MA,Brimfield,1995,6.1,100,1535,1635
1079,Brimfield,Hampden County,MA,Brimfield,1996,4.8,82,1620,1702
1080,Brimfield,Hampden County,MA,Brimfield,1997,4.9,83,1614,1697
1081,Brimfield,Hampden County,MA,Brimfield,1998,4.7,77,1565,1642
1082,Brimfield,Hampden County,MA,Brimfield,1999,4.4,71,1536,1607
1083,Brimfield,Hampden County,MA,Brimfield,2000,2.5,45,1786,1831
1084,Brimfield,Hampden County,MA,Brimfield,2001,3.5,66,1821,1887
1085,Brimfield,Hampden County,MA,Brimfield,2002,5,97,1842,1939
1086,Brimfield,Hampden County,MA,Brimfield,2003,5.7,113,1853,1966
1087,Brimfield,Hampden County,MA,Brimfield,2004,5.5,110,1878,1988
1088,Brimfield,Hampden County,MA,Brimfield,2005,4.9,99,1905,2004
1089,Brimfield,Hampden County,MA,Brimfield,2006,5.3,108,1947,2055
1090,Brimfield,Hampden County,MA,Brimfield,2007,5.1,106,1953,2059
1091,Brimfield,Hampden County,MA,Brimfield,2008,5.5,114,1942,2056
1092,Brimfield,Hampden County,MA,Brimfield,2009,8.3,173,1903,2076
1093,Brimfield,Hampden County,MA,Brimfield,2010,8.2,162,1809,1971
1094,Brimfield,Hampden County,MA,Brimfield,2011,8.4,164,1791,1955
1095,Brimfield,Hampden County,MA,Brimfield,2012,6.9,132,1792,1924
1119,Brockton,Plymouth County,MA,Brockton,1990,9.5,4385,41953,46338
1120,Brockton,Plymouth County,MA,Brockton,1991,13,5856,39354,45210
1121,Brockton,Plymouth County,MA,Brockton,1992,12.7,5567,38229,43796
1122,Brockton,Plymouth County,MA,Brockton,1993,10,4317,38668,42985
1123,Brockton,Plymouth County,MA,Brockton,1994,8.1,3557,40358,43915
1124,Brockton,Plymouth County,MA,Brockton,1995,7,3222,42855,46077
1125,Brockton,Plymouth County,MA,Brockton,1996,6.5,2994,42976,45970
1126,Brockton,Plymouth County,MA,Brockton,1997,5.5,2594,44258,46852
1127,Brockton,Plymouth County,MA,Brockton,1998,4.5,2120,44540,46660
1128,Brockton,Plymouth County,MA,Brockton,1999,4.3,2036,45028,47064
1129,Brockton,Plymouth County,MA,Brockton,2000,3.4,1540,43817,45357
1130,Brockton,Plymouth County,MA,Brockton,2001,4.7,2157,43526,45683
1131,Brockton,Plymouth County,MA,Brockton,2002,6.4,2935,43023,45958
1132,Brockton,Plymouth County,MA,Brockton,2003,7.3,3280,41894,45174
1133,Brockton,Plymouth County,MA,Brockton,2004,6.9,3072,41719,44791
1134,Brockton,Plymouth County,MA,Brockton,2005,6.1,2724,41684,44408
1135,Brockton,Plymouth County,MA,Brockton,2006,6.1,2721,42029,44750
1136,Brockton,Plymouth County,MA,Brockton,2007,5.9,2617,42109,44726
1137,Brockton,Plymouth County,MA,Brockton,2008,6.9,3097,41776,44873
1138,Brockton,Plymouth County,MA,Brockton,2009,10.4,4694,40593,45287
1139,Brockton,Plymouth County,MA,Brockton,2010,11.3,5166,40673,45839
1140,Brockton,Plymouth County,MA,Brockton,2011,10,4569,41052,45621
1141,Brockton,Plymouth County,MA,Brockton,2012,9,4115,41416,45531
1142,Brookfield,Worcester County,MA,Brookfield,1990,6.8,103,1404,1507
1143,Brookfield,Worcester County,MA,Brookfield,1991,11.1,177,1415,1592
1144,Brookfield,Worcester County,MA,Brookfield,1992,11.3,178,1391,1569
1145,Brookfield,Worcester County,MA,Brookfield,1993,7.9,123,1440,1563
1146,Brookfield,Worcester County,MA,Brookfield,1994,6.1,94,1451,1545
1147,Brookfield,Worcester County,MA,Brookfield,1995,4.8,68,1362,1430
1148,Brookfield,Worcester County,MA,Brookfield,1996,5.7,83,1381,1464
1149,Brookfield,Worcester County,MA,Brookfield,1997,5,74,1413,1487
1150,Brookfield,Worcester County,MA,Brookfield,1998,4.1,62,1436,1498
1151,Brookfield,Worcester County,MA,Brookfield,1999,3.6,54,1433,1487
1152,Brookfield,Worcester County,MA,Brookfield,2000,2.5,42,1642,1684
1153,Brookfield,Worcester County,MA,Brookfield,2001,3.2,54,1644,1698
1154,Brookfield,Worcester County,MA,Brookfield,2002,5.7,99,1631,1730
1155,Brookfield,Worcester County,MA,Brookfield,2003,6.3,109,1620,1729
1156,Brookfield,Worcester County,MA,Brookfield,2004,5.7,98,1610,1708
1157,Brookfield,Worcester County,MA,Brookfield,2005,5.8,98,1602,1700
1158,Brookfield,Worcester County,MA,Brookfield,2006,5.7,107,1759,1866
1159,Brookfield,Worcester County,MA,Brookfield,2007,5.9,110,1765,1875
1160,Brookfield,Worcester County,MA,Brookfield,2008,5.8,107,1735,1842
1161,Brookfield,Worcester County,MA,Brookfield,2009,9.1,169,1683,1852
1162,Brookfield,Worcester County,MA,Brookfield,2010,9.5,177,1679,1856
1163,Brookfield,Worcester County,MA,Brookfield,2011,8.4,156,1694,1850
1164,Brookfield,Worcester County,MA,Brookfield,2012,7.8,143,1693,1836
1165,Brookline,Norfolk County,MA,Brookline,1990,2.6,812,30784,31596
1166,Brookline,Norfolk County,MA,Brookline,1991,4.1,1240,29218,30458
1167,Brookline,Norfolk County,MA,Brookline,1992,4.8,1462,28683,30145
1168,Brookline,Norfolk County,MA,Brookline,1993,3.9,1172,28873,30045
1169,Brookline,Norfolk County,MA,Brookline,1994,3.6,1102,29189,30291
1170,Brookline,Norfolk County,MA,Brookline,1995,2.9,887,30233,31120
1171,Brookline,Norfolk County,MA,Brookline,1996,2.2,698,30763,31461
1172,Brookline,Norfolk County,MA,Brookline,1997,1.9,612,31428,32040
1173,Brookline,Norfolk County,MA,Brookline,1998,1.5,488,31717,32205
1174,Brookline,Norfolk County,MA,Brookline,1999,1.5,474,31770,32244
1175,Brookline,Norfolk County,MA,Brookline,2000,1.6,561,33760,34321
1176,Brookline,Norfolk County,MA,Brookline,2001,2.6,881,33571,34452
1177,Brookline,Norfolk County,MA,Brookline,2002,3.7,1266,32911,34177
1178,Brookline,Norfolk County,MA,Brookline,2003,3.6,1199,32253,33452
1179,Brookline,Norfolk County,MA,Brookline,2004,3.1,1021,32001,33022
1180,Brookline,Norfolk County,MA,Brookline,2005,2.8,924,31989,32913
1181,Brookline,Norfolk County,MA,Brookline,2006,2.7,872,31907,32779
1182,Brookline,Norfolk County,MA,Brookline,2007,2.5,841,32167,33008
1183,Brookline,Norfolk County,MA,Brookline,2008,3.2,1046,32100,33146
1184,Brookline,Norfolk County,MA,Brookline,2009,5.2,1686,30980,32666
1185,Brookline,Norfolk County,MA,Brookline,2010,4.5,1554,32735,34289
1186,Brookline,Norfolk County,MA,Brookline,2011,3.8,1310,33100,34410
1187,Brookline,Norfolk County,MA,Brookline,2012,3.4,1189,33462,34651
1188,Buckland,Franklin County,MA,Buckland,1990,1.4,15,1035,1050
1189,Buckland,Franklin County,MA,Buckland,1991,1.8,19,1047,1066
1190,Buckland,Franklin County,MA,Buckland,1992,1.9,20,1037,1057
1191,Buckland,Franklin County,MA,Buckland,1993,1.5,16,1065,1081
1192,Buckland,Franklin County,MA,Buckland,1994,1.4,16,1152,1168
1193,Buckland,Franklin County,MA,Buckland,1995,1.7,18,1046,1064
1194,Buckland,Franklin County,MA,Buckland,1996,1,11,1052,1063
1195,Buckland,Franklin County,MA,Buckland,1997,1.1,12,1074,1086
1196,Buckland,Franklin County,MA,Buckland,1998,1.1,12,1094,1106
1197,Buckland,Franklin County,MA,Buckland,1999,1.2,14,1114,1128
1198,Buckland,Franklin County,MA,Buckland,2000,1.3,15,1128,1143
1199,Buckland,Franklin County,MA,Buckland,2001,1.6,18,1120,1138
1200,Buckland,Franklin County,MA,Buckland,2002,1.7,19,1132,1151
1201,Buckland,Franklin County,MA,Buckland,2003,2.2,25,1136,1161
1202,Buckland,Franklin County,MA,Buckland,2004,2.5,29,1112,1141
1203,Buckland,Franklin County,MA,Buckland,2005,2.4,27,1115,1142
1204,Buckland,Franklin County,MA,Buckland,2006,2.5,29,1125,1154
1205,Buckland,Franklin County,MA,Buckland,2007,3,34,1111,1145
1206,Buckland,Franklin County,MA,Buckland,2008,2.8,32,1094,1126
1207,Buckland,Franklin County,MA,Buckland,2009,3.9,43,1063,1106
1208,Buckland,Franklin County,MA,Buckland,2010,4.1,44,1034,1078
1209,Buckland,Franklin County,MA,Buckland,2011,3.6,39,1037,1076
1210,Buckland,Franklin County,MA,Buckland,2012,3.7,40,1040,1080
1211,Burlington,Middlesex County,MA,Burlington,1990,5,732,13821,14553
1212,Burlington,Middlesex County,MA,Burlington,1991,7,1000,13337,14337
1213,Burlington,Middlesex County,MA,Burlington,1992,7.8,1120,13201,14321
1214,Burlington,Middlesex County,MA,Burlington,1993,5.6,793,13268,14061
1215,Burlington,Middlesex County,MA,Burlington,1994,4.9,689,13423,14112
1216,Burlington,Middlesex County,MA,Burlington,1995,4,569,13655,14224
1217,Burlington,Middlesex County,MA,Burlington,1996,3.1,444,13962,14406
1218,Burlington,Middlesex County,MA,Burlington,1997,2.9,429,14340,14769
1219,Burlington,Middlesex County,MA,Burlington,1998,2,300,14481,14781
1220,Burlington,Middlesex County,MA,Burlington,1999,2.2,332,14653,14985
1221,Burlington,Middlesex County,MA,Burlington,2000,2.2,290,12850,13140
1222,Burlington,Middlesex County,MA,Burlington,2001,3.3,431,12800,13231
1223,Burlington,Middlesex County,MA,Burlington,2002,5,654,12524,13178
1224,Burlington,Middlesex County,MA,Burlington,2003,5.2,680,12303,12983
1225,Burlington,Middlesex County,MA,Burlington,2004,4.3,564,12555,13119
1226,Burlington,Middlesex County,MA,Burlington,2005,3.9,512,12729,13241
1227,Burlington,Middlesex County,MA,Burlington,2006,3.6,503,13542,14045
1228,Burlington,Middlesex County,MA,Burlington,2007,3.4,477,13733,14210
1229,Burlington,Middlesex County,MA,Burlington,2008,4.1,584,13754,14338
1230,Burlington,Middlesex County,MA,Burlington,2009,6.6,945,13423,14368
1231,Burlington,Middlesex County,MA,Burlington,2010,6.4,880,12963,13843
1232,Burlington,Middlesex County,MA,Burlington,2011,5.4,746,13156,13902
1233,Burlington,Middlesex County,MA,Burlington,2012,5,707,13300,14007
1234,Cambridge,Middlesex County,MA,Cambridge,1990,4,2256,53753,56009
1235,Cambridge,Middlesex County,MA,Cambridge,1991,5.6,3098,52551,55649
1236,Cambridge,Middlesex County,MA,Cambridge,1992,5.6,3141,52660,55801
1237,Cambridge,Middlesex County,MA,Cambridge,1993,4.7,2660,53871,56531
1238,Cambridge,Middlesex County,MA,Cambridge,1994,3.9,2240,55065,57305
1239,Cambridge,Middlesex County,MA,Cambridge,1995,3.5,1917,52219,54136
1240,Cambridge,Middlesex County,MA,Cambridge,1996,2.8,1539,53013,54552
1241,Cambridge,Middlesex County,MA,Cambridge,1997,2.4,1354,54192,55546
1242,Cambridge,Middlesex County,MA,Cambridge,1998,1.9,1078,54649,55727
1243,Cambridge,Middlesex County,MA,Cambridge,1999,2,1105,54841,55946
1244,Cambridge,Middlesex County,MA,Cambridge,2000,1.9,1146,58159,59305
1245,Cambridge,Middlesex County,MA,Cambridge,2001,2.8,1658,58309,59967
1246,Cambridge,Middlesex County,MA,Cambridge,2002,4,2402,57199,59601
1247,Cambridge,Middlesex County,MA,Cambridge,2003,4.2,2484,56071,58555
1248,Cambridge,Middlesex County,MA,Cambridge,2004,3.6,2107,55675,57782
1249,Cambridge,Middlesex County,MA,Cambridge,2005,3.4,1954,55816,57770
1250,Cambridge,Middlesex County,MA,Cambridge,2006,3.2,1925,57683,59608
1251,Cambridge,Middlesex County,MA,Cambridge,2007,3,1803,58948,60751
1252,Cambridge,Middlesex County,MA,Cambridge,2008,3.5,2168,59561,61729
1253,Cambridge,Middlesex County,MA,Cambridge,2009,5.4,3293,57857,61150
1254,Cambridge,Middlesex County,MA,Cambridge,2010,5.3,3199,56777,59976
1255,Cambridge,Middlesex County,MA,Cambridge,2011,4.6,2778,57496,60274
1256,Cambridge,Middlesex County,MA,Cambridge,2012,4.2,2540,58126,60666
1257,Canton,Norfolk County,MA,Canton,1990,5.2,550,9987,10537
1258,Canton,Norfolk County,MA,Canton,1991,7.4,782,9832,10614
1259,Canton,Norfolk County,MA,Canton,1992,7.6,814,9897,10711
1260,Canton,Norfolk County,MA,Canton,1993,5.7,618,10183,10801
1261,Canton,Norfolk County,MA,Canton,1994,5.2,579,10557,11136
1262,Canton,Norfolk County,MA,Canton,1995,4.5,501,10665,11166
1263,Canton,Norfolk County,MA,Canton,1996,3.6,408,10984,11392
1264,Canton,Norfolk County,MA,Canton,1997,3.1,360,11344,11704
1265,Canton,Norfolk County,MA,Canton,1998,2.3,278,11625,11903
1266,Canton,Norfolk County,MA,Canton,1999,2.2,264,11779,12043
1267,Canton,Norfolk County,MA,Canton,2000,2.3,260,10941,11201
1268,Canton,Norfolk County,MA,Canton,2001,3,344,11013,11357
1269,Canton,Norfolk County,MA,Canton,2002,4.4,500,10936,11436
1270,Canton,Norfolk County,MA,Canton,2003,5,565,10828,11393
1271,Canton,Norfolk County,MA,Canton,2004,4.4,503,10877,11380
1272,Canton,Norfolk County,MA,Canton,2005,3.9,449,11023,11472
1273,Canton,Norfolk County,MA,Canton,2006,4.1,468,10959,11427
1274,Canton,Norfolk County,MA,Canton,2007,3.7,429,11151,11580
1275,Canton,Norfolk County,MA,Canton,2008,4.6,539,11162,11701
1276,Canton,Norfolk County,MA,Canton,2009,7.2,844,10908,11752
1277,Canton,Norfolk County,MA,Canton,2010,7,809,10672,11481
1278,Canton,Norfolk County,MA,Canton,2011,6.1,706,10792,11498
1279,Canton,Norfolk County,MA,Canton,2012,5.8,667,10910,11577
1280,Carlisle,Middlesex County,MA,Carlisle,1990,2.4,59,2404,2463
1281,Carlisle,Middlesex County,MA,Carlisle,1991,3.8,93,2334,2427
1282,Carlisle,Middlesex County,MA,Carlisle,1992,3.8,94,2361,2455
1283,Carlisle,Middlesex County,MA,Carlisle,1993,2.7,67,2444,2511
1284,Carlisle,Middlesex County,MA,Carlisle,1994,2.8,71,2503,2574
1285,Carlisle,Middlesex County,MA,Carlisle,1995,2.5,63,2489,2552
1286,Carlisle,Middlesex County,MA,Carlisle,1996,2,52,2560,2612
1287,Carlisle,Middlesex County,MA,Carlisle,1997,1.5,41,2656,2697
1288,Carlisle,Middlesex County,MA,Carlisle,1998,1.3,37,2734,2771
1289,Carlisle,Middlesex County,MA,Carlisle,1999,1.7,47,2791,2838
1290,Carlisle,Middlesex County,MA,Carlisle,2000,1.7,42,2454,2496
1291,Carlisle,Middlesex County,MA,Carlisle,2001,2.8,70,2472,2542
1292,Carlisle,Middlesex County,MA,Carlisle,2002,5,128,2449,2577
1293,Carlisle,Middlesex County,MA,Carlisle,2003,4.6,117,2420,2537
1294,Carlisle,Middlesex County,MA,Carlisle,2004,4,101,2412,2513
1295,Carlisle,Middlesex County,MA,Carlisle,2005,3.6,92,2436,2528
1296,Carlisle,Middlesex County,MA,Carlisle,2006,3.3,81,2394,2475
1297,Carlisle,Middlesex County,MA,Carlisle,2007,3.1,76,2413,2489
1298,Carlisle,Middlesex County,MA,Carlisle,2008,3.6,90,2410,2500
1299,Carlisle,Middlesex County,MA,Carlisle,2009,6.4,160,2348,2508
1300,Carlisle,Middlesex County,MA,Carlisle,2010,6,152,2371,2523
1301,Carlisle,Middlesex County,MA,Carlisle,2011,4.3,109,2406,2515
1302,Carlisle,Middlesex County,MA,Carlisle,2012,4.4,113,2432,2545
1303,Carver,Plymouth County,MA,Carver,1990,7.6,391,4744,5135
1304,Carver,Plymouth County,MA,Carver,1991,10.7,557,4652,5209
1305,Carver,Plymouth County,MA,Carver,1992,10.7,557,4668,5225
1306,Carver,Plymouth County,MA,Carver,1993,9.3,494,4810,5304
1307,Carver,Plymouth County,MA,Carver,1994,7.2,380,4887,5267
1308,Carver,Plymouth County,MA,Carver,1995,7,371,4917,5288
1309,Carver,Plymouth County,MA,Carver,1996,5.6,303,5063,5366
1310,Carver,Plymouth County,MA,Carver,1997,5.5,306,5248,5554
1311,Carver,Plymouth County,MA,Carver,1998,4,227,5409,5636
1312,Carver,Plymouth County,MA,Carver,1999,3.8,217,5557,5774
1313,Carver,Plymouth County,MA,Carver,2000,2.9,175,5856,6031
1314,Carver,Plymouth County,MA,Carver,2001,3.8,232,5875,6107
1315,Carver,Plymouth County,MA,Carver,2002,4.9,302,5824,6126
1316,Carver,Plymouth County,MA,Carver,2003,6.2,381,5769,6150
1317,Carver,Plymouth County,MA,Carver,2004,5.4,332,5791,6123
1318,Carver,Plymouth County,MA,Carver,2005,5.3,327,5888,6215
1319,Carver,Plymouth County,MA,Carver,2006,5.1,318,5874,6192
1320,Carver,Plymouth County,MA,Carver,2007,5.1,324,5986,6310
1321,Carver,Plymouth County,MA,Carver,2008,5.9,377,6019,6396
1322,Carver,Plymouth County,MA,Carver,2009,8.9,571,5851,6422
1323,Carver,Plymouth County,MA,Carver,2010,9.2,572,5676,6248
1324,Carver,Plymouth County,MA,Carver,2011,7.9,492,5733,6225
1325,Carver,Plymouth County,MA,Carver,2012,7,437,5796,6233
1326,Charlemont,Franklin County,MA,Charlemont,1990,7,46,610,656
1327,Charlemont,Franklin County,MA,Charlemont,1991,9.5,62,594,656
1328,Charlemont,Franklin County,MA,Charlemont,1992,10.5,70,598,668
1329,Charlemont,Franklin County,MA,Charlemont,1993,9,59,597,656
1330,Charlemont,Franklin County,MA,Charlemont,1994,7.8,51,600,651
1331,Charlemont,Franklin County,MA,Charlemont,1995,5.2,34,618,652
1332,Charlemont,Franklin County,MA,Charlemont,1996,5.5,36,620,656
1333,Charlemont,Franklin County,MA,Charlemont,1997,6,40,632,672
1334,Charlemont,Franklin County,MA,Charlemont,1998,4.7,32,644,676
1335,Charlemont,Franklin County,MA,Charlemont,1999,4.7,32,655,687
1336,Charlemont,Franklin County,MA,Charlemont,2000,2.7,21,758,779
1337,Charlemont,Franklin County,MA,Charlemont,2001,3,24,767,791
1338,Charlemont,Franklin County,MA,Charlemont,2002,4.3,35,776,811
1339,Charlemont,Franklin County,MA,Charlemont,2003,5,41,776,817
1340,Charlemont,Franklin County,MA,Charlemont,2004,4.7,38,768,806
1341,Charlemont,Franklin County,MA,Charlemont,2005,3.9,31,762,793
1342,Charlemont,Franklin County,MA,Charlemont,2006,3.8,30,760,790
1343,Charlemont,Franklin County,MA,Charlemont,2007,4.7,37,751,788
1344,Charlemont,Franklin County,MA,Charlemont,2008,4.7,37,745,782
1345,Charlemont,Franklin County,MA,Charlemont,2009,7.1,56,728,784
1346,Charlemont,Franklin County,MA,Charlemont,2010,7.4,54,677,731
1347,Charlemont,Franklin County,MA,Charlemont,2011,6.6,48,678,726
1348,Charlemont,Franklin County,MA,Charlemont,2012,6.5,47,680,727
1349,Charlton,Worcester County,MA,Charlton,1990,6.1,319,4887,5206
1350,Charlton,Worcester County,MA,Charlton,1991,9.1,469,4664,5133
1351,Charlton,Worcester County,MA,Charlton,1992,9.6,565,5317,5882
1352,Charlton,Worcester County,MA,Charlton,1993,6.8,414,5672,6086
1353,Charlton,Worcester County,MA,Charlton,1994,5,313,5910,6223
1354,Charlton,Worcester County,MA,Charlton,1995,5.9,316,5062,5378
1355,Charlton,Worcester County,MA,Charlton,1996,4.8,258,5172,5430
1356,Charlton,Worcester County,MA,Charlton,1997,4,222,5339,5561
1357,Charlton,Worcester County,MA,Charlton,1998,3.9,223,5483,5706
1358,Charlton,Worcester County,MA,Charlton,1999,3.4,193,5542,5735
1359,Charlton,Worcester County,MA,Charlton,2000,2.5,157,6076,6233
1360,Charlton,Worcester County,MA,Charlton,2001,3.5,225,6169,6394
1361,Charlton,Worcester County,MA,Charlton,2002,5.5,363,6225,6588
1362,Charlton,Worcester County,MA,Charlton,2003,6,405,6318,6723
1363,Charlton,Worcester County,MA,Charlton,2004,5.5,373,6373,6746
1364,Charlton,Worcester County,MA,Charlton,2005,5.2,352,6446,6798
1365,Charlton,Worcester County,MA,Charlton,2006,5,341,6517,6858
1366,Charlton,Worcester County,MA,Charlton,2007,5,340,6526,6866
1367,Charlton,Worcester County,MA,Charlton,2008,5.5,372,6387,6759
1368,Charlton,Worcester County,MA,Charlton,2009,8.7,591,6230,6821
1369,Charlton,Worcester County,MA,Charlton,2010,8.3,582,6421,7003
1370,Charlton,Worcester County,MA,Charlton,2011,7.4,515,6478,6993
1371,Charlton,Worcester County,MA,Charlton,2012,7.3,507,6476,6983
1372,Chatham,Barnstable County,MA,Chatham,1990,4,114,2771,2885
1373,Chatham,Barnstable County,MA,Chatham,1991,7.9,224,2616,2840
1374,Chatham,Barnstable County,MA,Chatham,1992,8.3,227,2521,2748
1375,Chatham,Barnstable County,MA,Chatham,1993,7.2,199,2565,2764
1376,Chatham,Barnstable County,MA,Chatham,1994,7.1,194,2550,2744
1377,Chatham,Barnstable County,MA,Chatham,1995,5.9,179,2848,3027
1378,Chatham,Barnstable County,MA,Chatham,1996,5,152,2909,3061
1379,Chatham,Barnstable County,MA,Chatham,1997,4.5,138,2940,3078
1380,Chatham,Barnstable County,MA,Chatham,1998,3.8,119,2994,3113
1381,Chatham,Barnstable County,MA,Chatham,1999,3.6,117,3108,3225
1382,Chatham,Barnstable County,MA,Chatham,2000,3.1,99,3057,3156
1383,Chatham,Barnstable County,MA,Chatham,2001,3.5,114,3098,3212
1384,Chatham,Barnstable County,MA,Chatham,2002,4,133,3153,3286
1385,Chatham,Barnstable County,MA,Chatham,2003,4.4,147,3225,3372
1386,Chatham,Barnstable County,MA,Chatham,2004,4.4,152,3270,3422
1387,Chatham,Barnstable County,MA,Chatham,2005,4.5,155,3276,3431
1388,Chatham,Barnstable County,MA,Chatham,2006,4.5,155,3283,3438
1389,Chatham,Barnstable County,MA,Chatham,2007,4.5,153,3275,3428
1390,Chatham,Barnstable County,MA,Chatham,2008,5.4,187,3258,3445
1391,Chatham,Barnstable County,MA,Chatham,2009,7.6,264,3191,3455
1392,Chatham,Barnstable County,MA,Chatham,2010,7.9,251,2936,3187
1393,Chatham,Barnstable County,MA,Chatham,2011,7.1,225,2932,3157
1394,Chatham,Barnstable County,MA,Chatham,2012,6.8,217,2982,3199
1395,Chelmsford,Middlesex County,MA,Chelmsford,1990,5.4,1084,19116,20200
1396,Chelmsford,Middlesex County,MA,Chelmsford,1991,7.6,1521,18513,20034
1397,Chelmsford,Middlesex County,MA,Chelmsford,1992,8,1606,18445,20051
1398,Chelmsford,Middlesex County,MA,Chelmsford,1993,6.8,1363,18604,19967
1399,Chelmsford,Middlesex County,MA,Chelmsford,1994,5.6,1110,18837,19947
1400,Chelmsford,Middlesex County,MA,Chelmsford,1995,4.3,837,18766,19603
1401,Chelmsford,Middlesex County,MA,Chelmsford,1996,3.1,613,19441,20054
1402,Chelmsford,Middlesex County,MA,Chelmsford,1997,2.8,577,20183,20760
1403,Chelmsford,Middlesex County,MA,Chelmsford,1998,2.5,529,20662,21191
1404,Chelmsford,Middlesex County,MA,Chelmsford,1999,2.6,567,21292,21859
1405,Chelmsford,Middlesex County,MA,Chelmsford,2000,2.1,410,18713,19123
1406,Chelmsford,Middlesex County,MA,Chelmsford,2001,3.1,607,18740,19347
1407,Chelmsford,Middlesex County,MA,Chelmsford,2002,5.4,1050,18346,19396
1408,Chelmsford,Middlesex County,MA,Chelmsford,2003,5.7,1101,18180,19281
1409,Chelmsford,Middlesex County,MA,Chelmsford,2004,4.6,868,18028,18896
1410,Chelmsford,Middlesex County,MA,Chelmsford,2005,4,758,18152,18910
1411,Chelmsford,Middlesex County,MA,Chelmsford,2006,3.9,742,18106,18848
1412,Chelmsford,Middlesex County,MA,Chelmsford,2007,3.7,708,18325,19033
1413,Chelmsford,Middlesex County,MA,Chelmsford,2008,4.4,843,18426,19269
1414,Chelmsford,Middlesex County,MA,Chelmsford,2009,7,1345,17734,19079
1415,Chelmsford,Middlesex County,MA,Chelmsford,2010,7,1325,17705,19030
1416,Chelmsford,Middlesex County,MA,Chelmsford,2011,6,1143,17896,19039
1417,Chelmsford,Middlesex County,MA,Chelmsford,2012,5.6,1076,18094,19170
1418,Chelsea,Suffolk County,MA,Chelsea,1990,8.7,1131,11886,13017
1419,Chelsea,Suffolk County,MA,Chelsea,1991,11.6,1451,11106,12557
1420,Chelsea,Suffolk County,MA,Chelsea,1992,12.2,1457,10506,11963
1421,Chelsea,Suffolk County,MA,Chelsea,1993,9.7,1113,10409,11522
1422,Chelsea,Suffolk County,MA,Chelsea,1994,8.2,930,10481,11411
1423,Chelsea,Suffolk County,MA,Chelsea,1995,7.7,948,11415,12363
1424,Chelsea,Suffolk County,MA,Chelsea,1996,6.7,835,11543,12378
1425,Chelsea,Suffolk County,MA,Chelsea,1997,5.9,737,11746,12483
1426,Chelsea,Suffolk County,MA,Chelsea,1998,5.4,673,11886,12559
1427,Chelsea,Suffolk County,MA,Chelsea,1999,5.6,708,11959,12667
1428,Chelsea,Suffolk County,MA,Chelsea,2000,3.7,515,13590,14105
1429,Chelsea,Suffolk County,MA,Chelsea,2001,5,713,13531,14244
1430,Chelsea,Suffolk County,MA,Chelsea,2002,7.4,1041,13071,14112
1431,Chelsea,Suffolk County,MA,Chelsea,2003,8.7,1207,12668,13875
1432,Chelsea,Suffolk County,MA,Chelsea,2004,7.6,1024,12387,13411
1433,Chelsea,Suffolk County,MA,Chelsea,2005,7,927,12267,13194
1434,Chelsea,Suffolk County,MA,Chelsea,2006,6.3,890,13218,14108
1435,Chelsea,Suffolk County,MA,Chelsea,2007,5.9,859,13675,14534
1436,Chelsea,Suffolk County,MA,Chelsea,2008,6.7,978,13601,14579
1437,Chelsea,Suffolk County,MA,Chelsea,2009,9.8,1473,13492,14965
1438,Chelsea,Suffolk County,MA,Chelsea,2010,10.7,1536,12852,14388
1439,Chelsea,Suffolk County,MA,Chelsea,2011,9.5,1367,13081,14448
1440,Chelsea,Suffolk County,MA,Chelsea,2012,8.7,1262,13225,14487
1441,Cheshire,Berkshire County,MA,Cheshire,1990,6.4,118,1739,1857
1442,Cheshire,Berkshire County,MA,Cheshire,1991,12,223,1632,1855
1443,Cheshire,Berkshire County,MA,Cheshire,1992,11.7,210,1592,1802
1444,Cheshire,Berkshire County,MA,Cheshire,1993,9.8,173,1593,1766
1445,Cheshire,Berkshire County,MA,Cheshire,1994,8.9,161,1639,1800
1446,Cheshire,Berkshire County,MA,Cheshire,1995,7.6,134,1624,1758
1447,Cheshire,Berkshire County,MA,Cheshire,1996,6,106,1652,1758
1448,Cheshire,Berkshire County,MA,Cheshire,1997,6,107,1670,1777
1449,Cheshire,Berkshire County,MA,Cheshire,1998,4.5,80,1680,1760
1450,Cheshire,Berkshire County,MA,Cheshire,1999,4.1,72,1691,1763
1451,Cheshire,Berkshire County,MA,Cheshire,2000,3,56,1799,1855
1452,Cheshire,Berkshire County,MA,Cheshire,2001,3.7,70,1801,1871
1453,Cheshire,Berkshire County,MA,Cheshire,2002,5.9,114,1825,1939
1454,Cheshire,Berkshire County,MA,Cheshire,2003,6.2,119,1811,1930
1455,Cheshire,Berkshire County,MA,Cheshire,2004,5.5,106,1812,1918
1456,Cheshire,Berkshire County,MA,Cheshire,2005,5.2,101,1845,1946
1457,Cheshire,Berkshire County,MA,Cheshire,2006,4.4,86,1877,1963
1458,Cheshire,Berkshire County,MA,Cheshire,2007,4.8,94,1857,1951
1459,Cheshire,Berkshire County,MA,Cheshire,2008,5.7,111,1853,1964
1460,Cheshire,Berkshire County,MA,Cheshire,2009,8.6,169,1796,1965
1461,Cheshire,Berkshire County,MA,Cheshire,2010,8.9,166,1696,1862
1462,Cheshire,Berkshire County,MA,Cheshire,2011,8.3,154,1711,1865
1463,Cheshire,Berkshire County,MA,Cheshire,2012,7.5,139,1704,1843
1464,Chester,Hampden County,MA,Chester,1990,5.7,38,633,671
1465,Chester,Hampden County,MA,Chester,1991,11.5,78,601,679
1466,Chester,Hampden County,MA,Chester,1992,13.2,103,678,781
1467,Chester,Hampden County,MA,Chester,1993,9.8,75,688,763
1468,Chester,Hampden County,MA,Chester,1994,12.1,102,738,840
1469,Chester,Hampden County,MA,Chester,1995,8.7,68,715,783
1470,Chester,Hampden County,MA,Chester,1996,7.9,59,691,750
1471,Chester,Hampden County,MA,Chester,1997,6.8,51,694,745
1472,Chester,Hampden County,MA,Chester,1998,6.3,49,725,774
1473,Chester,Hampden County,MA,Chester,1999,5.6,47,785,832
1474,Chester,Hampden County,MA,Chester,2000,4.6,34,698,732
1475,Chester,Hampden County,MA,Chester,2001,5.2,38,699,737
1476,Chester,Hampden County,MA,Chester,2002,7.6,58,701,759
1477,Chester,Hampden County,MA,Chester,2003,7.5,56,692,748
1478,Chester,Hampden County,MA,Chester,2004,5.5,40,691,731
1479,Chester,Hampden County,MA,Chester,2005,5.3,39,692,731
1480,Chester,Hampden County,MA,Chester,2006,4,29,692,721
1481,Chester,Hampden County,MA,Chester,2007,4.2,30,685,715
1482,Chester,Hampden County,MA,Chester,2008,5.2,37,674,711
1483,Chester,Hampden County,MA,Chester,2009,9.3,67,652,719
1484,Chester,Hampden County,MA,Chester,2010,9.3,69,670,739
1485,Chester,Hampden County,MA,Chester,2011,8.2,59,664,723
1486,Chester,Hampden County,MA,Chester,2012,5.9,42,664,706
1487,Chesterfield,Hampshire County,MA,Chesterfield,1990,5.1,32,592,624
1488,Chesterfield,Hampshire County,MA,Chesterfield,1991,11.8,77,577,654
1489,Chesterfield,Hampshire County,MA,Chesterfield,1992,8.5,56,601,657
1490,Chesterfield,Hampshire County,MA,Chesterfield,1993,7.8,51,600,651
1491,Chesterfield,Hampshire County,MA,Chesterfield,1994,4.4,30,647,677
1492,Chesterfield,Hampshire County,MA,Chesterfield,1995,3.5,26,721,747
1493,Chesterfield,Hampshire County,MA,Chesterfield,1996,3.7,27,711,738
1494,Chesterfield,Hampshire County,MA,Chesterfield,1997,3.4,25,720,745
1495,Chesterfield,Hampshire County,MA,Chesterfield,1998,3.1,24,757,781
1496,Chesterfield,Hampshire County,MA,Chesterfield,1999,2.4,20,827,847
1497,Chesterfield,Hampshire County,MA,Chesterfield,2000,1.8,13,706,719
1498,Chesterfield,Hampshire County,MA,Chesterfield,2001,2.6,19,717,736
1499,Chesterfield,Hampshire County,MA,Chesterfield,2002,3.3,24,713,737
1500,Chesterfield,Hampshire County,MA,Chesterfield,2003,4,30,716,746
1501,Chesterfield,Hampshire County,MA,Chesterfield,2004,4,30,723,753
1502,Chesterfield,Hampshire County,MA,Chesterfield,2005,2.9,22,732,754
1503,Chesterfield,Hampshire County,MA,Chesterfield,2006,4.4,34,739,773
1504,Chesterfield,Hampshire County,MA,Chesterfield,2007,3.3,25,740,765
1505,Chesterfield,Hampshire County,MA,Chesterfield,2008,4.1,32,742,774
1506,Chesterfield,Hampshire County,MA,Chesterfield,2009,6.6,50,710,760
1507,Chesterfield,Hampshire County,MA,Chesterfield,2010,7.5,55,674,729
1508,Chesterfield,Hampshire County,MA,Chesterfield,2011,5.5,39,665,704
1509,Chesterfield,Hampshire County,MA,Chesterfield,2012,5.7,40,665,705
1510,Chicopee,Hampden County,MA,Chicopee,1990,7,2026,27039,29065
1511,Chicopee,Hampden County,MA,Chicopee,1991,9.9,2857,26073,28930
1512,Chicopee,Hampden County,MA,Chicopee,1992,9.4,2663,25802,28465
1513,Chicopee,Hampden County,MA,Chicopee,1993,9,2538,25692,28230
1514,Chicopee,Hampden County,MA,Chicopee,1994,7.2,1978,25417,27395
1515,Chicopee,Hampden County,MA,Chicopee,1995,6.6,1794,25469,27263
1516,Chicopee,Hampden County,MA,Chicopee,1996,5.3,1447,25673,27120
1517,Chicopee,Hampden County,MA,Chicopee,1997,4.7,1282,26197,27479
1518,Chicopee,Hampden County,MA,Chicopee,1998,4.2,1143,26221,27364
1519,Chicopee,Hampden County,MA,Chicopee,1999,3.9,1070,26214,27284
1520,Chicopee,Hampden County,MA,Chicopee,2000,3.3,899,26521,27420
1521,Chicopee,Hampden County,MA,Chicopee,2001,4.2,1168,26548,27716
1522,Chicopee,Hampden County,MA,Chicopee,2002,5.7,1609,26398,28007
1523,Chicopee,Hampden County,MA,Chicopee,2003,6.7,1880,26129,28009
1524,Chicopee,Hampden County,MA,Chicopee,2004,6.3,1750,26078,27828
1525,Chicopee,Hampden County,MA,Chicopee,2005,5.8,1605,26103,27708
1526,Chicopee,Hampden County,MA,Chicopee,2006,5.9,1642,26160,27802
1527,Chicopee,Hampden County,MA,Chicopee,2007,5.7,1571,25967,27538
1528,Chicopee,Hampden County,MA,Chicopee,2008,6.5,1818,26244,28062
1529,Chicopee,Hampden County,MA,Chicopee,2009,9.7,2740,25491,28231
1530,Chicopee,Hampden County,MA,Chicopee,2010,9.9,2774,25275,28049
1531,Chicopee,Hampden County,MA,Chicopee,2011,8.9,2454,25022,27476
1532,Chicopee,Hampden County,MA,Chicopee,2012,8.1,2214,25037,27251
1533,Chilmark,Dukes County,MA,Chilmark,1990,3.6,13,353,366
1534,Chilmark,Dukes County,MA,Chilmark,1991,3.5,14,386,400
1535,Chilmark,Dukes County,MA,Chilmark,1992,3.1,12,369,381
1536,Chilmark,Dukes County,MA,Chilmark,1993,4.8,19,379,398
1537,Chilmark,Dukes County,MA,Chilmark,1994,4.7,21,428,449
1538,Chilmark,Dukes County,MA,Chilmark,1995,2.6,11,416,427
1539,Chilmark,Dukes County,MA,Chilmark,1996,3.5,16,437,453
1540,Chilmark,Dukes County,MA,Chilmark,1997,2.6,12,451,463
1541,Chilmark,Dukes County,MA,Chilmark,1998,2.4,11,449,460
1542,Chilmark,Dukes County,MA,Chilmark,1999,4.4,21,457,478
1543,Chilmark,Dukes County,MA,Chilmark,2000,2.9,16,543,559
1544,Chilmark,Dukes County,MA,Chilmark,2001,2,11,551,562
1545,Chilmark,Dukes County,MA,Chilmark,2002,2.4,14,580,594
1546,Chilmark,Dukes County,MA,Chilmark,2003,2.7,17,612,629
1547,Chilmark,Dukes County,MA,Chilmark,2004,2.2,14,626,640
1548,Chilmark,Dukes County,MA,Chilmark,2005,2.6,17,628,645
1549,Chilmark,Dukes County,MA,Chilmark,2006,2.9,19,642,661
1550,Chilmark,Dukes County,MA,Chilmark,2007,2.7,18,656,674
1551,Chilmark,Dukes County,MA,Chilmark,2008,2.8,19,661,680
1552,Chilmark,Dukes County,MA,Chilmark,2009,3.6,22,585,607
1553,Chilmark,Dukes County,MA,Chilmark,2010,6.2,36,549,585
1554,Chilmark,Dukes County,MA,Chilmark,2011,5.5,32,554,586
1555,Chilmark,Dukes County,MA,Chilmark,2012,5.1,30,559,589
1556,Clarksburg,Berkshire County,MA,Clarksburg,1990,5.4,50,879,929
1557,Clarksburg,Berkshire County,MA,Clarksburg,1991,10.7,102,855,957
1558,Clarksburg,Berkshire County,MA,Clarksburg,1992,10.2,96,844,940
1559,Clarksburg,Berkshire County,MA,Clarksburg,1993,8.4,81,888,969
1560,Clarksburg,Berkshire County,MA,Clarksburg,1994,7.5,72,884,956
1561,Clarksburg,Berkshire County,MA,Clarksburg,1995,6.2,56,842,898
1562,Clarksburg,Berkshire County,MA,Clarksburg,1996,6.4,58,852,910
1563,Clarksburg,Berkshire County,MA,Clarksburg,1997,4.4,40,863,903
1564,Clarksburg,Berkshire County,MA,Clarksburg,1998,4.7,39,798,837
1565,Clarksburg,Berkshire County,MA,Clarksburg,1999,4.7,40,808,848
1566,Clarksburg,Berkshire County,MA,Clarksburg,2000,2.8,26,888,914
1567,Clarksburg,Berkshire County,MA,Clarksburg,2001,3.5,32,895,927
1568,Clarksburg,Berkshire County,MA,Clarksburg,2002,4.5,42,894,936
1569,Clarksburg,Berkshire County,MA,Clarksburg,2003,5,47,886,933
1570,Clarksburg,Berkshire County,MA,Clarksburg,2004,5.6,52,880,932
1571,Clarksburg,Berkshire County,MA,Clarksburg,2005,5.2,49,885,934
1572,Clarksburg,Berkshire County,MA,Clarksburg,2006,4.6,43,893,936
1573,Clarksburg,Berkshire County,MA,Clarksburg,2007,4.6,43,893,936
1574,Clarksburg,Berkshire County,MA,Clarksburg,2008,5.8,55,888,943
1575,Clarksburg,Berkshire County,MA,Clarksburg,2009,9.6,92,866,958
1576,Clarksburg,Berkshire County,MA,Clarksburg,2010,8.4,82,898,980
1577,Clarksburg,Berkshire County,MA,Clarksburg,2011,7.8,76,896,972
1578,Clarksburg,Berkshire County,MA,Clarksburg,2012,6.6,63,885,948
1579,Clinton,Worcester County,MA,Clinton,1990,7.1,523,6828,7351
1580,Clinton,Worcester County,MA,Clinton,1991,10.1,722,6458,7180
1581,Clinton,Worcester County,MA,Clinton,1992,10.1,724,6446,7170
1582,Clinton,Worcester County,MA,Clinton,1993,8.4,600,6567,7167
1583,Clinton,Worcester County,MA,Clinton,1994,7.1,504,6605,7109
1584,Clinton,Worcester County,MA,Clinton,1995,6.6,474,6721,7195
1585,Clinton,Worcester County,MA,Clinton,1996,5.3,377,6794,7171
1586,Clinton,Worcester County,MA,Clinton,1997,3.7,268,6931,7199
1587,Clinton,Worcester County,MA,Clinton,1998,3.3,241,7060,7301
1588,Clinton,Worcester County,MA,Clinton,1999,3.8,276,7009,7285
1589,Clinton,Worcester County,MA,Clinton,2000,2.7,194,7072,7266
1590,Clinton,Worcester County,MA,Clinton,2001,4.1,302,7086,7388
1591,Clinton,Worcester County,MA,Clinton,2002,5.9,443,7050,7493
1592,Clinton,Worcester County,MA,Clinton,2003,6.6,494,7004,7498
1593,Clinton,Worcester County,MA,Clinton,2004,6.2,464,7049,7513
1594,Clinton,Worcester County,MA,Clinton,2005,5.7,425,7079,7504
1595,Clinton,Worcester County,MA,Clinton,2006,5.5,418,7220,7638
1596,Clinton,Worcester County,MA,Clinton,2007,5.2,396,7205,7601
1597,Clinton,Worcester County,MA,Clinton,2008,6.2,469,7048,7517
1598,Clinton,Worcester County,MA,Clinton,2009,9.5,715,6851,7566
1599,Clinton,Worcester County,MA,Clinton,2010,10.2,748,6588,7336
1600,Clinton,Worcester County,MA,Clinton,2011,9.1,666,6646,7312
1601,Clinton,Worcester County,MA,Clinton,2012,8.5,616,6644,7260
1602,Cohasset,Norfolk County,MA,Cohasset,1990,6.3,255,3766,4021
1603,Cohasset,Norfolk County,MA,Cohasset,1991,6.7,264,3681,3945
1604,Cohasset,Norfolk County,MA,Cohasset,1992,6,235,3708,3943
1605,Cohasset,Norfolk County,MA,Cohasset,1993,4.2,167,3775,3942
1606,Cohasset,Norfolk County,MA,Cohasset,1994,3.4,137,3903,4040
1607,Cohasset,Norfolk County,MA,Cohasset,1995,3,114,3714,3828
1608,Cohasset,Norfolk County,MA,Cohasset,1996,3,117,3774,3891
1609,Cohasset,Norfolk County,MA,Cohasset,1997,2.2,86,3864,3950
1610,Cohasset,Norfolk County,MA,Cohasset,1998,2,82,3922,4004
1611,Cohasset,Norfolk County,MA,Cohasset,1999,1.5,60,3961,4021
1612,Cohasset,Norfolk County,MA,Cohasset,2000,2.1,77,3625,3702
1613,Cohasset,Norfolk County,MA,Cohasset,2001,2.8,105,3618,3723
1614,Cohasset,Norfolk County,MA,Cohasset,2002,4,148,3559,3707
1615,Cohasset,Norfolk County,MA,Cohasset,2003,4.5,164,3504,3668
1616,Cohasset,Norfolk County,MA,Cohasset,2004,4.2,152,3495,3647
1617,Cohasset,Norfolk County,MA,Cohasset,2005,3.5,127,3506,3633
1618,Cohasset,Norfolk County,MA,Cohasset,2006,3.2,115,3506,3621
1619,Cohasset,Norfolk County,MA,Cohasset,2007,3.3,120,3531,3651
1620,Cohasset,Norfolk County,MA,Cohasset,2008,4,146,3534,3680
1621,Cohasset,Norfolk County,MA,Cohasset,2009,6.3,232,3433,3665
1622,Cohasset,Norfolk County,MA,Cohasset,2010,5.6,210,3547,3757
1623,Cohasset,Norfolk County,MA,Cohasset,2011,5,189,3586,3775
1624,Cohasset,Norfolk County,MA,Cohasset,2012,4.8,182,3626,3808
1625,Colrain,Franklin County,MA,Colrain,1990,5,43,822,865
1626,Colrain,Franklin County,MA,Colrain,1991,7.7,67,805,872
1627,Colrain,Franklin County,MA,Colrain,1992,7.4,64,804,868
1628,Colrain,Franklin County,MA,Colrain,1993,7.2,63,811,874
1629,Colrain,Franklin County,MA,Colrain,1994,5.3,47,837,884
1630,Colrain,Franklin County,MA,Colrain,1995,5.2,47,861,908
1631,Colrain,Franklin County,MA,Colrain,1996,4.5,41,863,904
1632,Colrain,Franklin County,MA,Colrain,1997,6.1,57,882,939
1633,Colrain,Franklin County,MA,Colrain,1998,5,48,907,955
1634,Colrain,Franklin County,MA,Colrain,1999,3.1,30,927,957
1635,Colrain,Franklin County,MA,Colrain,2000,2.6,25,944,969
1636,Colrain,Franklin County,MA,Colrain,2001,3.1,30,946,976
1637,Colrain,Franklin County,MA,Colrain,2002,3.8,38,966,1004
1638,Colrain,Franklin County,MA,Colrain,2003,4.9,50,974,1024
1639,Colrain,Franklin County,MA,Colrain,2004,5.4,55,956,1011
1640,Colrain,Franklin County,MA,Colrain,2005,4.5,45,954,999
1641,Colrain,Franklin County,MA,Colrain,2006,4.8,48,955,1003
1642,Colrain,Franklin County,MA,Colrain,2007,3.9,38,943,981
1643,Colrain,Franklin County,MA,Colrain,2008,5.1,51,948,999
1644,Colrain,Franklin County,MA,Colrain,2009,7.6,76,929,1005
1645,Colrain,Franklin County,MA,Colrain,2010,9.2,84,834,918
1646,Colrain,Franklin County,MA,Colrain,2011,6.6,59,836,895
1647,Colrain,Franklin County,MA,Colrain,2012,6.8,61,838,899
1648,Concord,Middlesex County,MA,Concord,1990,3.4,285,8211,8496
1649,Concord,Middlesex County,MA,Concord,1991,3.7,312,8063,8375
1650,Concord,Middlesex County,MA,Concord,1992,4,340,8072,8412
1651,Concord,Middlesex County,MA,Concord,1993,3.7,309,8101,8410
1652,Concord,Middlesex County,MA,Concord,1994,3.1,263,8263,8526
1653,Concord,Middlesex County,MA,Concord,1995,2.5,215,8426,8641
1654,Concord,Middlesex County,MA,Concord,1996,2,179,8590,8769
1655,Concord,Middlesex County,MA,Concord,1997,1.7,151,8801,8952
1656,Concord,Middlesex County,MA,Concord,1998,1.6,141,8885,9026
1657,Concord,Middlesex County,MA,Concord,1999,1.6,142,8966,9108
1658,Concord,Middlesex County,MA,Concord,2000,1.9,152,7712,7864
1659,Concord,Middlesex County,MA,Concord,2001,2.9,231,7663,7894
1660,Concord,Middlesex County,MA,Concord,2002,4.4,346,7508,7854
1661,Concord,Middlesex County,MA,Concord,2003,4.5,346,7384,7730
1662,Concord,Middlesex County,MA,Concord,2004,4,304,7390,7694
1663,Concord,Middlesex County,MA,Concord,2005,3.6,275,7431,7706
1664,Concord,Middlesex County,MA,Concord,2006,3.3,261,7712,7973
1665,Concord,Middlesex County,MA,Concord,2007,2.9,233,7682,7915
1666,Concord,Middlesex County,MA,Concord,2008,3.8,300,7672,7972
1667,Concord,Middlesex County,MA,Concord,2009,5.8,460,7405,7865
1668,Concord,Middlesex County,MA,Concord,2010,5.8,463,7554,8017
1669,Concord,Middlesex County,MA,Concord,2011,4.8,389,7658,8047
1670,Concord,Middlesex County,MA,Concord,2012,4.7,385,7742,8127
1671,Conway,Franklin County,MA,Conway,1990,5.2,46,836,882
1672,Conway,Franklin County,MA,Conway,1991,6.3,56,835,891
1673,Conway,Franklin County,MA,Conway,1992,7.9,71,828,899
1674,Conway,Franklin County,MA,Conway,1993,5.5,50,864,914
1675,Conway,Franklin County,MA,Conway,1994,3.7,36,928,964
1676,Conway,Franklin County,MA,Conway,1995,3.9,36,892,928
1677,Conway,Franklin County,MA,Conway,1996,2.9,27,903,930
1678,Conway,Franklin County,MA,Conway,1997,2.4,23,925,948
1679,Conway,Franklin County,MA,Conway,1998,2.3,22,946,968
1680,Conway,Franklin County,MA,Conway,1999,3,30,972,1002
1681,Conway,Franklin County,MA,Conway,2000,1.9,21,1095,1116
1682,Conway,Franklin County,MA,Conway,2001,2.5,28,1112,1140
1683,Conway,Franklin County,MA,Conway,2002,2.6,30,1119,1149
1684,Conway,Franklin County,MA,Conway,2003,3.4,39,1114,1153
1685,Conway,Franklin County,MA,Conway,2004,3.1,36,1118,1154
1686,Conway,Franklin County,MA,Conway,2005,3.2,37,1132,1169
1687,Conway,Franklin County,MA,Conway,2006,3.2,38,1136,1174
1688,Conway,Franklin County,MA,Conway,2007,2.8,32,1130,1162
1689,Conway,Franklin County,MA,Conway,2008,3.4,40,1127,1167
1690,Conway,Franklin County,MA,Conway,2009,4.9,56,1076,1132
1691,Conway,Franklin County,MA,Conway,2010,5.4,62,1079,1141
1692,Conway,Franklin County,MA,Conway,2011,5.1,58,1071,1129
1693,Conway,Franklin County,MA,Conway,2012,3.9,44,1072,1116
1694,Cummington,Hampshire County,MA,Cummington,1990,6.7,32,448,480
1695,Cummington,Hampshire County,MA,Cummington,1991,11.2,53,422,475
1696,Cummington,Hampshire County,MA,Cummington,1992,12.5,68,475,543
1697,Cummington,Hampshire County,MA,Cummington,1993,8.5,45,485,530
1698,Cummington,Hampshire County,MA,Cummington,1994,7,39,517,556
1699,Cummington,Hampshire County,MA,Cummington,1995,5.1,28,521,549
1700,Cummington,Hampshire County,MA,Cummington,1996,5.6,30,505,535
1701,Cummington,Hampshire County,MA,Cummington,1997,4.5,24,508,532
1702,Cummington,Hampshire County,MA,Cummington,1998,2.9,16,531,547
1703,Cummington,Hampshire County,MA,Cummington,1999,3.2,19,574,593
1704,Cummington,Hampshire County,MA,Cummington,2000,2.5,13,499,512
1705,Cummington,Hampshire County,MA,Cummington,2001,3.5,18,499,517
1706,Cummington,Hampshire County,MA,Cummington,2002,5.2,27,496,523
1707,Cummington,Hampshire County,MA,Cummington,2003,5.5,29,496,525
1708,Cummington,Hampshire County,MA,Cummington,2004,5.7,30,497,527
1709,Cummington,Hampshire County,MA,Cummington,2005,5.5,29,496,525
1710,Cummington,Hampshire County,MA,Cummington,2006,6.8,36,497,533
1711,Cummington,Hampshire County,MA,Cummington,2007,5.2,27,494,521
1712,Cummington,Hampshire County,MA,Cummington,2008,6.2,32,484,516
1713,Cummington,Hampshire County,MA,Cummington,2009,8.5,43,465,508
1714,Cummington,Hampshire County,MA,Cummington,2010,8.3,38,419,457
1715,Cummington,Hampshire County,MA,Cummington,2011,8.4,38,414,452
1716,Cummington,Hampshire County,MA,Cummington,2012,7.2,32,414,446
1717,Dalton,Berkshire County,MA,Dalton,1990,5.1,189,3538,3727
1718,Dalton,Berkshire County,MA,Dalton,1991,8.2,302,3386,3688
1719,Dalton,Berkshire County,MA,Dalton,1992,9.4,348,3353,3701
1720,Dalton,Berkshire County,MA,Dalton,1993,7.9,289,3358,3647
1721,Dalton,Berkshire County,MA,Dalton,1994,6.7,238,3338,3576
1722,Dalton,Berkshire County,MA,Dalton,1995,5,173,3256,3429
1723,Dalton,Berkshire County,MA,Dalton,1996,4.4,152,3309,3461
1724,Dalton,Berkshire County,MA,Dalton,1997,4.2,146,3333,3479
1725,Dalton,Berkshire County,MA,Dalton,1998,3.6,125,3310,3435
1726,Dalton,Berkshire County,MA,Dalton,1999,3.5,120,3311,3431
1727,Dalton,Berkshire County,MA,Dalton,2000,2.4,89,3605,3694
1728,Dalton,Berkshire County,MA,Dalton,2001,3.3,123,3591,3714
1729,Dalton,Berkshire County,MA,Dalton,2002,4,151,3632,3783
1730,Dalton,Berkshire County,MA,Dalton,2003,4.5,171,3604,3775
1731,Dalton,Berkshire County,MA,Dalton,2004,3.9,145,3602,3747
1732,Dalton,Berkshire County,MA,Dalton,2005,3.9,148,3646,3794
1733,Dalton,Berkshire County,MA,Dalton,2006,3.9,149,3702,3851
1734,Dalton,Berkshire County,MA,Dalton,2007,4,151,3670,3821
1735,Dalton,Berkshire County,MA,Dalton,2008,4.4,170,3651,3821
1736,Dalton,Berkshire County,MA,Dalton,2009,7.5,287,3527,3814
1737,Dalton,Berkshire County,MA,Dalton,2010,7.6,290,3508,3798
1738,Dalton,Berkshire County,MA,Dalton,2011,6.6,249,3539,3788
1739,Dalton,Berkshire County,MA,Dalton,2012,6.4,240,3523,3763
1740,Danvers,Essex County,MA,Danvers,1990,5.1,702,13101,13803
1741,Danvers,Essex County,MA,Danvers,1991,6.9,946,12795,13741
1742,Danvers,Essex County,MA,Danvers,1992,7.8,1067,12636,13703
1743,Danvers,Essex County,MA,Danvers,1993,6.1,830,12783,13613
1744,Danvers,Essex County,MA,Danvers,1994,4.6,627,13059,13686
1745,Danvers,Essex County,MA,Danvers,1995,3.9,531,13041,13572
1746,Danvers,Essex County,MA,Danvers,1996,3.1,426,13346,13772
1747,Danvers,Essex County,MA,Danvers,1997,2.9,418,13790,14208
1748,Danvers,Essex County,MA,Danvers,1998,2.7,398,14271,14669
1749,Danvers,Essex County,MA,Danvers,1999,2.3,340,14509,14849
1750,Danvers,Essex County,MA,Danvers,2000,2.2,296,13297,13593
1751,Danvers,Essex County,MA,Danvers,2001,3.2,440,13348,13788
1752,Danvers,Essex County,MA,Danvers,2002,4.7,648,13172,13820
1753,Danvers,Essex County,MA,Danvers,2003,5.3,738,13094,13832
1754,Danvers,Essex County,MA,Danvers,2004,5.1,696,13048,13744
1755,Danvers,Essex County,MA,Danvers,2005,4.4,611,13379,13990
1756,Danvers,Essex County,MA,Danvers,2006,4.3,601,13431,14032
1757,Danvers,Essex County,MA,Danvers,2007,3.9,560,13953,14513
1758,Danvers,Essex County,MA,Danvers,2008,4.8,702,13985,14687
1759,Danvers,Essex County,MA,Danvers,2009,7.6,1133,13806,14939
1760,Danvers,Essex County,MA,Danvers,2010,7.4,1071,13459,14530
1761,Danvers,Essex County,MA,Danvers,2011,6.3,913,13612,14525
1762,Danvers,Essex County,MA,Danvers,2012,6.1,895,13717,14612
1763,Dartmouth,Bristol County,MA,Dartmouth,1990,8.2,1126,12676,13802
1764,Dartmouth,Bristol County,MA,Dartmouth,1991,11.2,1541,12258,13799
1765,Dartmouth,Bristol County,MA,Dartmouth,1992,10.9,1499,12245,13744
1766,Dartmouth,Bristol County,MA,Dartmouth,1993,9.1,1272,12675,13947
1767,Dartmouth,Bristol County,MA,Dartmouth,1994,8.5,1211,13013,14224
1768,Dartmouth,Bristol County,MA,Dartmouth,1995,7.8,1080,12769,13849
1769,Dartmouth,Bristol County,MA,Dartmouth,1996,7,963,12743,13706
1770,Dartmouth,Bristol County,MA,Dartmouth,1997,6.3,878,13121,13999
1771,Dartmouth,Bristol County,MA,Dartmouth,1998,5.1,735,13757,14492
1772,Dartmouth,Bristol County,MA,Dartmouth,1999,4.5,658,13937,14595
1773,Dartmouth,Bristol County,MA,Dartmouth,2000,3.5,544,14810,15354
1774,Dartmouth,Bristol County,MA,Dartmouth,2001,4.2,633,14453,15086
1775,Dartmouth,Bristol County,MA,Dartmouth,2002,5.2,810,14675,15485
1776,Dartmouth,Bristol County,MA,Dartmouth,2003,6.1,933,14453,15386
1777,Dartmouth,Bristol County,MA,Dartmouth,2004,5.6,867,14609,15476
1778,Dartmouth,Bristol County,MA,Dartmouth,2005,5.6,882,14871,15753
1779,Dartmouth,Bristol County,MA,Dartmouth,2006,5.3,852,15118,15970
1780,Dartmouth,Bristol County,MA,Dartmouth,2007,5.5,875,15100,15975
1781,Dartmouth,Bristol County,MA,Dartmouth,2008,6.4,1082,15955,17037
1782,Dartmouth,Bristol County,MA,Dartmouth,2009,9.2,1592,15754,17346
1783,Dartmouth,Bristol County,MA,Dartmouth,2010,9.9,1688,15357,17045
1784,Dartmouth,Bristol County,MA,Dartmouth,2011,8.8,1504,15513,17017
1785,Dartmouth,Bristol County,MA,Dartmouth,2012,8.1,1388,15696,17084
1786,Dedham,Norfolk County,MA,Dedham,1990,5.1,661,12245,12906
1787,Dedham,Norfolk County,MA,Dedham,1991,7.3,934,11821,12755
1788,Dedham,Norfolk County,MA,Dedham,1992,7.9,1005,11705,12710
1789,Dedham,Norfolk County,MA,Dedham,1993,6.8,863,11838,12701
1790,Dedham,Norfolk County,MA,Dedham,1994,5.8,728,11901,12629
1791,Dedham,Norfolk County,MA,Dedham,1995,3.6,615,16581,17196
1792,Dedham,Norfolk County,MA,Dedham,1996,3.1,532,16854,17386
1793,Dedham,Norfolk County,MA,Dedham,1997,3.9,510,12592,13102
1794,Dedham,Norfolk County,MA,Dedham,1998,2.9,381,12714,13095
1795,Dedham,Norfolk County,MA,Dedham,1999,2.5,332,12760,13092
1796,Dedham,Norfolk County,MA,Dedham,2000,2.6,324,12139,12463
1797,Dedham,Norfolk County,MA,Dedham,2001,3.3,411,12040,12451
1798,Dedham,Norfolk County,MA,Dedham,2002,5,622,11791,12413
1799,Dedham,Norfolk County,MA,Dedham,2003,5.3,651,11565,12216
1800,Dedham,Norfolk County,MA,Dedham,2004,5.1,622,11573,12195
1801,Dedham,Norfolk County,MA,Dedham,2005,4.3,538,11949,12487
1802,Dedham,Norfolk County,MA,Dedham,2006,4.4,547,11867,12414
1803,Dedham,Norfolk County,MA,Dedham,2007,3.9,503,12237,12740
1804,Dedham,Norfolk County,MA,Dedham,2008,4.8,623,12356,12979
1805,Dedham,Norfolk County,MA,Dedham,2009,7.5,960,11919,12879
1806,Dedham,Norfolk County,MA,Dedham,2010,7.6,992,12059,13051
1807,Dedham,Norfolk County,MA,Dedham,2011,6.3,824,12191,13015
1808,Dedham,Norfolk County,MA,Dedham,2012,5.9,766,12325,13091
1809,Deerfield,Franklin County,MA,Deerfield,1990,3.7,111,2869,2980
1810,Deerfield,Franklin County,MA,Deerfield,1991,6,182,2835,3017
1811,Deerfield,Franklin County,MA,Deerfield,1992,6.5,193,2782,2975
1812,Deerfield,Franklin County,MA,Deerfield,1993,5.4,161,2805,2966
1813,Deerfield,Franklin County,MA,Deerfield,1994,5.1,158,2915,3073
1814,Deerfield,Franklin County,MA,Deerfield,1995,4.3,127,2847,2974
1815,Deerfield,Franklin County,MA,Deerfield,1996,3.2,94,2858,2952
1816,Deerfield,Franklin County,MA,Deerfield,1997,3.3,100,2922,3022
1817,Deerfield,Franklin County,MA,Deerfield,1998,2.8,89,3094,3183
1818,Deerfield,Franklin County,MA,Deerfield,1999,2.3,74,3144,3218
1819,Deerfield,Franklin County,MA,Deerfield,2000,2.4,66,2738,2804
1820,Deerfield,Franklin County,MA,Deerfield,2001,2.8,80,2748,2828
1821,Deerfield,Franklin County,MA,Deerfield,2002,3.8,109,2735,2844
1822,Deerfield,Franklin County,MA,Deerfield,2003,4.8,136,2700,2836
1823,Deerfield,Franklin County,MA,Deerfield,2004,3.7,103,2713,2816
1824,Deerfield,Franklin County,MA,Deerfield,2005,3.7,105,2716,2821
1825,Deerfield,Franklin County,MA,Deerfield,2006,4,114,2718,2832
1826,Deerfield,Franklin County,MA,Deerfield,2007,3.9,111,2711,2822
1827,Deerfield,Franklin County,MA,Deerfield,2008,4.3,120,2666,2786
1828,Deerfield,Franklin County,MA,Deerfield,2009,7.4,204,2537,2741
1829,Deerfield,Franklin County,MA,Deerfield,2010,6.6,197,2784,2981
1830,Deerfield,Franklin County,MA,Deerfield,2011,6,177,2763,2940
1831,Deerfield,Franklin County,MA,Deerfield,2012,5.9,172,2765,2937
1832,Dennis,Barnstable County,MA,Dennis,1990,6,387,6027,6414
1833,Dennis,Barnstable County,MA,Dennis,1991,9.6,607,5687,6294
1834,Dennis,Barnstable County,MA,Dennis,1992,12.4,797,5609,6406
1835,Dennis,Barnstable County,MA,Dennis,1993,10.1,641,5712,6353
1836,Dennis,Barnstable County,MA,Dennis,1994,9.3,596,5817,6413
1837,Dennis,Barnstable County,MA,Dennis,1995,7.4,488,6090,6578
1838,Dennis,Barnstable County,MA,Dennis,1996,6.3,414,6208,6622
1839,Dennis,Barnstable County,MA,Dennis,1997,6.1,405,6267,6672
1840,Dennis,Barnstable County,MA,Dennis,1998,5.4,366,6362,6728
1841,Dennis,Barnstable County,MA,Dennis,1999,5,342,6564,6906
1842,Dennis,Barnstable County,MA,Dennis,2000,3.8,301,7543,7844
1843,Dennis,Barnstable County,MA,Dennis,2001,4.3,337,7586,7923
1844,Dennis,Barnstable County,MA,Dennis,2002,5.2,421,7693,8114
1845,Dennis,Barnstable County,MA,Dennis,2003,5.8,483,7838,8321
1846,Dennis,Barnstable County,MA,Dennis,2004,5.3,443,7881,8324
1847,Dennis,Barnstable County,MA,Dennis,2005,5.4,447,7812,8259
1848,Dennis,Barnstable County,MA,Dennis,2006,5.3,439,7788,8227
1849,Dennis,Barnstable County,MA,Dennis,2007,5.2,424,7724,8148
1850,Dennis,Barnstable County,MA,Dennis,2008,6.1,499,7653,8152
1851,Dennis,Barnstable County,MA,Dennis,2009,8.8,723,7482,8205
1852,Dennis,Barnstable County,MA,Dennis,2010,9.9,771,6985,7756
1853,Dennis,Barnstable County,MA,Dennis,2011,8.5,649,6973,7622
1854,Dennis,Barnstable County,MA,Dennis,2012,7.5,571,7090,7661
1855,Dighton,Bristol County,MA,Dighton,1990,7,215,2858,3073
1856,Dighton,Bristol County,MA,Dighton,1991,9.6,298,2793,3091
1857,Dighton,Bristol County,MA,Dighton,1992,10.1,315,2809,3124
1858,Dighton,Bristol County,MA,Dighton,1993,8.3,252,2782,3034
1859,Dighton,Bristol County,MA,Dighton,1994,7.5,231,2859,3090
1860,Dighton,Bristol County,MA,Dighton,1995,6.1,190,2926,3116
1861,Dighton,Bristol County,MA,Dighton,1996,4.9,153,2990,3143
1862,Dighton,Bristol County,MA,Dighton,1997,4.7,152,3070,3222
1863,Dighton,Bristol County,MA,Dighton,1998,3.4,111,3113,3224
1864,Dighton,Bristol County,MA,Dighton,1999,3.1,101,3162,3263
1865,Dighton,Bristol County,MA,Dighton,2000,2.7,96,3406,3502
1866,Dighton,Bristol County,MA,Dighton,2001,3.5,125,3453,3578
1867,Dighton,Bristol County,MA,Dighton,2002,4.8,174,3488,3662
1868,Dighton,Bristol County,MA,Dighton,2003,5.2,192,3519,3711
1869,Dighton,Bristol County,MA,Dighton,2004,5.1,191,3533,3724
1870,Dighton,Bristol County,MA,Dighton,2005,4.6,173,3617,3790
1871,Dighton,Bristol County,MA,Dighton,2006,4.7,180,3690,3870
1872,Dighton,Bristol County,MA,Dighton,2007,4.5,178,3739,3917
1873,Dighton,Bristol County,MA,Dighton,2008,5.8,228,3721,3949
1874,Dighton,Bristol County,MA,Dighton,2009,8.5,335,3608,3943
1875,Dighton,Bristol County,MA,Dighton,2010,8.7,360,3757,4117
1876,Dighton,Bristol County,MA,Dighton,2011,6.9,281,3795,4076
1877,Dighton,Bristol County,MA,Dighton,2012,6.7,272,3784,4056
1878,Douglas,Worcester County,MA,Douglas,1990,7.9,231,2696,2927
1879,Douglas,Worcester County,MA,Douglas,1991,10.1,303,2683,2986
1880,Douglas,Worcester County,MA,Douglas,1992,9.8,307,2832,3139
1881,Douglas,Worcester County,MA,Douglas,1993,5.3,170,3034,3204
1882,Douglas,Worcester County,MA,Douglas,1994,5,169,3194,3363
1883,Douglas,Worcester County,MA,Douglas,1995,4.5,138,2912,3050
1884,Douglas,Worcester County,MA,Douglas,1996,4.1,131,3048,3179
1885,Douglas,Worcester County,MA,Douglas,1997,3.2,108,3231,3339
1886,Douglas,Worcester County,MA,Douglas,1998,2.8,100,3533,3633
1887,Douglas,Worcester County,MA,Douglas,1999,3.1,116,3608,3724
1888,Douglas,Worcester County,MA,Douglas,2000,2.5,102,4024,4126
1889,Douglas,Worcester County,MA,Douglas,2001,3.3,139,4122,4261
1890,Douglas,Worcester County,MA,Douglas,2002,5.1,223,4161,4384
1891,Douglas,Worcester County,MA,Douglas,2003,5.4,240,4203,4443
1892,Douglas,Worcester County,MA,Douglas,2004,4.8,215,4250,4465
1893,Douglas,Worcester County,MA,Douglas,2005,4.7,213,4305,4518
1894,Douglas,Worcester County,MA,Douglas,2006,4.7,215,4373,4588
1895,Douglas,Worcester County,MA,Douglas,2007,4.8,222,4389,4611
1896,Douglas,Worcester County,MA,Douglas,2008,5.4,246,4324,4570
1897,Douglas,Worcester County,MA,Douglas,2009,8.5,394,4217,4611
1898,Douglas,Worcester County,MA,Douglas,2010,7.6,365,4427,4792
1899,Douglas,Worcester County,MA,Douglas,2011,7,334,4466,4800
1900,Douglas,Worcester County,MA,Douglas,2012,6.5,308,4464,4772
1901,Dover,Norfolk County,MA,Dover,1990,2.9,74,2453,2527
1902,Dover,Norfolk County,MA,Dover,1991,4.5,114,2408,2522
1903,Dover,Norfolk County,MA,Dover,1992,4.9,128,2460,2588
1904,Dover,Norfolk County,MA,Dover,1993,2.8,74,2544,2618
1905,Dover,Norfolk County,MA,Dover,1994,3.4,94,2681,2775
1906,Dover,Norfolk County,MA,Dover,1995,2.7,72,2604,2676
1907,Dover,Norfolk County,MA,Dover,1996,1.7,46,2693,2739
1908,Dover,Norfolk County,MA,Dover,1997,1.8,50,2782,2832
1909,Dover,Norfolk County,MA,Dover,1998,1.3,38,2831,2869
1910,Dover,Norfolk County,MA,Dover,1999,0.9,27,2869,2896
1911,Dover,Norfolk County,MA,Dover,2000,1.5,43,2796,2839
1912,Dover,Norfolk County,MA,Dover,2001,2.4,70,2810,2880
1913,Dover,Norfolk County,MA,Dover,2002,3.5,102,2776,2878
1914,Dover,Norfolk County,MA,Dover,2003,3.4,97,2743,2840
1915,Dover,Norfolk County,MA,Dover,2004,3,84,2734,2818
1916,Dover,Norfolk County,MA,Dover,2005,2.7,76,2755,2831
1917,Dover,Norfolk County,MA,Dover,2006,2.6,72,2715,2787
1918,Dover,Norfolk County,MA,Dover,2007,2.3,65,2739,2804
1919,Dover,Norfolk County,MA,Dover,2008,3.1,88,2748,2836
1920,Dover,Norfolk County,MA,Dover,2009,5.1,145,2671,2816
1921,Dover,Norfolk County,MA,Dover,2010,4.9,135,2644,2779
1922,Dover,Norfolk County,MA,Dover,2011,4.2,117,2673,2790
1923,Dover,Norfolk County,MA,Dover,2012,3.9,110,2703,2813
1924,Dracut,Middlesex County,MA,Dracut,1990,7.5,1149,14209,15358
1925,Dracut,Middlesex County,MA,Dracut,1991,10.3,1585,13860,15445
1926,Dracut,Middlesex County,MA,Dracut,1992,11.2,1765,14008,15773
1927,Dracut,Middlesex County,MA,Dracut,1993,9.6,1498,14141,15639
1928,Dracut,Middlesex County,MA,Dracut,1994,7.7,1206,14443,15649
1929,Dracut,Middlesex County,MA,Dracut,1995,6.3,970,14530,15500
1930,Dracut,Middlesex County,MA,Dracut,1996,4.7,749,15071,15820
1931,Dracut,Middlesex County,MA,Dracut,1997,4,658,15693,16351
1932,Dracut,Middlesex County,MA,Dracut,1998,3.3,541,16088,16629
1933,Dracut,Middlesex County,MA,Dracut,1999,3.3,563,16563,17126
1934,Dracut,Middlesex County,MA,Dracut,2000,2.5,413,15877,16290
1935,Dracut,Middlesex County,MA,Dracut,2001,3.5,584,15966,16550
1936,Dracut,Middlesex County,MA,Dracut,2002,6,995,15640,16635
1937,Dracut,Middlesex County,MA,Dracut,2003,6.1,994,15398,16392
1938,Dracut,Middlesex County,MA,Dracut,2004,5.7,930,15271,16201
1939,Dracut,Middlesex County,MA,Dracut,2005,4.9,799,15494,16293
1940,Dracut,Middlesex County,MA,Dracut,2006,4.7,781,15741,16522
1941,Dracut,Middlesex County,MA,Dracut,2007,4.7,777,15796,16573
1942,Dracut,Middlesex County,MA,Dracut,2008,5.4,892,15755,16647
1943,Dracut,Middlesex County,MA,Dracut,2009,8.6,1438,15252,16690
1944,Dracut,Middlesex County,MA,Dracut,2010,8.7,1470,15387,16857
1945,Dracut,Middlesex County,MA,Dracut,2011,7.3,1217,15555,16772
1946,Dracut,Middlesex County,MA,Dracut,2012,6.7,1132,15726,16858
1947,Dudley,Worcester County,MA,Dudley,1990,6.5,337,4863,5200
1948,Dudley,Worcester County,MA,Dudley,1991,9.3,489,4745,5234
1949,Dudley,Worcester County,MA,Dudley,1992,9.9,519,4699,5218
1950,Dudley,Worcester County,MA,Dudley,1993,7.7,399,4789,5188
1951,Dudley,Worcester County,MA,Dudley,1994,5.7,295,4858,5153
1952,Dudley,Worcester County,MA,Dudley,1995,4.9,252,4880,5132
1953,Dudley,Worcester County,MA,Dudley,1996,4.3,225,4974,5199
1954,Dudley,Worcester County,MA,Dudley,1997,4,212,5111,5323
1955,Dudley,Worcester County,MA,Dudley,1998,4.2,220,4967,5187
1956,Dudley,Worcester County,MA,Dudley,1999,3.7,191,4958,5149
1957,Dudley,Worcester County,MA,Dudley,2000,2.7,149,5421,5570
1958,Dudley,Worcester County,MA,Dudley,2001,3.8,214,5471,5685
1959,Dudley,Worcester County,MA,Dudley,2002,5.2,305,5520,5825
1960,Dudley,Worcester County,MA,Dudley,2003,6.4,379,5578,5957
1961,Dudley,Worcester County,MA,Dudley,2004,5.6,334,5595,5929
1962,Dudley,Worcester County,MA,Dudley,2005,5.4,321,5597,5918
1963,Dudley,Worcester County,MA,Dudley,2006,5.4,324,5648,5972
1964,Dudley,Worcester County,MA,Dudley,2007,5,301,5695,5996
1965,Dudley,Worcester County,MA,Dudley,2008,5.8,355,5719,6074
1966,Dudley,Worcester County,MA,Dudley,2009,9.1,556,5548,6104
1967,Dudley,Worcester County,MA,Dudley,2010,8.8,547,5644,6191
1968,Dudley,Worcester County,MA,Dudley,2011,7.6,471,5692,6163
1969,Dudley,Worcester County,MA,Dudley,2012,7.1,435,5690,6125
1993,Dunstable,Middlesex County,MA,Dunstable,1990,5.8,78,1272,1350
1994,Dunstable,Middlesex County,MA,Dunstable,1991,7.8,108,1269,1377
1995,Dunstable,Middlesex County,MA,Dunstable,1992,8.1,114,1298,1412
1996,Dunstable,Middlesex County,MA,Dunstable,1993,4.7,65,1331,1396
1997,Dunstable,Middlesex County,MA,Dunstable,1994,4.8,69,1356,1425
1998,Dunstable,Middlesex County,MA,Dunstable,1995,4.3,61,1351,1412
1999,Dunstable,Middlesex County,MA,Dunstable,1996,3.5,52,1432,1484
2000,Dunstable,Middlesex County,MA,Dunstable,1997,3.2,50,1522,1572
2001,Dunstable,Middlesex County,MA,Dunstable,1998,2.7,44,1592,1636
2002,Dunstable,Middlesex County,MA,Dunstable,1999,2.3,40,1679,1719
2003,Dunstable,Middlesex County,MA,Dunstable,2000,2.1,35,1638,1673
2004,Dunstable,Middlesex County,MA,Dunstable,2001,3,52,1685,1737
2005,Dunstable,Middlesex County,MA,Dunstable,2002,5,88,1684,1772
2006,Dunstable,Middlesex County,MA,Dunstable,2003,5,90,1693,1783
2007,Dunstable,Middlesex County,MA,Dunstable,2004,4.2,75,1711,1786
2008,Dunstable,Middlesex County,MA,Dunstable,2005,3.5,64,1752,1816
2009,Dunstable,Middlesex County,MA,Dunstable,2006,3.5,64,1788,1852
2010,Dunstable,Middlesex County,MA,Dunstable,2007,3.3,62,1825,1887
2011,Dunstable,Middlesex County,MA,Dunstable,2008,3.9,74,1838,1912
2012,Dunstable,Middlesex County,MA,Dunstable,2009,6.1,119,1819,1938
2013,Dunstable,Middlesex County,MA,Dunstable,2010,6,110,1720,1830
2014,Dunstable,Middlesex County,MA,Dunstable,2011,5.5,102,1739,1841
2015,Dunstable,Middlesex County,MA,Dunstable,2012,5.3,98,1758,1856
2016,Duxbury,Plymouth County,MA,Duxbury,1990,4.5,320,6829,7149
2017,Duxbury,Plymouth County,MA,Duxbury,1991,5.8,409,6643,7052
2018,Duxbury,Plymouth County,MA,Duxbury,1992,6.5,459,6624,7083
2019,Duxbury,Plymouth County,MA,Duxbury,1993,5.1,362,6786,7148
2020,Duxbury,Plymouth County,MA,Duxbury,1994,4.4,324,7014,7338
2021,Duxbury,Plymouth County,MA,Duxbury,1995,3.5,265,7227,7492
2022,Duxbury,Plymouth County,MA,Duxbury,1996,2.9,219,7422,7641
2023,Duxbury,Plymouth County,MA,Duxbury,1997,2.5,196,7670,7866
2024,Duxbury,Plymouth County,MA,Duxbury,1998,2.2,177,7859,8036
2025,Duxbury,Plymouth County,MA,Duxbury,1999,2.2,182,8013,8195
2026,Duxbury,Plymouth County,MA,Duxbury,2000,2.2,158,7050,7208
2027,Duxbury,Plymouth County,MA,Duxbury,2001,3,221,7074,7295
2028,Duxbury,Plymouth County,MA,Duxbury,2002,4.3,315,7019,7334
2029,Duxbury,Plymouth County,MA,Duxbury,2003,4.4,322,6964,7286
2030,Duxbury,Plymouth County,MA,Duxbury,2004,4,292,6983,7275
2031,Duxbury,Plymouth County,MA,Duxbury,2005,3.9,283,7042,7325
2032,Duxbury,Plymouth County,MA,Duxbury,2006,3.7,255,6724,6979
2033,Duxbury,Plymouth County,MA,Duxbury,2007,3.6,255,6773,7028
2034,Duxbury,Plymouth County,MA,Duxbury,2008,4.4,313,6775,7088
2035,Duxbury,Plymouth County,MA,Duxbury,2009,6.9,491,6584,7075
2036,Duxbury,Plymouth County,MA,Duxbury,2010,6.7,502,7007,7509
2037,Duxbury,Plymouth County,MA,Duxbury,2011,5.4,404,7075,7479
2038,Duxbury,Plymouth County,MA,Duxbury,2012,5.2,395,7152,7547
2039,East Bridgewater,Plymouth County,MA,East Bridgewater,1990,6.5,401,5748,6149
2040,East Bridgewater,Plymouth County,MA,East Bridgewater,1991,11.9,759,5616,6375
2041,East Bridgewater,Plymouth County,MA,East Bridgewater,1992,10.8,689,5673,6362
2042,East Bridgewater,Plymouth County,MA,East Bridgewater,1993,7.4,475,5927,6402
2043,East Bridgewater,Plymouth County,MA,East Bridgewater,1994,6.3,426,6283,6709
2044,East Bridgewater,Plymouth County,MA,East Bridgewater,1995,5.7,380,6306,6686
2045,East Bridgewater,Plymouth County,MA,East Bridgewater,1996,4.7,319,6403,6722
2046,East Bridgewater,Plymouth County,MA,East Bridgewater,1997,4.5,314,6664,6978
2047,East Bridgewater,Plymouth County,MA,East Bridgewater,1998,3.1,216,6811,7027
2048,East Bridgewater,Plymouth County,MA,East Bridgewater,1999,2.8,201,6991,7192
2049,East Bridgewater,Plymouth County,MA,East Bridgewater,2000,2.5,179,6977,7156
2050,East Bridgewater,Plymouth County,MA,East Bridgewater,2001,3.1,228,7030,7258
2051,East Bridgewater,Plymouth County,MA,East Bridgewater,2002,4.6,339,7022,7361
2052,East Bridgewater,Plymouth County,MA,East Bridgewater,2003,5.3,389,6938,7327
2053,East Bridgewater,Plymouth County,MA,East Bridgewater,2004,4.8,352,6934,7286
2054,East Bridgewater,Plymouth County,MA,East Bridgewater,2005,4.7,344,7041,7385
2055,East Bridgewater,Plymouth County,MA,East Bridgewater,2006,4.8,360,7172,7532
2056,East Bridgewater,Plymouth County,MA,East Bridgewater,2007,4.5,338,7241,7579
2057,East Bridgewater,Plymouth County,MA,East Bridgewater,2008,5.6,431,7251,7682
2058,East Bridgewater,Plymouth County,MA,East Bridgewater,2009,8.6,666,7057,7723
2059,East Bridgewater,Plymouth County,MA,East Bridgewater,2010,8.8,664,6898,7562
2060,East Bridgewater,Plymouth County,MA,East Bridgewater,2011,8.1,612,6960,7572
2061,East Bridgewater,Plymouth County,MA,East Bridgewater,2012,7.2,543,7022,7565
2062,East Brookfield,Worcester County,MA,East Brookfield,1990,6.8,72,984,1056
2063,East Brookfield,Worcester County,MA,East Brookfield,1991,13.4,151,975,1126
2064,East Brookfield,Worcester County,MA,East Brookfield,1992,10.7,112,934,1046
2065,East Brookfield,Worcester County,MA,East Brookfield,1993,8.1,86,971,1057
2066,East Brookfield,Worcester County,MA,East Brookfield,1994,5,51,978,1029
2067,East Brookfield,Worcester County,MA,East Brookfield,1995,5.7,59,968,1027
2068,East Brookfield,Worcester County,MA,East Brookfield,1996,6.1,64,978,1042
2069,East Brookfield,Worcester County,MA,East Brookfield,1997,4.6,48,1001,1049
2070,East Brookfield,Worcester County,MA,East Brookfield,1998,3.7,39,1018,1057
2071,East Brookfield,Worcester County,MA,East Brookfield,1999,3.8,40,1015,1055
2072,East Brookfield,Worcester County,MA,East Brookfield,2000,2.9,35,1168,1203
2073,East Brookfield,Worcester County,MA,East Brookfield,2001,3.1,37,1164,1201
2074,East Brookfield,Worcester County,MA,East Brookfield,2002,4.3,52,1154,1206
2075,East Brookfield,Worcester County,MA,East Brookfield,2003,5.2,63,1145,1208
2076,East Brookfield,Worcester County,MA,East Brookfield,2004,5.6,67,1139,1206
2077,East Brookfield,Worcester County,MA,East Brookfield,2005,4.1,48,1130,1178
2078,East Brookfield,Worcester County,MA,East Brookfield,2006,4.3,51,1129,1180
2079,East Brookfield,Worcester County,MA,East Brookfield,2007,4.3,51,1125,1176
2080,East Brookfield,Worcester County,MA,East Brookfield,2008,5.1,59,1097,1156
2081,East Brookfield,Worcester County,MA,East Brookfield,2009,9.1,107,1066,1173
2082,East Brookfield,Worcester County,MA,East Brookfield,2010,8.1,98,1119,1217
2083,East Brookfield,Worcester County,MA,East Brookfield,2011,7.8,95,1128,1223
2084,East Brookfield,Worcester County,MA,East Brookfield,2012,6.6,80,1128,1208
2085,East Longmeadow,Hampden County,MA,East Longmeadow,1990,4.3,299,6585,6884
2086,East Longmeadow,Hampden County,MA,East Longmeadow,1991,6.7,460,6440,6900
2087,East Longmeadow,Hampden County,MA,East Longmeadow,1992,7.5,530,6493,7023
2088,East Longmeadow,Hampden County,MA,East Longmeadow,1993,6.5,461,6585,7046
2089,East Longmeadow,Hampden County,MA,East Longmeadow,1994,5.3,378,6737,7115
2090,East Longmeadow,Hampden County,MA,East Longmeadow,1995,4.6,315,6601,6916
2091,East Longmeadow,Hampden County,MA,East Longmeadow,1996,3.6,251,6742,6993
2092,East Longmeadow,Hampden County,MA,East Longmeadow,1997,3.6,258,6938,7196
2093,East Longmeadow,Hampden County,MA,East Longmeadow,1998,2.9,208,6970,7178
2094,East Longmeadow,Hampden County,MA,East Longmeadow,1999,2.8,201,7004,7205
2095,East Longmeadow,Hampden County,MA,East Longmeadow,2000,2.6,188,7166,7354
2096,East Longmeadow,Hampden County,MA,East Longmeadow,2001,2.9,216,7247,7463
2097,East Longmeadow,Hampden County,MA,East Longmeadow,2002,3.9,294,7301,7595
2098,East Longmeadow,Hampden County,MA,East Longmeadow,2003,4.7,359,7304,7663
2099,East Longmeadow,Hampden County,MA,East Longmeadow,2004,4.3,334,7358,7692
2100,East Longmeadow,Hampden County,MA,East Longmeadow,2005,4.2,325,7424,7749
2101,East Longmeadow,Hampden County,MA,East Longmeadow,2006,3.8,297,7500,7797
2102,East Longmeadow,Hampden County,MA,East Longmeadow,2007,4,318,7664,7982
2103,East Longmeadow,Hampden County,MA,East Longmeadow,2008,4.6,367,7652,8019
2104,East Longmeadow,Hampden County,MA,East Longmeadow,2009,6.5,523,7577,8100
2105,East Longmeadow,Hampden County,MA,East Longmeadow,2010,7.1,572,7506,8078
2106,East Longmeadow,Hampden County,MA,East Longmeadow,2011,6.2,489,7432,7921
2107,East Longmeadow,Hampden County,MA,East Longmeadow,2012,6,472,7437,7909
2108,Eastham,Barnstable County,MA,Eastham,1990,5.9,137,2191,2328
2109,Eastham,Barnstable County,MA,Eastham,1991,9.1,213,2119,2332
2110,Eastham,Barnstable County,MA,Eastham,1992,9.7,224,2094,2318
2111,Eastham,Barnstable County,MA,Eastham,1993,8.8,206,2141,2347
2112,Eastham,Barnstable County,MA,Eastham,1994,7.9,187,2187,2374
2113,Eastham,Barnstable County,MA,Eastham,1995,6.8,168,2306,2474
2114,Eastham,Barnstable County,MA,Eastham,1996,5.7,142,2362,2504
2115,Eastham,Barnstable County,MA,Eastham,1997,5.9,150,2399,2549
2116,Eastham,Barnstable County,MA,Eastham,1998,5.1,131,2458,2589
2117,Eastham,Barnstable County,MA,Eastham,1999,4.2,113,2571,2684
2118,Eastham,Barnstable County,MA,Eastham,2000,4.1,106,2510,2616
2119,Eastham,Barnstable County,MA,Eastham,2001,4.3,114,2550,2664
2120,Eastham,Barnstable County,MA,Eastham,2002,5.3,144,2596,2740
2121,Eastham,Barnstable County,MA,Eastham,2003,5.6,157,2648,2805
2122,Eastham,Barnstable County,MA,Eastham,2004,5.5,154,2670,2824
2123,Eastham,Barnstable County,MA,Eastham,2005,5.5,153,2652,2805
2124,Eastham,Barnstable County,MA,Eastham,2006,5.3,148,2658,2806
2125,Eastham,Barnstable County,MA,Eastham,2007,4.9,136,2643,2779
2126,Eastham,Barnstable County,MA,Eastham,2008,6.2,175,2636,2811
2127,Eastham,Barnstable County,MA,Eastham,2009,8.9,253,2574,2827
2128,Eastham,Barnstable County,MA,Eastham,2010,10.6,280,2368,2648
2129,Eastham,Barnstable County,MA,Eastham,2011,9,234,2365,2599
2130,Eastham,Barnstable County,MA,Eastham,2012,8.9,235,2404,2639
2131,Easthampton,Hampshire County,MA,Easthampton,1990,5.8,498,8136,8634
2132,Easthampton,Hampshire County,MA,Easthampton,1991,8.9,764,7822,8586
2133,Easthampton,Hampshire County,MA,Easthampton,1992,8.8,748,7795,8543
2134,Easthampton,Hampshire County,MA,Easthampton,1993,6.7,564,7814,8378
2135,Easthampton,Hampshire County,MA,Easthampton,1994,6.2,516,7857,8373
2136,Easthampton,Hampshire County,MA,Easthampton,1995,5.9,500,7990,8490
2137,Easthampton,Hampshire County,MA,Easthampton,1996,4.1,347,8127,8474
2138,Easthampton,Hampshire County,MA,Easthampton,1997,3.8,330,8294,8624
2139,Easthampton,Hampshire County,MA,Easthampton,1998,3.7,317,8248,8565
2140,Easthampton,Hampshire County,MA,Easthampton,1999,3.1,265,8303,8568
2141,Easthampton,Hampshire County,MA,Easthampton,2000,2.3,216,9220,9436
2142,Easthampton,Hampshire County,MA,Easthampton,2001,2.9,272,9216,9488
2143,Easthampton,Hampshire County,MA,Easthampton,2002,3.8,365,9191,9556
2144,Easthampton,Hampshire County,MA,Easthampton,2003,4.4,417,9139,9556
2145,Easthampton,Hampshire County,MA,Easthampton,2004,4.1,393,9077,9470
2146,Easthampton,Hampshire County,MA,Easthampton,2005,4.1,384,9077,9461
2147,Easthampton,Hampshire County,MA,Easthampton,2006,3.9,375,9182,9557
2148,Easthampton,Hampshire County,MA,Easthampton,2007,3.9,371,9198,9569
2149,Easthampton,Hampshire County,MA,Easthampton,2008,4.8,460,9191,9651
2150,Easthampton,Hampshire County,MA,Easthampton,2009,7.6,729,8807,9536
2151,Easthampton,Hampshire County,MA,Easthampton,2010,7.8,737,8716,9453
2152,Easthampton,Hampshire County,MA,Easthampton,2011,6.8,625,8608,9233
2153,Easthampton,Hampshire County,MA,Easthampton,2012,6.1,563,8613,9176
2154,Easton,Bristol County,MA,Easton,1990,5.9,672,10667,11339
2155,Easton,Bristol County,MA,Easton,1991,8.8,992,10263,11255
2156,Easton,Bristol County,MA,Easton,1992,9,1012,10173,11185
2157,Easton,Bristol County,MA,Easton,1993,6.8,776,10712,11488
2158,Easton,Bristol County,MA,Easton,1994,6,720,11362,12082
2159,Easton,Bristol County,MA,Easton,1995,4.6,557,11462,12019
2160,Easton,Bristol County,MA,Easton,1996,4.4,531,11574,12105
2161,Easton,Bristol County,MA,Easton,1997,3.8,468,11939,12407
2162,Easton,Bristol County,MA,Easton,1998,2.9,367,12094,12461
2163,Easton,Bristol County,MA,Easton,1999,3,383,12283,12666
2164,Easton,Bristol County,MA,Easton,2000,2.3,300,12782,13082
2165,Easton,Bristol County,MA,Easton,2001,3.1,404,12698,13102
2166,Easton,Bristol County,MA,Easton,2002,4.3,563,12637,13200
2167,Easton,Bristol County,MA,Easton,2003,4.8,630,12458,13088
2168,Easton,Bristol County,MA,Easton,2004,4.5,586,12477,13063
2169,Easton,Bristol County,MA,Easton,2005,4.1,535,12501,13036
2170,Easton,Bristol County,MA,Easton,2006,4.1,535,12665,13200
2171,Easton,Bristol County,MA,Easton,2007,3.7,495,12805,13300
2172,Easton,Bristol County,MA,Easton,2008,4.7,631,12848,13479
2173,Easton,Bristol County,MA,Easton,2009,7.2,953,12297,13250
2174,Easton,Bristol County,MA,Easton,2010,7.3,978,12350,13328
2175,Easton,Bristol County,MA,Easton,2011,6.2,817,12412,13229
2176,Easton,Bristol County,MA,Easton,2012,5.9,787,12521,13308
2177,Edgartown,Dukes County,MA,Edgartown,1990,6.6,142,2007,2149
2178,Edgartown,Dukes County,MA,Edgartown,1991,9.9,224,2042,2266
2179,Edgartown,Dukes County,MA,Edgartown,1992,9.9,212,1936,2148
2180,Edgartown,Dukes County,MA,Edgartown,1993,8.6,192,2051,2243
2181,Edgartown,Dukes County,MA,Edgartown,1994,8.4,203,2209,2412
2182,Edgartown,Dukes County,MA,Edgartown,1995,7.4,187,2330,2517
2183,Edgartown,Dukes County,MA,Edgartown,1996,6.6,173,2432,2605
2184,Edgartown,Dukes County,MA,Edgartown,1997,6.2,164,2498,2662
2185,Edgartown,Dukes County,MA,Edgartown,1998,4.8,130,2594,2724
2186,Edgartown,Dukes County,MA,Edgartown,1999,4.6,126,2636,2762
2187,Edgartown,Dukes County,MA,Edgartown,2000,3.2,81,2484,2565
2188,Edgartown,Dukes County,MA,Edgartown,2001,3.7,96,2491,2587
2189,Edgartown,Dukes County,MA,Edgartown,2002,4.6,126,2584,2710
2190,Edgartown,Dukes County,MA,Edgartown,2003,4.8,135,2687,2822
2191,Edgartown,Dukes County,MA,Edgartown,2004,4.3,123,2705,2828
2192,Edgartown,Dukes County,MA,Edgartown,2005,4.5,126,2678,2804
2193,Edgartown,Dukes County,MA,Edgartown,2006,4.5,128,2704,2832
2194,Edgartown,Dukes County,MA,Edgartown,2007,4,115,2740,2855
2195,Edgartown,Dukes County,MA,Edgartown,2008,4.7,136,2741,2877
2196,Edgartown,Dukes County,MA,Edgartown,2009,7.3,215,2717,2932
2197,Edgartown,Dukes County,MA,Edgartown,2010,8.5,247,2644,2891
2198,Edgartown,Dukes County,MA,Edgartown,2011,8.5,248,2665,2913
2199,Edgartown,Dukes County,MA,Edgartown,2012,7.8,228,2692,2920
2200,Egremont,Berkshire County,MA,Egremont,1990,2.8,19,661,680
2201,Egremont,Berkshire County,MA,Egremont,1991,5.1,35,650,685
2202,Egremont,Berkshire County,MA,Egremont,1992,4.9,35,675,710
2203,Egremont,Berkshire County,MA,Egremont,1993,3.1,21,660,681
2204,Egremont,Berkshire County,MA,Egremont,1994,2.6,18,672,690
2205,Egremont,Berkshire County,MA,Egremont,1995,2,15,718,733
2206,Egremont,Berkshire County,MA,Egremont,1996,2.6,20,737,757
2207,Egremont,Berkshire County,MA,Egremont,1997,2.1,16,754,770
2208,Egremont,Berkshire County,MA,Egremont,1998,2,15,724,739
2209,Egremont,Berkshire County,MA,Egremont,1999,1.9,14,723,737
2210,Egremont,Berkshire County,MA,Egremont,2000,1.5,12,771,783
2211,Egremont,Berkshire County,MA,Egremont,2001,2,16,797,813
2212,Egremont,Berkshire County,MA,Egremont,2002,2.7,23,821,844
2213,Egremont,Berkshire County,MA,Egremont,2003,2.9,25,823,848
2214,Egremont,Berkshire County,MA,Egremont,2004,3.3,28,821,849
2215,Egremont,Berkshire County,MA,Egremont,2005,3.3,29,843,872
2216,Egremont,Berkshire County,MA,Egremont,2006,2.9,25,852,877
2217,Egremont,Berkshire County,MA,Egremont,2007,2.9,25,835,860
2218,Egremont,Berkshire County,MA,Egremont,2008,3.5,30,836,866
2219,Egremont,Berkshire County,MA,Egremont,2009,4.8,41,809,850
2220,Egremont,Berkshire County,MA,Egremont,2010,5.6,44,744,788
2221,Egremont,Berkshire County,MA,Egremont,2011,4.5,35,748,783
2222,Egremont,Berkshire County,MA,Egremont,2012,3.6,28,742,770
2223,Erving,Franklin County,MA,Erving,1990,3.8,28,700,728
2224,Erving,Franklin County,MA,Erving,1991,7.5,55,674,729
2225,Erving,Franklin County,MA,Erving,1992,7.8,55,647,702
2226,Erving,Franklin County,MA,Erving,1993,5.7,40,659,699
2227,Erving,Franklin County,MA,Erving,1994,3.6,25,674,699
2228,Erving,Franklin County,MA,Erving,1995,3.5,26,707,733
2229,Erving,Franklin County,MA,Erving,1996,3,22,713,735
2230,Erving,Franklin County,MA,Erving,1997,3.1,23,730,753
2231,Erving,Franklin County,MA,Erving,1998,3,23,743,766
2232,Erving,Franklin County,MA,Erving,1999,3,23,751,774
2233,Erving,Franklin County,MA,Erving,2000,2.5,20,777,797
2234,Erving,Franklin County,MA,Erving,2001,3.5,28,779,807
2235,Erving,Franklin County,MA,Erving,2002,5.5,46,791,837
2236,Erving,Franklin County,MA,Erving,2003,4.5,38,804,842
2237,Erving,Franklin County,MA,Erving,2004,3.8,32,800,832
2238,Erving,Franklin County,MA,Erving,2005,5.1,43,805,848
2239,Erving,Franklin County,MA,Erving,2006,4.3,37,818,855
2240,Erving,Franklin County,MA,Erving,2007,4.6,39,802,841
2241,Erving,Franklin County,MA,Erving,2008,5.5,46,796,842
2242,Erving,Franklin County,MA,Erving,2009,9.2,78,772,850
2243,Erving,Franklin County,MA,Erving,2010,7.7,76,914,990
2244,Erving,Franklin County,MA,Erving,2011,7,69,915,984
2245,Erving,Franklin County,MA,Erving,2012,5.7,56,918,974
2246,Essex,Essex County,MA,Essex,1990,5.4,101,1761,1862
2247,Essex,Essex County,MA,Essex,1991,7.4,136,1702,1838
2248,Essex,Essex County,MA,Essex,1992,7.8,146,1733,1879
2249,Essex,Essex County,MA,Essex,1993,5.9,113,1809,1922
2250,Essex,Essex County,MA,Essex,1994,4.5,89,1879,1968
2251,Essex,Essex County,MA,Essex,1995,5.1,96,1785,1881
2252,Essex,Essex County,MA,Essex,1996,3.5,66,1827,1893
2253,Essex,Essex County,MA,Essex,1997,3.3,63,1873,1936
2254,Essex,Essex County,MA,Essex,1998,3,60,1914,1974
2255,Essex,Essex County,MA,Essex,1999,2.8,56,1934,1990
2256,Essex,Essex County,MA,Essex,2000,2.5,46,1777,1823
2257,Essex,Essex County,MA,Essex,2001,3.3,61,1794,1855
2258,Essex,Essex County,MA,Essex,2002,4.6,86,1768,1854
2259,Essex,Essex County,MA,Essex,2003,5.2,96,1750,1846
2260,Essex,Essex County,MA,Essex,2004,4.9,91,1750,1841
2261,Essex,Essex County,MA,Essex,2005,4.2,78,1764,1842
2262,Essex,Essex County,MA,Essex,2006,4.2,74,1708,1782
2263,Essex,Essex County,MA,Essex,2007,4.1,74,1725,1799
2264,Essex,Essex County,MA,Essex,2008,5.1,93,1732,1825
2265,Essex,Essex County,MA,Essex,2009,7.3,133,1680,1813
2266,Essex,Essex County,MA,Essex,2010,7.6,147,1789,1936
2267,Essex,Essex County,MA,Essex,2011,6.7,131,1812,1943
2268,Essex,Essex County,MA,Essex,2012,5.9,115,1832,1947
2292,Everett,Middlesex County,MA,Everett,1990,7,1339,17695,19034
2293,Everett,Middlesex County,MA,Everett,1991,9.7,1811,16899,18710
2294,Everett,Middlesex County,MA,Everett,1992,10,1850,16596,18446
2295,Everett,Middlesex County,MA,Everett,1993,8,1424,16480,17904
2296,Everett,Middlesex County,MA,Everett,1994,7.1,1264,16611,17875
2297,Everett,Middlesex County,MA,Everett,1995,6.6,1211,17220,18431
2298,Everett,Middlesex County,MA,Everett,1996,4.9,910,17481,18391
2299,Everett,Middlesex County,MA,Everett,1997,4.5,839,17882,18721
2300,Everett,Middlesex County,MA,Everett,1998,3.8,708,18051,18759
2301,Everett,Middlesex County,MA,Everett,1999,4,761,18110,18871
2302,Everett,Middlesex County,MA,Everett,2000,3.1,593,18813,19406
2303,Everett,Middlesex County,MA,Everett,2001,3.9,755,18674,19429
2304,Everett,Middlesex County,MA,Everett,2002,5.9,1140,18220,19360
2305,Everett,Middlesex County,MA,Everett,2003,7.1,1361,17861,19222
2306,Everett,Middlesex County,MA,Everett,2004,5.7,1079,17721,18800
2307,Everett,Middlesex County,MA,Everett,2005,5.4,1006,17736,18742
2308,Everett,Middlesex County,MA,Everett,2006,5.3,1000,17702,18702
2309,Everett,Middlesex County,MA,Everett,2007,5,940,17922,18862
2310,Everett,Middlesex County,MA,Everett,2008,5.8,1102,17973,19075
2311,Everett,Middlesex County,MA,Everett,2009,8.5,1639,17597,19236
2312,Everett,Middlesex County,MA,Everett,2010,8.3,1756,19432,21188
2313,Everett,Middlesex County,MA,Everett,2011,7.7,1651,19718,21369
2314,Everett,Middlesex County,MA,Everett,2012,6.9,1475,19934,21409
2315,Fairhaven,Bristol County,MA,Fairhaven,1990,8.1,662,7465,8127
2316,Fairhaven,Bristol County,MA,Fairhaven,1991,12.2,1012,7251,8263
2317,Fairhaven,Bristol County,MA,Fairhaven,1992,11.8,967,7236,8203
2318,Fairhaven,Bristol County,MA,Fairhaven,1993,10,823,7412,8235
2319,Fairhaven,Bristol County,MA,Fairhaven,1994,9.2,768,7568,8336
2320,Fairhaven,Bristol County,MA,Fairhaven,1995,8.6,689,7286,7975
2321,Fairhaven,Bristol County,MA,Fairhaven,1996,7.8,614,7212,7826
2322,Fairhaven,Bristol County,MA,Fairhaven,1997,6.5,516,7364,7880
2323,Fairhaven,Bristol County,MA,Fairhaven,1998,5.6,441,7393,7834
2324,Fairhaven,Bristol County,MA,Fairhaven,1999,5.2,411,7436,7847
2325,Fairhaven,Bristol County,MA,Fairhaven,2000,3.6,304,8149,8453
2326,Fairhaven,Bristol County,MA,Fairhaven,2001,4.2,354,8085,8439
2327,Fairhaven,Bristol County,MA,Fairhaven,2002,5.8,500,8130,8630
2328,Fairhaven,Bristol County,MA,Fairhaven,2003,6.4,540,7941,8481
2329,Fairhaven,Bristol County,MA,Fairhaven,2004,5.8,486,7961,8447
2330,Fairhaven,Bristol County,MA,Fairhaven,2005,5.7,488,8036,8524
2331,Fairhaven,Bristol County,MA,Fairhaven,2006,5.7,492,8197,8689
2332,Fairhaven,Bristol County,MA,Fairhaven,2007,5.6,485,8149,8634
2333,Fairhaven,Bristol County,MA,Fairhaven,2008,7.1,605,7929,8534
2334,Fairhaven,Bristol County,MA,Fairhaven,2009,10.1,866,7703,8569
2335,Fairhaven,Bristol County,MA,Fairhaven,2010,10.8,908,7489,8397
2336,Fairhaven,Bristol County,MA,Fairhaven,2011,9.4,785,7567,8352
2337,Fairhaven,Bristol County,MA,Fairhaven,2012,9,760,7656,8416
2338,Fall River,Bristol County,MA,Fall River,1990,12.8,5898,40138,46036
2339,Fall River,Bristol County,MA,Fall River,1991,17.1,7872,38242,46114
2340,Fall River,Bristol County,MA,Fall River,1992,15.5,7034,38221,45255
2341,Fall River,Bristol County,MA,Fall River,1993,15,6781,38500,45281
2342,Fall River,Bristol County,MA,Fall River,1994,11.7,5093,38592,43685
2343,Fall River,Bristol County,MA,Fall River,1995,10.8,4819,39720,44539
2344,Fall River,Bristol County,MA,Fall River,1996,10.2,4512,39754,44266
2345,Fall River,Bristol County,MA,Fall River,1997,8.7,3834,40391,44225
2346,Fall River,Bristol County,MA,Fall River,1998,6.5,2850,40738,43588
2347,Fall River,Bristol County,MA,Fall River,1999,6.3,2744,40917,43661
2348,Fall River,Bristol County,MA,Fall River,2000,5.1,2224,41047,43271
2349,Fall River,Bristol County,MA,Fall River,2001,6.2,2699,40668,43367
2350,Fall River,Bristol County,MA,Fall River,2002,7.8,3474,40888,44362
2351,Fall River,Bristol County,MA,Fall River,2003,8.3,3707,41038,44745
2352,Fall River,Bristol County,MA,Fall River,2004,8.2,3680,40952,44632
2353,Fall River,Bristol County,MA,Fall River,2005,8.1,3604,40902,44506
2354,Fall River,Bristol County,MA,Fall River,2006,8.2,3698,41183,44881
2355,Fall River,Bristol County,MA,Fall River,2007,8.4,3744,41030,44774
2356,Fall River,Bristol County,MA,Fall River,2008,9.5,4248,40428,44676
2357,Fall River,Bristol County,MA,Fall River,2009,14.2,6368,38526,44894
2358,Fall River,Bristol County,MA,Fall River,2010,14.5,6369,37546,43915
2359,Fall River,Bristol County,MA,Fall River,2011,14,6149,37821,43970
2360,Fall River,Bristol County,MA,Fall River,2012,13,5641,37881,43522
2361,Falmouth,Barnstable County,MA,Falmouth,1990,6.1,885,13673,14558
2362,Falmouth,Barnstable County,MA,Falmouth,1991,8.6,1256,13343,14599
2363,Falmouth,Barnstable County,MA,Falmouth,1992,9.1,1322,13235,14557
2364,Falmouth,Barnstable County,MA,Falmouth,1993,7.6,1162,14037,15199
2365,Falmouth,Barnstable County,MA,Falmouth,1994,6.7,1030,14346,15376
2366,Falmouth,Barnstable County,MA,Falmouth,1995,5.7,886,14699,15585
2367,Falmouth,Barnstable County,MA,Falmouth,1996,5.2,823,15037,15860
2368,Falmouth,Barnstable County,MA,Falmouth,1997,4.9,793,15549,16342
2369,Falmouth,Barnstable County,MA,Falmouth,1998,4.2,689,15847,16536
2370,Falmouth,Barnstable County,MA,Falmouth,1999,3.5,575,16053,16628
2371,Falmouth,Barnstable County,MA,Falmouth,2000,2.9,484,16212,16696
2372,Falmouth,Barnstable County,MA,Falmouth,2001,3.4,571,16413,16984
2373,Falmouth,Barnstable County,MA,Falmouth,2002,4.2,728,16742,17470
2374,Falmouth,Barnstable County,MA,Falmouth,2003,4.7,852,17111,17963
2375,Falmouth,Barnstable County,MA,Falmouth,2004,4.6,829,17337,18166
2376,Falmouth,Barnstable County,MA,Falmouth,2005,4.3,780,17356,18136
2377,Falmouth,Barnstable County,MA,Falmouth,2006,4.4,799,17495,18294
2378,Falmouth,Barnstable County,MA,Falmouth,2007,4.3,774,17417,18191
2379,Falmouth,Barnstable County,MA,Falmouth,2008,5.2,941,17330,18271
2380,Falmouth,Barnstable County,MA,Falmouth,2009,7.3,1321,16694,18015
2381,Falmouth,Barnstable County,MA,Falmouth,2010,8.1,1432,16266,17698
2382,Falmouth,Barnstable County,MA,Falmouth,2011,7.4,1302,16239,17541
2383,Falmouth,Barnstable County,MA,Falmouth,2012,6.6,1175,16512,17687
2384,Fitchburg,Worcester County,MA,Fitchburg,1990,9.3,1818,17663,19481
2385,Fitchburg,Worcester County,MA,Fitchburg,1991,11.9,2236,16585,18821
2386,Fitchburg,Worcester County,MA,Fitchburg,1992,10.8,1967,16186,18153
2387,Fitchburg,Worcester County,MA,Fitchburg,1993,8.2,1428,16011,17439
2388,Fitchburg,Worcester County,MA,Fitchburg,1994,7.2,1237,15864,17101
2389,Fitchburg,Worcester County,MA,Fitchburg,1995,6.2,1145,17211,18356
2390,Fitchburg,Worcester County,MA,Fitchburg,1996,6.1,1110,17102,18212
2391,Fitchburg,Worcester County,MA,Fitchburg,1997,5.7,1048,17431,18479
2392,Fitchburg,Worcester County,MA,Fitchburg,1998,4.6,851,17471,18322
2393,Fitchburg,Worcester County,MA,Fitchburg,1999,4.6,837,17387,18224
2394,Fitchburg,Worcester County,MA,Fitchburg,2000,3.5,658,17890,18548
2395,Fitchburg,Worcester County,MA,Fitchburg,2001,4.8,895,17633,18528
2396,Fitchburg,Worcester County,MA,Fitchburg,2002,7,1321,17543,18864
2397,Fitchburg,Worcester County,MA,Fitchburg,2003,7.9,1484,17408,18892
2398,Fitchburg,Worcester County,MA,Fitchburg,2004,7.1,1317,17281,18598
2399,Fitchburg,Worcester County,MA,Fitchburg,2005,7,1294,17149,18443
2400,Fitchburg,Worcester County,MA,Fitchburg,2006,6.8,1258,17299,18557
2401,Fitchburg,Worcester County,MA,Fitchburg,2007,6.4,1175,17279,18454
2402,Fitchburg,Worcester County,MA,Fitchburg,2008,7.3,1361,17220,18581
2403,Fitchburg,Worcester County,MA,Fitchburg,2009,11.1,2131,17031,19162
2404,Fitchburg,Worcester County,MA,Fitchburg,2010,11.7,2200,16637,18837
2405,Fitchburg,Worcester County,MA,Fitchburg,2011,11,2058,16626,18684
2406,Fitchburg,Worcester County,MA,Fitchburg,2012,10,1851,16614,18465
2407,Florida,Berkshire County,MA,Florida,1990,10.8,42,348,390
2408,Florida,Berkshire County,MA,Florida,1991,6.5,24,346,370
2409,Florida,Berkshire County,MA,Florida,1992,12.5,50,350,400
2410,Florida,Berkshire County,MA,Florida,1993,8.3,35,386,421
2411,Florida,Berkshire County,MA,Florida,1994,5.6,22,374,396
2412,Florida,Berkshire County,MA,Florida,1995,5,18,345,363
2413,Florida,Berkshire County,MA,Florida,1996,5.4,20,351,371
2414,Florida,Berkshire County,MA,Florida,1997,7.5,29,357,386
2415,Florida,Berkshire County,MA,Florida,1998,5.2,19,349,368
2416,Florida,Berkshire County,MA,Florida,1999,4.6,17,351,368
2417,Florida,Berkshire County,MA,Florida,2000,3.7,14,367,381
2418,Florida,Berkshire County,MA,Florida,2001,5.4,21,369,390
2419,Florida,Berkshire County,MA,Florida,2002,6.6,26,367,393
2420,Florida,Berkshire County,MA,Florida,2003,9.3,37,363,400
2421,Florida,Berkshire County,MA,Florida,2004,7.9,31,360,391
2422,Florida,Berkshire County,MA,Florida,2005,6.9,27,366,393
2423,Florida,Berkshire County,MA,Florida,2006,6.7,27,377,404
2424,Florida,Berkshire County,MA,Florida,2007,7.3,30,383,413
2425,Florida,Berkshire County,MA,Florida,2008,5.5,22,381,403
2426,Florida,Berkshire County,MA,Florida,2009,9.9,41,373,414
2427,Florida,Berkshire County,MA,Florida,2010,9.1,41,410,451
2428,Florida,Berkshire County,MA,Florida,2011,8.1,36,409,445
2429,Florida,Berkshire County,MA,Florida,2012,7.1,31,404,435
2430,Foxborough,Norfolk County,MA,Foxborough,1990,5.3,443,7965,8408
2431,Foxborough,Norfolk County,MA,Foxborough,1991,7.8,655,7717,8372
2432,Foxborough,Norfolk County,MA,Foxborough,1992,8.3,697,7748,8445
2433,Foxborough,Norfolk County,MA,Foxborough,1993,6.3,534,7877,8411
2434,Foxborough,Norfolk County,MA,Foxborough,1994,5.1,444,8275,8719
2435,Foxborough,Norfolk County,MA,Foxborough,1995,4.5,403,8462,8865
2436,Foxborough,Norfolk County,MA,Foxborough,1996,3.5,317,8755,9072
2437,Foxborough,Norfolk County,MA,Foxborough,1997,3.4,316,9077,9393
2438,Foxborough,Norfolk County,MA,Foxborough,1998,2.4,229,9255,9484
2439,Foxborough,Norfolk County,MA,Foxborough,1999,2.6,250,9375,9625
2440,Foxborough,Norfolk County,MA,Foxborough,2000,2.2,202,8959,9161
2441,Foxborough,Norfolk County,MA,Foxborough,2001,3.1,285,8965,9250
2442,Foxborough,Norfolk County,MA,Foxborough,2002,4.8,441,8810,9251
2443,Foxborough,Norfolk County,MA,Foxborough,2003,5.2,472,8682,9154
2444,Foxborough,Norfolk County,MA,Foxborough,2004,4.6,423,8677,9100
2445,Foxborough,Norfolk County,MA,Foxborough,2005,4.2,388,8744,9132
2446,Foxborough,Norfolk County,MA,Foxborough,2006,4,357,8599,8956
2447,Foxborough,Norfolk County,MA,Foxborough,2007,4,361,8714,9075
2448,Foxborough,Norfolk County,MA,Foxborough,2008,4.9,451,8737,9188
2449,Foxborough,Norfolk County,MA,Foxborough,2009,7.4,695,8754,9449
2450,Foxborough,Norfolk County,MA,Foxborough,2010,7.3,694,8755,9449
2451,Foxborough,Norfolk County,MA,Foxborough,2011,6.4,607,8854,9461
2452,Foxborough,Norfolk County,MA,Foxborough,2012,5.6,535,8951,9486
2453,Framingham,Middlesex County,MA,Framingham,1990,5.2,2015,36371,38386
2454,Framingham,Middlesex County,MA,Framingham,1991,7.1,2658,34988,37646
2455,Framingham,Middlesex County,MA,Framingham,1992,7.5,2772,34347,37119
2456,Framingham,Middlesex County,MA,Framingham,1993,5.8,2107,34528,36635
2457,Framingham,Middlesex County,MA,Framingham,1994,5,1832,34899,36731
2458,Framingham,Middlesex County,MA,Framingham,1995,4.2,1569,35810,37379
2459,Framingham,Middlesex County,MA,Framingham,1996,3.5,1313,36477,37790
2460,Framingham,Middlesex County,MA,Framingham,1997,2.7,1037,37339,38376
2461,Framingham,Middlesex County,MA,Framingham,1998,2.2,859,38051,38910
2462,Framingham,Middlesex County,MA,Framingham,1999,2.4,950,38317,39267
2463,Framingham,Middlesex County,MA,Framingham,2000,2.2,841,36987,37828
2464,Framingham,Middlesex County,MA,Framingham,2001,3,1137,36791,37928
2465,Framingham,Middlesex County,MA,Framingham,2002,4.6,1713,35759,37472
2466,Framingham,Middlesex County,MA,Framingham,2003,4.9,1787,34961,36748
2467,Framingham,Middlesex County,MA,Framingham,2004,4.2,1527,34925,36452
2468,Framingham,Middlesex County,MA,Framingham,2005,3.6,1331,35185,36516
2469,Framingham,Middlesex County,MA,Framingham,2006,3.7,1355,35225,36580
2470,Framingham,Middlesex County,MA,Framingham,2007,3.4,1237,35670,36907
2471,Framingham,Middlesex County,MA,Framingham,2008,4,1504,36050,37554
2472,Framingham,Middlesex County,MA,Framingham,2009,6.2,2352,35600,37952
2473,Framingham,Middlesex County,MA,Framingham,2010,6.2,2375,35828,38203
2474,Framingham,Middlesex County,MA,Framingham,2011,5.3,2041,36157,38198
2475,Framingham,Middlesex County,MA,Framingham,2012,5,1903,36488,38391
2476,Franklin,Norfolk County,MA,Franklin,1990,6,750,11764,12514
2477,Franklin,Norfolk County,MA,Franklin,1991,8,1019,11771,12790
2478,Franklin,Norfolk County,MA,Franklin,1992,7.4,971,12159,13130
2479,Franklin,Norfolk County,MA,Franklin,1993,6,811,12677,13488
2480,Franklin,Norfolk County,MA,Franklin,1994,4.7,653,13369,14022
2481,Franklin,Norfolk County,MA,Franklin,1995,4.6,654,13525,14179
2482,Franklin,Norfolk County,MA,Franklin,1996,3.5,514,14170,14684
2483,Franklin,Norfolk County,MA,Franklin,1997,3,458,14937,15395
2484,Franklin,Norfolk County,MA,Franklin,1998,2.4,373,15445,15818
2485,Franklin,Norfolk County,MA,Franklin,1999,2.3,383,16007,16390
2486,Franklin,Norfolk County,MA,Franklin,2000,2.1,335,15521,15856
2487,Franklin,Norfolk County,MA,Franklin,2001,3.1,496,15559,16055
2488,Franklin,Norfolk County,MA,Franklin,2002,4.6,744,15339,16083
2489,Franklin,Norfolk County,MA,Franklin,2003,5.1,814,15250,16064
2490,Franklin,Norfolk County,MA,Franklin,2004,4.4,696,15246,15942
2491,Franklin,Norfolk County,MA,Franklin,2005,3.9,635,15756,16391
2492,Franklin,Norfolk County,MA,Franklin,2006,3.9,629,15590,16219
2493,Franklin,Norfolk County,MA,Franklin,2007,3.9,636,15807,16443
2494,Franklin,Norfolk County,MA,Franklin,2008,4.6,759,15892,16651
2495,Franklin,Norfolk County,MA,Franklin,2009,7.4,1245,15606,16851
2496,Franklin,Norfolk County,MA,Franklin,2010,7.3,1238,15628,16866
2497,Franklin,Norfolk County,MA,Franklin,2011,6.3,1059,15802,16861
2498,Franklin,Norfolk County,MA,Franklin,2012,5.6,954,15975,16929
2522,Freetown,Bristol County,MA,Freetown,1990,7.2,332,4295,4627
2523,Freetown,Bristol County,MA,Freetown,1991,10.7,494,4110,4604
2524,Freetown,Bristol County,MA,Freetown,1992,11,510,4113,4623
2525,Freetown,Bristol County,MA,Freetown,1993,8.5,394,4225,4619
2526,Freetown,Bristol County,MA,Freetown,1994,7.9,368,4284,4652
2527,Freetown,Bristol County,MA,Freetown,1995,7.7,361,4316,4677
2528,Freetown,Bristol County,MA,Freetown,1996,6.7,310,4290,4600
2529,Freetown,Bristol County,MA,Freetown,1997,6.2,289,4404,4693
2530,Freetown,Bristol County,MA,Freetown,1998,5.3,249,4434,4683
2531,Freetown,Bristol County,MA,Freetown,1999,4.6,218,4499,4717
2532,Freetown,Bristol County,MA,Freetown,2000,3,154,5049,5203
2533,Freetown,Bristol County,MA,Freetown,2001,3.6,189,5052,5241
2534,Freetown,Bristol County,MA,Freetown,2002,4.7,250,5117,5367
2535,Freetown,Bristol County,MA,Freetown,2003,5.5,293,5068,5361
2536,Freetown,Bristol County,MA,Freetown,2004,5.2,283,5157,5440
2537,Freetown,Bristol County,MA,Freetown,2005,5.1,281,5246,5527
2538,Freetown,Bristol County,MA,Freetown,2006,4.7,264,5327,5591
2539,Freetown,Bristol County,MA,Freetown,2007,4.7,265,5325,5590
2540,Freetown,Bristol County,MA,Freetown,2008,5.9,330,5239,5569
2541,Freetown,Bristol County,MA,Freetown,2009,8.5,477,5118,5595
2542,Freetown,Bristol County,MA,Freetown,2010,9,491,4936,5427
2543,Freetown,Bristol County,MA,Freetown,2011,8.2,444,4987,5431
2544,Freetown,Bristol County,MA,Freetown,2012,7.3,398,5046,5444
2545,Gardner,Worcester County,MA,Gardner,1990,9.3,887,8664,9551
2546,Gardner,Worcester County,MA,Gardner,1991,12.2,1177,8497,9674
2547,Gardner,Worcester County,MA,Gardner,1992,10,957,8592,9549
2548,Gardner,Worcester County,MA,Gardner,1993,7.5,715,8810,9525
2549,Gardner,Worcester County,MA,Gardner,1994,7.4,705,8777,9482
2550,Gardner,Worcester County,MA,Gardner,1995,7,657,8699,9356
2551,Gardner,Worcester County,MA,Gardner,1996,6.1,563,8647,9210
2552,Gardner,Worcester County,MA,Gardner,1997,5.3,497,8803,9300
2553,Gardner,Worcester County,MA,Gardner,1998,4.2,387,8782,9169
2554,Gardner,Worcester County,MA,Gardner,1999,4.4,401,8764,9165
2555,Gardner,Worcester County,MA,Gardner,2000,3.3,330,9815,10145
2556,Gardner,Worcester County,MA,Gardner,2001,4.8,487,9672,10159
2557,Gardner,Worcester County,MA,Gardner,2002,6.4,651,9565,10216
2558,Gardner,Worcester County,MA,Gardner,2003,7,713,9468,10181
2559,Gardner,Worcester County,MA,Gardner,2004,6.7,673,9375,10048
2560,Gardner,Worcester County,MA,Gardner,2005,7.1,706,9246,9952
2561,Gardner,Worcester County,MA,Gardner,2006,6.2,614,9280,9894
2562,Gardner,Worcester County,MA,Gardner,2007,6,590,9233,9823
2563,Gardner,Worcester County,MA,Gardner,2008,7.7,758,9139,9897
2564,Gardner,Worcester County,MA,Gardner,2009,11.1,1094,8740,9834
2565,Gardner,Worcester County,MA,Gardner,2010,11.2,1092,8620,9712
2566,Gardner,Worcester County,MA,Gardner,2011,10.4,997,8614,9611
2567,Gardner,Worcester County,MA,Gardner,2012,9.4,888,8607,9495
2568,Georgetown,Essex County,MA,Georgetown,1990,5.2,184,3368,3552
2569,Georgetown,Essex County,MA,Georgetown,1991,7.4,267,3355,3622
2570,Georgetown,Essex County,MA,Georgetown,1992,7.6,283,3429,3712
2571,Georgetown,Essex County,MA,Georgetown,1993,5.1,192,3539,3731
2572,Georgetown,Essex County,MA,Georgetown,1994,5.1,203,3799,4002
2573,Georgetown,Essex County,MA,Georgetown,1995,4.3,167,3732,3899
2574,Georgetown,Essex County,MA,Georgetown,1996,3.2,129,3866,3995
2575,Georgetown,Essex County,MA,Georgetown,1997,3.2,130,3955,4085
2576,Georgetown,Essex County,MA,Georgetown,1998,2.6,113,4218,4331
2577,Georgetown,Essex County,MA,Georgetown,1999,2.4,107,4381,4488
2578,Georgetown,Essex County,MA,Georgetown,2000,2.2,89,4020,4109
2579,Georgetown,Essex County,MA,Georgetown,2001,3,127,4069,4196
2580,Georgetown,Essex County,MA,Georgetown,2002,4.2,176,3975,4151
2581,Georgetown,Essex County,MA,Georgetown,2003,4.6,191,3929,4120
2582,Georgetown,Essex County,MA,Georgetown,2004,4.3,177,3956,4133
2583,Georgetown,Essex County,MA,Georgetown,2005,4,170,4029,4199
2584,Georgetown,Essex County,MA,Georgetown,2006,3.6,153,4100,4253
2585,Georgetown,Essex County,MA,Georgetown,2007,3.7,158,4125,4283
2586,Georgetown,Essex County,MA,Georgetown,2008,4.3,195,4304,4499
2587,Georgetown,Essex County,MA,Georgetown,2009,6.9,312,4210,4522
2588,Georgetown,Essex County,MA,Georgetown,2010,6.7,291,4047,4338
2589,Georgetown,Essex County,MA,Georgetown,2011,5.9,256,4099,4355
2590,Georgetown,Essex County,MA,Georgetown,2012,5.1,223,4153,4376
2591,Gill,Franklin County,MA,Gill,1990,4.2,40,909,949
2592,Gill,Franklin County,MA,Gill,1991,6.6,64,907,971
2593,Gill,Franklin County,MA,Gill,1992,3.8,34,863,897
2594,Gill,Franklin County,MA,Gill,1993,3.8,34,867,901
2595,Gill,Franklin County,MA,Gill,1994,3.4,32,920,952
2596,Gill,Franklin County,MA,Gill,1995,3.1,29,917,946
2597,Gill,Franklin County,MA,Gill,1996,2.9,28,923,951
2598,Gill,Franklin County,MA,Gill,1997,2.6,25,947,972
2599,Gill,Franklin County,MA,Gill,1998,2,19,941,960
2600,Gill,Franklin County,MA,Gill,1999,1.9,19,968,987
2601,Gill,Franklin County,MA,Gill,2000,1.9,15,772,787
2602,Gill,Franklin County,MA,Gill,2001,2.2,17,770,787
2603,Gill,Franklin County,MA,Gill,2002,2.5,20,779,799
2604,Gill,Franklin County,MA,Gill,2003,3.5,28,782,810
2605,Gill,Franklin County,MA,Gill,2004,3.6,29,779,808
2606,Gill,Franklin County,MA,Gill,2005,3.7,30,778,808
2607,Gill,Franklin County,MA,Gill,2006,3.7,30,776,806
2608,Gill,Franklin County,MA,Gill,2007,3.3,26,770,796
2609,Gill,Franklin County,MA,Gill,2008,5.1,41,762,803
2610,Gill,Franklin County,MA,Gill,2009,7.8,63,745,808
2611,Gill,Franklin County,MA,Gill,2010,7.4,65,815,880
2612,Gill,Franklin County,MA,Gill,2011,6.5,57,816,873
2613,Gill,Franklin County,MA,Gill,2012,5.2,45,818,863
2614,Gloucester,Essex County,MA,Gloucester,1990,10.8,1742,14409,16151
2615,Gloucester,Essex County,MA,Gloucester,1991,13.4,2152,13958,16110
2616,Gloucester,Essex County,MA,Gloucester,1992,14.7,2387,13873,16260
2617,Gloucester,Essex County,MA,Gloucester,1993,12.2,1954,14023,15977
2618,Gloucester,Essex County,MA,Gloucester,1994,9.9,1579,14314,15893
2619,Gloucester,Essex County,MA,Gloucester,1995,8.5,1343,14488,15831
2620,Gloucester,Essex County,MA,Gloucester,1996,6.5,1030,14776,15806
2621,Gloucester,Essex County,MA,Gloucester,1997,5.8,938,15217,16155
2622,Gloucester,Essex County,MA,Gloucester,1998,5.4,884,15518,16402
2623,Gloucester,Essex County,MA,Gloucester,1999,4.5,733,15662,16395
2624,Gloucester,Essex County,MA,Gloucester,2000,3.7,601,15844,16445
2625,Gloucester,Essex County,MA,Gloucester,2001,4.9,815,15900,16715
2626,Gloucester,Essex County,MA,Gloucester,2002,6.3,1059,15710,16769
2627,Gloucester,Essex County,MA,Gloucester,2003,6.9,1150,15509,16659
2628,Gloucester,Essex County,MA,Gloucester,2004,6.3,1048,15484,16532
2629,Gloucester,Essex County,MA,Gloucester,2005,5.9,987,15608,16595
2630,Gloucester,Essex County,MA,Gloucester,2006,5.9,959,15164,16123
2631,Gloucester,Essex County,MA,Gloucester,2007,5.4,877,15250,16127
2632,Gloucester,Essex County,MA,Gloucester,2008,6.6,1079,15264,16343
2633,Gloucester,Essex County,MA,Gloucester,2009,9.7,1589,14804,16393
2634,Gloucester,Essex County,MA,Gloucester,2010,10,1575,14170,15745
2635,Gloucester,Essex County,MA,Gloucester,2011,8.7,1360,14342,15702
2636,Gloucester,Essex County,MA,Gloucester,2012,7.8,1232,14499,15731
2637,Goshen,Hampshire County,MA,Goshen,1990,5,26,493,519
2638,Goshen,Hampshire County,MA,Goshen,1991,5.5,28,478,506
2639,Goshen,Hampshire County,MA,Goshen,1992,5.4,29,511,540
2640,Goshen,Hampshire County,MA,Goshen,1993,4.1,23,532,555
2641,Goshen,Hampshire County,MA,Goshen,1994,4.5,27,567,594
2642,Goshen,Hampshire County,MA,Goshen,1995,2.5,15,587,602
2643,Goshen,Hampshire County,MA,Goshen,1996,1.9,11,573,584
2644,Goshen,Hampshire County,MA,Goshen,1997,3,18,577,595
2645,Goshen,Hampshire County,MA,Goshen,1998,1.9,11,557,568
2646,Goshen,Hampshire County,MA,Goshen,1999,1.8,11,604,615
2647,Goshen,Hampshire County,MA,Goshen,2000,1.4,8,564,572
2648,Goshen,Hampshire County,MA,Goshen,2001,1.7,10,569,579
2649,Goshen,Hampshire County,MA,Goshen,2002,2.4,14,570,584
2650,Goshen,Hampshire County,MA,Goshen,2003,3.7,22,572,594
2651,Goshen,Hampshire County,MA,Goshen,2004,3.4,20,573,593
2652,Goshen,Hampshire County,MA,Goshen,2005,2.5,15,574,589
2653,Goshen,Hampshire County,MA,Goshen,2006,3.3,20,580,600
2654,Goshen,Hampshire County,MA,Goshen,2007,2.7,16,580,596
2655,Goshen,Hampshire County,MA,Goshen,2008,4.7,29,585,614
2656,Goshen,Hampshire County,MA,Goshen,2009,6.4,38,560,598
2657,Goshen,Hampshire County,MA,Goshen,2010,5.6,36,606,642
2658,Goshen,Hampshire County,MA,Goshen,2011,4.5,28,599,627
2659,Goshen,Hampshire County,MA,Goshen,2012,5.1,32,599,631
2660,Gosnold,Dukes County,MA,Gosnold,1990,0,0,89,89
2661,Gosnold,Dukes County,MA,Gosnold,1991,0,0,86,86
2662,Gosnold,Dukes County,MA,Gosnold,1992,0,0,73,73
2663,Gosnold,Dukes County,MA,Gosnold,1993,2.3,2,84,86
2664,Gosnold,Dukes County,MA,Gosnold,1994,0,0,87,87
2665,Gosnold,Dukes County,MA,Gosnold,1995,0,0,88,88
2666,Gosnold,Dukes County,MA,Gosnold,1996,0,0,90,90
2667,Gosnold,Dukes County,MA,Gosnold,1997,1.1,1,90,91
2668,Gosnold,Dukes County,MA,Gosnold,1998,0,0,90,90
2669,Gosnold,Dukes County,MA,Gosnold,1999,0,0,89,89
2670,Gosnold,Dukes County,MA,Gosnold,2000,5.4,2,35,37
2671,Gosnold,Dukes County,MA,Gosnold,2001,0,0,35,35
2672,Gosnold,Dukes County,MA,Gosnold,2002,2.8,1,35,36
2673,Gosnold,Dukes County,MA,Gosnold,2003,2.9,1,34,35
2674,Gosnold,Dukes County,MA,Gosnold,2004,2.9,1,34,35
2675,Gosnold,Dukes County,MA,Gosnold,2005,2.8,1,35,36
2676,Gosnold,Dukes County,MA,Gosnold,2006,2.8,1,35,36
2677,Gosnold,Dukes County,MA,Gosnold,2007,5.6,2,34,36
2678,Gosnold,Dukes County,MA,Gosnold,2008,2.9,1,33,34
2679,Gosnold,Dukes County,MA,Gosnold,2009,2.9,1,33,34
2680,Gosnold,Dukes County,MA,Gosnold,2010,12.1,4,29,33
2681,Gosnold,Dukes County,MA,Gosnold,2011,6.5,2,29,31
2682,Gosnold,Dukes County,MA,Gosnold,2012,6.3,2,30,32
2683,Grafton,Worcester County,MA,Grafton,1990,5.7,410,6752,7162
2684,Grafton,Worcester County,MA,Grafton,1991,10.1,732,6532,7264
2685,Grafton,Worcester County,MA,Grafton,1992,8.2,586,6570,7156
2686,Grafton,Worcester County,MA,Grafton,1993,6.3,455,6821,7276
2687,Grafton,Worcester County,MA,Grafton,1994,4.6,333,6898,7231
2688,Grafton,Worcester County,MA,Grafton,1995,4.7,332,6771,7103
2689,Grafton,Worcester County,MA,Grafton,1996,3.9,279,6915,7194
2690,Grafton,Worcester County,MA,Grafton,1997,3.3,244,7166,7410
2691,Grafton,Worcester County,MA,Grafton,1998,3,221,7217,7438
2692,Grafton,Worcester County,MA,Grafton,1999,2.9,223,7343,7566
2693,Grafton,Worcester County,MA,Grafton,2000,2.5,206,8184,8390
2694,Grafton,Worcester County,MA,Grafton,2001,3.2,271,8293,8564
2695,Grafton,Worcester County,MA,Grafton,2002,4.9,433,8414,8847
2696,Grafton,Worcester County,MA,Grafton,2003,5.5,488,8464,8952
2697,Grafton,Worcester County,MA,Grafton,2004,4.9,440,8609,9049
2698,Grafton,Worcester County,MA,Grafton,2005,4.3,402,8896,9298
2699,Grafton,Worcester County,MA,Grafton,2006,4.1,395,9211,9606
2700,Grafton,Worcester County,MA,Grafton,2007,4.4,426,9341,9767
2701,Grafton,Worcester County,MA,Grafton,2008,4.9,478,9182,9660
2702,Grafton,Worcester County,MA,Grafton,2009,8.2,802,8942,9744
2703,Grafton,Worcester County,MA,Grafton,2010,7.6,733,8956,9689
2704,Grafton,Worcester County,MA,Grafton,2011,6.2,593,9036,9629
2705,Grafton,Worcester County,MA,Grafton,2012,6.2,602,9033,9635
2706,Granby,Hampshire County,MA,Granby,1990,6,187,2949,3136
2707,Granby,Hampshire County,MA,Granby,1991,8.4,264,2895,3159
2708,Granby,Hampshire County,MA,Granby,1992,8.3,265,2942,3207
2709,Granby,Hampshire County,MA,Granby,1993,7.3,233,2958,3191
2710,Granby,Hampshire County,MA,Granby,1994,6.4,209,3069,3278
2711,Granby,Hampshire County,MA,Granby,1995,5.2,162,2972,3134
2712,Granby,Hampshire County,MA,Granby,1996,4.9,157,3038,3195
2713,Granby,Hampshire County,MA,Granby,1997,4.7,152,3114,3266
2714,Granby,Hampshire County,MA,Granby,1998,4,132,3150,3282
2715,Granby,Hampshire County,MA,Granby,1999,3,99,3190,3289
2716,Granby,Hampshire County,MA,Granby,2000,2.6,90,3384,3474
2717,Granby,Hampshire County,MA,Granby,2001,3.1,109,3403,3512
2718,Granby,Hampshire County,MA,Granby,2002,4.4,157,3402,3559
2719,Granby,Hampshire County,MA,Granby,2003,4.8,172,3396,3568
2720,Granby,Hampshire County,MA,Granby,2004,4.7,168,3418,3586
2721,Granby,Hampshire County,MA,Granby,2005,4.2,151,3440,3591
2722,Granby,Hampshire County,MA,Granby,2006,4.3,157,3464,3621
2723,Granby,Hampshire County,MA,Granby,2007,4.5,163,3440,3603
2724,Granby,Hampshire County,MA,Granby,2008,5,178,3408,3586
2725,Granby,Hampshire County,MA,Granby,2009,7.8,274,3251,3525
2726,Granby,Hampshire County,MA,Granby,2010,7.3,255,3239,3494
2727,Granby,Hampshire County,MA,Granby,2011,6.8,232,3198,3430
2728,Granby,Hampshire County,MA,Granby,2012,6.8,234,3200,3434
2729,Granville,Hampden County,MA,Granville,1990,3.8,29,734,763
2730,Granville,Hampden County,MA,Granville,1991,7.6,59,718,777
2731,Granville,Hampden County,MA,Granville,1992,6.5,57,819,876
2732,Granville,Hampden County,MA,Granville,1993,6.8,62,845,907
2733,Granville,Hampden County,MA,Granville,1994,6.1,59,904,963
2734,Granville,Hampden County,MA,Granville,1995,5.7,51,849,900
2735,Granville,Hampden County,MA,Granville,1996,5.1,45,831,876
2736,Granville,Hampden County,MA,Granville,1997,3.8,33,841,874
2737,Granville,Hampden County,MA,Granville,1998,3.1,28,887,915
2738,Granville,Hampden County,MA,Granville,1999,2.9,29,967,996
2739,Granville,Hampden County,MA,Granville,2000,2.3,20,850,870
2740,Granville,Hampden County,MA,Granville,2001,2.4,21,861,882
2741,Granville,Hampden County,MA,Granville,2002,3.6,32,869,901
2742,Granville,Hampden County,MA,Granville,2003,3.5,32,873,905
2743,Granville,Hampden County,MA,Granville,2004,3.2,29,887,916
2744,Granville,Hampden County,MA,Granville,2005,3.4,32,902,934
2745,Granville,Hampden County,MA,Granville,2006,3.3,31,920,951
2746,Granville,Hampden County,MA,Granville,2007,3.3,32,927,959
2747,Granville,Hampden County,MA,Granville,2008,4.5,44,924,968
2748,Granville,Hampden County,MA,Granville,2009,8.1,76,861,937
2749,Granville,Hampden County,MA,Granville,2010,9.2,83,821,904
2750,Granville,Hampden County,MA,Granville,2011,7.8,69,813,882
2751,Granville,Hampden County,MA,Granville,2012,7.3,64,814,878
2752,Great Barrington,Berkshire County,MA,Great Barrington,1990,6.1,241,3704,3945
2753,Great Barrington,Berkshire County,MA,Great Barrington,1991,8.4,327,3588,3915
2754,Great Barrington,Berkshire County,MA,Great Barrington,1992,8.5,331,3572,3903
2755,Great Barrington,Berkshire County,MA,Great Barrington,1993,7.3,291,3699,3990
2756,Great Barrington,Berkshire County,MA,Great Barrington,1994,6.1,241,3682,3923
2757,Great Barrington,Berkshire County,MA,Great Barrington,1995,5,211,3985,4196
2758,Great Barrington,Berkshire County,MA,Great Barrington,1996,3.9,163,4070,4233
2759,Great Barrington,Berkshire County,MA,Great Barrington,1997,3.5,151,4160,4311
2760,Great Barrington,Berkshire County,MA,Great Barrington,1998,2.8,120,4212,4332
2761,Great Barrington,Berkshire County,MA,Great Barrington,1999,2.7,115,4195,4310
2762,Great Barrington,Berkshire County,MA,Great Barrington,2000,2.5,103,3984,4087
2763,Great Barrington,Berkshire County,MA,Great Barrington,2001,2.9,121,4118,4239
2764,Great Barrington,Berkshire County,MA,Great Barrington,2002,3.5,153,4230,4383
2765,Great Barrington,Berkshire County,MA,Great Barrington,2003,4.1,179,4212,4391
2766,Great Barrington,Berkshire County,MA,Great Barrington,2004,3.7,163,4185,4348
2767,Great Barrington,Berkshire County,MA,Great Barrington,2005,3.5,153,4272,4425
2768,Great Barrington,Berkshire County,MA,Great Barrington,2006,3.5,156,4304,4460
2769,Great Barrington,Berkshire County,MA,Great Barrington,2007,3.7,164,4210,4374
2770,Great Barrington,Berkshire County,MA,Great Barrington,2008,4.7,206,4224,4430
2771,Great Barrington,Berkshire County,MA,Great Barrington,2009,6.8,300,4093,4393
2772,Great Barrington,Berkshire County,MA,Great Barrington,2010,7,299,3987,4286
2773,Great Barrington,Berkshire County,MA,Great Barrington,2011,6.2,267,4010,4277
2774,Great Barrington,Berkshire County,MA,Great Barrington,2012,5.8,247,3977,4224
2775,Greenfield,Franklin County,MA,Greenfield,1990,5,463,8768,9231
2776,Greenfield,Franklin County,MA,Greenfield,1991,8.2,768,8652,9420
2777,Greenfield,Franklin County,MA,Greenfield,1992,8.7,789,8314,9103
2778,Greenfield,Franklin County,MA,Greenfield,1993,6.8,600,8265,8865
2779,Greenfield,Franklin County,MA,Greenfield,1994,5.5,491,8389,8880
2780,Greenfield,Franklin County,MA,Greenfield,1995,5.1,471,8805,9276
2781,Greenfield,Franklin County,MA,Greenfield,1996,4.2,385,8804,9189
2782,Greenfield,Franklin County,MA,Greenfield,1997,3.8,354,8955,9309
2783,Greenfield,Franklin County,MA,Greenfield,1998,3.6,334,9063,9397
2784,Greenfield,Franklin County,MA,Greenfield,1999,3.3,318,9182,9500
2785,Greenfield,Franklin County,MA,Greenfield,2000,2.7,248,8975,9223
2786,Greenfield,Franklin County,MA,Greenfield,2001,3.5,321,8905,9226
2787,Greenfield,Franklin County,MA,Greenfield,2002,4.5,423,8979,9402
2788,Greenfield,Franklin County,MA,Greenfield,2003,5,468,8954,9422
2789,Greenfield,Franklin County,MA,Greenfield,2004,4.6,425,8762,9187
2790,Greenfield,Franklin County,MA,Greenfield,2005,4.9,447,8701,9148
2791,Greenfield,Franklin County,MA,Greenfield,2006,4.7,431,8683,9114
2792,Greenfield,Franklin County,MA,Greenfield,2007,4.7,428,8636,9064
2793,Greenfield,Franklin County,MA,Greenfield,2008,5.6,508,8559,9067
2794,Greenfield,Franklin County,MA,Greenfield,2009,8.3,759,8336,9095
2795,Greenfield,Franklin County,MA,Greenfield,2010,8.2,741,8290,9031
2796,Greenfield,Franklin County,MA,Greenfield,2011,7.1,632,8301,8933
2797,Greenfield,Franklin County,MA,Greenfield,2012,7,629,8324,8953
2798,Groton,Middlesex County,MA,Groton,1990,4.5,200,4214,4414
2799,Groton,Middlesex County,MA,Groton,1991,7,312,4169,4481
2800,Groton,Middlesex County,MA,Groton,1992,6.8,319,4360,4679
2801,Groton,Middlesex County,MA,Groton,1993,5.1,237,4449,4686
2802,Groton,Middlesex County,MA,Groton,1994,4.8,232,4612,4844
2803,Groton,Middlesex County,MA,Groton,1995,3.9,184,4578,4762
2804,Groton,Middlesex County,MA,Groton,1996,2.9,145,4821,4966
2805,Groton,Middlesex County,MA,Groton,1997,2.8,145,5087,5232
2806,Groton,Middlesex County,MA,Groton,1998,2.6,140,5302,5442
2807,Groton,Middlesex County,MA,Groton,1999,2.4,138,5584,5722
2808,Groton,Middlesex County,MA,Groton,2000,2,105,5050,5155
2809,Groton,Middlesex County,MA,Groton,2001,3.3,174,5139,5313
2810,Groton,Middlesex County,MA,Groton,2002,5.5,300,5135,5435
2811,Groton,Middlesex County,MA,Groton,2003,5,272,5162,5434
2812,Groton,Middlesex County,MA,Groton,2004,4.2,229,5249,5478
2813,Groton,Middlesex County,MA,Groton,2005,3.7,208,5339,5547
2814,Groton,Middlesex County,MA,Groton,2006,3.4,188,5327,5515
2815,Groton,Middlesex County,MA,Groton,2007,3.3,185,5386,5571
2816,Groton,Middlesex County,MA,Groton,2008,4.2,238,5394,5632
2817,Groton,Middlesex County,MA,Groton,2009,6.3,354,5262,5616
2818,Groton,Middlesex County,MA,Groton,2010,6.3,356,5275,5631
2819,Groton,Middlesex County,MA,Groton,2011,5.9,334,5352,5686
2820,Groton,Middlesex County,MA,Groton,2012,5.1,293,5411,5704
2821,Groveland,Essex County,MA,Groveland,1990,6.5,194,2784,2978
2822,Groveland,Essex County,MA,Groveland,1991,8.2,248,2770,3018
2823,Groveland,Essex County,MA,Groveland,1992,7,215,2835,3050
2824,Groveland,Essex County,MA,Groveland,1993,6.8,212,2917,3129
2825,Groveland,Essex County,MA,Groveland,1994,6.1,191,2952,3143
2826,Groveland,Essex County,MA,Groveland,1995,5.1,160,2992,3152
2827,Groveland,Essex County,MA,Groveland,1996,4.4,144,3109,3253
2828,Groveland,Essex County,MA,Groveland,1997,3.7,122,3189,3311
2829,Groveland,Essex County,MA,Groveland,1998,2.9,99,3311,3410
2830,Groveland,Essex County,MA,Groveland,1999,2.8,98,3401,3499
2831,Groveland,Essex County,MA,Groveland,2000,2.2,75,3291,3366
2832,Groveland,Essex County,MA,Groveland,2001,3.2,109,3264,3373
2833,Groveland,Essex County,MA,Groveland,2002,4.6,155,3222,3377
2834,Groveland,Essex County,MA,Groveland,2003,4.8,161,3202,3363
2835,Groveland,Essex County,MA,Groveland,2004,4.7,158,3233,3391
2836,Groveland,Essex County,MA,Groveland,2005,4.1,144,3328,3472
2837,Groveland,Essex County,MA,Groveland,2006,4.1,147,3441,3588
2838,Groveland,Essex County,MA,Groveland,2007,3.7,135,3524,3659
2839,Groveland,Essex County,MA,Groveland,2008,4.2,157,3609,3766
2840,Groveland,Essex County,MA,Groveland,2009,6.8,264,3617,3881
2841,Groveland,Essex County,MA,Groveland,2010,7.3,251,3211,3462
2842,Groveland,Essex County,MA,Groveland,2011,5.9,204,3252,3456
2843,Groveland,Essex County,MA,Groveland,2012,5.8,203,3295,3498
2844,Hadley,Hampshire County,MA,Hadley,1990,4.6,110,2258,2368
2845,Hadley,Hampshire County,MA,Hadley,1991,7.4,174,2185,2359
2846,Hadley,Hampshire County,MA,Hadley,1992,6.5,151,2179,2330
2847,Hadley,Hampshire County,MA,Hadley,1993,4.5,104,2188,2292
2848,Hadley,Hampshire County,MA,Hadley,1994,4.8,114,2238,2352
2849,Hadley,Hampshire County,MA,Hadley,1995,3.3,78,2253,2331
2850,Hadley,Hampshire County,MA,Hadley,1996,3.2,75,2303,2378
2851,Hadley,Hampshire County,MA,Hadley,1997,2.7,65,2378,2443
2852,Hadley,Hampshire County,MA,Hadley,1998,2.2,54,2408,2462
2853,Hadley,Hampshire County,MA,Hadley,1999,2.1,53,2441,2494
2854,Hadley,Hampshire County,MA,Hadley,2000,2.1,54,2530,2584
2855,Hadley,Hampshire County,MA,Hadley,2001,2.4,62,2530,2592
2856,Hadley,Hampshire County,MA,Hadley,2002,3.5,92,2522,2614
2857,Hadley,Hampshire County,MA,Hadley,2003,4.9,130,2512,2642
2858,Hadley,Hampshire County,MA,Hadley,2004,4.4,116,2511,2627
2859,Hadley,Hampshire County,MA,Hadley,2005,4.5,117,2504,2621
2860,Hadley,Hampshire County,MA,Hadley,2006,4.1,108,2516,2624
2861,Hadley,Hampshire County,MA,Hadley,2007,4,104,2510,2614
2862,Hadley,Hampshire County,MA,Hadley,2008,4.2,109,2459,2568
2863,Hadley,Hampshire County,MA,Hadley,2009,6.3,157,2347,2504
2864,Hadley,Hampshire County,MA,Hadley,2010,6.6,184,2611,2795
2865,Hadley,Hampshire County,MA,Hadley,2011,5.9,161,2578,2739
2866,Hadley,Hampshire County,MA,Hadley,2012,5.7,155,2580,2735
2867,Halifax,Plymouth County,MA,Halifax,1990,8,285,3273,3558
2868,Halifax,Plymouth County,MA,Halifax,1991,10.9,387,3156,3543
2869,Halifax,Plymouth County,MA,Halifax,1992,10.7,375,3130,3505
2870,Halifax,Plymouth County,MA,Halifax,1993,8.7,316,3309,3625
2871,Halifax,Plymouth County,MA,Halifax,1994,6.7,252,3514,3766
2872,Halifax,Plymouth County,MA,Halifax,1995,5.5,201,3469,3670
2873,Halifax,Plymouth County,MA,Halifax,1996,6.1,226,3496,3722
2874,Halifax,Plymouth County,MA,Halifax,1997,5.1,195,3629,3824
2875,Halifax,Plymouth County,MA,Halifax,1998,3.4,130,3732,3862
2876,Halifax,Plymouth County,MA,Halifax,1999,3.4,134,3865,3999
2877,Halifax,Plymouth County,MA,Halifax,2000,2.7,111,4069,4180
2878,Halifax,Plymouth County,MA,Halifax,2001,3.4,144,4070,4214
2879,Halifax,Plymouth County,MA,Halifax,2002,4.7,200,4048,4248
2880,Halifax,Plymouth County,MA,Halifax,2003,5.6,237,3977,4214
2881,Halifax,Plymouth County,MA,Halifax,2004,5.3,221,3983,4204
2882,Halifax,Plymouth County,MA,Halifax,2005,5.2,221,4011,4232
2883,Halifax,Plymouth County,MA,Halifax,2006,5.3,228,4051,4279
2884,Halifax,Plymouth County,MA,Halifax,2007,5,214,4060,4274
2885,Halifax,Plymouth County,MA,Halifax,2008,5.9,254,4028,4282
2886,Halifax,Plymouth County,MA,Halifax,2009,8.8,381,3947,4328
2887,Halifax,Plymouth County,MA,Halifax,2010,9.4,395,3799,4194
2888,Halifax,Plymouth County,MA,Halifax,2011,7.9,329,3837,4166
2889,Halifax,Plymouth County,MA,Halifax,2012,7.6,318,3870,4188
2890,Hamilton,Essex County,MA,Hamilton,1990,4.4,163,3526,3689
2891,Hamilton,Essex County,MA,Hamilton,1991,6,222,3448,3670
2892,Hamilton,Essex County,MA,Hamilton,1992,5.4,197,3439,3636
2893,Hamilton,Essex County,MA,Hamilton,1993,4.8,176,3529,3705
2894,Hamilton,Essex County,MA,Hamilton,1994,4.1,154,3599,3753
2895,Hamilton,Essex County,MA,Hamilton,1995,3.2,119,3579,3698
2896,Hamilton,Essex County,MA,Hamilton,1996,2.6,96,3653,3749
2897,Hamilton,Essex County,MA,Hamilton,1997,2.3,88,3748,3836
2898,Hamilton,Essex County,MA,Hamilton,1998,2.2,86,3826,3912
2899,Hamilton,Essex County,MA,Hamilton,1999,1.9,76,3855,3931
2900,Hamilton,Essex County,MA,Hamilton,2000,1.9,75,3926,4001
2901,Hamilton,Essex County,MA,Hamilton,2001,2.9,116,3938,4054
2902,Hamilton,Essex County,MA,Hamilton,2002,4,160,3887,4047
2903,Hamilton,Essex County,MA,Hamilton,2003,4.7,191,3832,4023
2904,Hamilton,Essex County,MA,Hamilton,2004,4.2,167,3820,3987
2905,Hamilton,Essex County,MA,Hamilton,2005,3.8,152,3828,3980
2906,Hamilton,Essex County,MA,Hamilton,2006,3.8,145,3709,3854
2907,Hamilton,Essex County,MA,Hamilton,2007,3.5,137,3729,3866
2908,Hamilton,Essex County,MA,Hamilton,2008,4.4,173,3729,3902
2909,Hamilton,Essex County,MA,Hamilton,2009,6.7,259,3609,3868
2910,Hamilton,Essex County,MA,Hamilton,2010,6.5,240,3448,3688
2911,Hamilton,Essex County,MA,Hamilton,2011,5.3,196,3490,3686
2912,Hamilton,Essex County,MA,Hamilton,2012,4.7,175,3529,3704
2913,Hampden,Hampden County,MA,Hampden,1990,4.6,125,2607,2732
2914,Hampden,Hampden County,MA,Hampden,1991,6.7,181,2530,2711
2915,Hampden,Hampden County,MA,Hampden,1992,7.6,209,2551,2760
2916,Hampden,Hampden County,MA,Hampden,1993,6.8,186,2560,2746
2917,Hampden,Hampden County,MA,Hampden,1994,5.4,147,2578,2725
2918,Hampden,Hampden County,MA,Hampden,1995,5.1,136,2551,2687
2919,Hampden,Hampden County,MA,Hampden,1996,4,109,2586,2695
2920,Hampden,Hampden County,MA,Hampden,1997,3.1,84,2650,2734
2921,Hampden,Hampden County,MA,Hampden,1998,2.3,64,2671,2735
2922,Hampden,Hampden County,MA,Hampden,1999,2.5,70,2691,2761
2923,Hampden,Hampden County,MA,Hampden,2000,2.4,68,2753,2821
2924,Hampden,Hampden County,MA,Hampden,2001,3,85,2777,2862
2925,Hampden,Hampden County,MA,Hampden,2002,4.2,122,2771,2893
2926,Hampden,Hampden County,MA,Hampden,2003,5.1,148,2765,2913
2927,Hampden,Hampden County,MA,Hampden,2004,5.1,149,2769,2918
2928,Hampden,Hampden County,MA,Hampden,2005,4.3,126,2781,2907
2929,Hampden,Hampden County,MA,Hampden,2006,4,116,2804,2920
2930,Hampden,Hampden County,MA,Hampden,2007,3.9,115,2800,2915
2931,Hampden,Hampden County,MA,Hampden,2008,4.7,140,2825,2965
2932,Hampden,Hampden County,MA,Hampden,2009,7.1,206,2683,2889
2933,Hampden,Hampden County,MA,Hampden,2010,7.8,218,2572,2790
2934,Hampden,Hampden County,MA,Hampden,2011,6.7,184,2547,2731
2935,Hampden,Hampden County,MA,Hampden,2012,6.3,172,2548,2720
2982,Hancock,Berkshire County,MA,Hancock,1990,4.3,16,357,373
2983,Hancock,Berkshire County,MA,Hancock,1991,4.7,17,348,365
2984,Hancock,Berkshire County,MA,Hancock,1992,3.2,13,397,410
2985,Hancock,Berkshire County,MA,Hancock,1993,5.2,23,417,440
2986,Hancock,Berkshire County,MA,Hancock,1994,3.9,16,396,412
2987,Hancock,Berkshire County,MA,Hancock,1995,4.9,17,329,346
2988,Hancock,Berkshire County,MA,Hancock,1996,1.8,6,331,337
2989,Hancock,Berkshire County,MA,Hancock,1997,2.1,7,333,340
2990,Hancock,Berkshire County,MA,Hancock,1998,1.8,4,223,227
2991,Hancock,Berkshire County,MA,Hancock,1999,0.4,1,224,225
2992,Hancock,Berkshire County,MA,Hancock,2000,1,4,388,392
2993,Hancock,Berkshire County,MA,Hancock,2001,1.8,7,391,398
2994,Hancock,Berkshire County,MA,Hancock,2002,2.3,10,424,434
2995,Hancock,Berkshire County,MA,Hancock,2003,2.1,11,516,527
2996,Hancock,Berkshire County,MA,Hancock,2004,3.3,19,554,573
2997,Hancock,Berkshire County,MA,Hancock,2005,2.2,13,572,585
2998,Hancock,Berkshire County,MA,Hancock,2006,2.5,15,589,604
2999,Hancock,Berkshire County,MA,Hancock,2007,1.9,12,619,631
3000,Hancock,Berkshire County,MA,Hancock,2008,2.2,14,631,645
3001,Hancock,Berkshire County,MA,Hancock,2009,2.7,19,697,716
3002,Hancock,Berkshire County,MA,Hancock,2010,5.2,21,382,403
3003,Hancock,Berkshire County,MA,Hancock,2011,4.5,18,385,403
3004,Hancock,Berkshire County,MA,Hancock,2012,5.4,22,384,406
3005,Hanover,Plymouth County,MA,Hanover,1990,5.2,351,6374,6725
3006,Hanover,Plymouth County,MA,Hanover,1991,7.3,500,6309,6809
3007,Hanover,Plymouth County,MA,Hanover,1992,7.7,526,6309,6835
3008,Hanover,Plymouth County,MA,Hanover,1993,6.3,433,6446,6879
3009,Hanover,Plymouth County,MA,Hanover,1994,4.5,312,6564,6876
3010,Hanover,Plymouth County,MA,Hanover,1995,4.6,323,6714,7037
3011,Hanover,Plymouth County,MA,Hanover,1996,3.6,261,6917,7178
3012,Hanover,Plymouth County,MA,Hanover,1997,3.2,237,7180,7417
3013,Hanover,Plymouth County,MA,Hanover,1998,2.2,167,7386,7553
3014,Hanover,Plymouth County,MA,Hanover,1999,2.5,195,7540,7735
3015,Hanover,Plymouth County,MA,Hanover,2000,2.2,156,7055,7211
3016,Hanover,Plymouth County,MA,Hanover,2001,2.8,205,7106,7311
3017,Hanover,Plymouth County,MA,Hanover,2002,3.7,276,7094,7370
3018,Hanover,Plymouth County,MA,Hanover,2003,4.5,335,7047,7382
3019,Hanover,Plymouth County,MA,Hanover,2004,4.2,316,7126,7442
3020,Hanover,Plymouth County,MA,Hanover,2005,4.1,310,7330,7640
3021,Hanover,Plymouth County,MA,Hanover,2006,4.1,302,7152,7454
3022,Hanover,Plymouth County,MA,Hanover,2007,3.7,278,7189,7467
3023,Hanover,Plymouth County,MA,Hanover,2008,4.5,339,7209,7548
3024,Hanover,Plymouth County,MA,Hanover,2009,6.9,521,6998,7519
3025,Hanover,Plymouth County,MA,Hanover,2010,7.2,540,6988,7528
3026,Hanover,Plymouth County,MA,Hanover,2011,6.1,460,7056,7516
3027,Hanover,Plymouth County,MA,Hanover,2012,5.4,411,7133,7544
3028,Hanson,Plymouth County,MA,Hanson,1990,7.4,379,4727,5106
3029,Hanson,Plymouth County,MA,Hanson,1991,11.1,570,4586,5156
3030,Hanson,Plymouth County,MA,Hanson,1992,10.9,557,4562,5119
3031,Hanson,Plymouth County,MA,Hanson,1993,8.2,430,4795,5225
3032,Hanson,Plymouth County,MA,Hanson,1994,5.7,309,5098,5407
3033,Hanson,Plymouth County,MA,Hanson,1995,5.9,317,5034,5351
3034,Hanson,Plymouth County,MA,Hanson,1996,5.3,284,5087,5371
3035,Hanson,Plymouth County,MA,Hanson,1997,4.8,265,5253,5518
3036,Hanson,Plymouth County,MA,Hanson,1998,3.6,196,5324,5520
3037,Hanson,Plymouth County,MA,Hanson,1999,3.4,193,5460,5653
3038,Hanson,Plymouth County,MA,Hanson,2000,2.7,144,5230,5374
3039,Hanson,Plymouth County,MA,Hanson,2001,3.2,175,5252,5427
3040,Hanson,Plymouth County,MA,Hanson,2002,4.6,250,5235,5485
3041,Hanson,Plymouth County,MA,Hanson,2003,5.5,297,5126,5423
3042,Hanson,Plymouth County,MA,Hanson,2004,5.2,280,5138,5418
3043,Hanson,Plymouth County,MA,Hanson,2005,5.1,275,5169,5444
3044,Hanson,Plymouth County,MA,Hanson,2006,4.7,261,5270,5531
3045,Hanson,Plymouth County,MA,Hanson,2007,5,278,5324,5602
3046,Hanson,Plymouth County,MA,Hanson,2008,5.5,311,5321,5632
3047,Hanson,Plymouth County,MA,Hanson,2009,8.4,479,5203,5682
3048,Hanson,Plymouth County,MA,Hanson,2010,9.1,521,5233,5754
3049,Hanson,Plymouth County,MA,Hanson,2011,8,457,5282,5739
3050,Hanson,Plymouth County,MA,Hanson,2012,6.7,385,5329,5714
3051,Hardwick,Worcester County,MA,Hardwick,1990,7.8,92,1092,1184
3052,Hardwick,Worcester County,MA,Hardwick,1991,10.8,128,1058,1186
3053,Hardwick,Worcester County,MA,Hardwick,1992,9.9,115,1052,1167
3054,Hardwick,Worcester County,MA,Hardwick,1993,10.4,124,1068,1192
3055,Hardwick,Worcester County,MA,Hardwick,1994,7.8,90,1060,1150
3056,Hardwick,Worcester County,MA,Hardwick,1995,7.1,84,1093,1177
3057,Hardwick,Worcester County,MA,Hardwick,1996,5.6,64,1088,1152
3058,Hardwick,Worcester County,MA,Hardwick,1997,5.4,64,1120,1184
3059,Hardwick,Worcester County,MA,Hardwick,1998,4.7,55,1120,1175
3060,Hardwick,Worcester County,MA,Hardwick,1999,5,59,1127,1186
3061,Hardwick,Worcester County,MA,Hardwick,2000,3,40,1282,1322
3062,Hardwick,Worcester County,MA,Hardwick,2001,4.1,55,1283,1338
3063,Hardwick,Worcester County,MA,Hardwick,2002,5.4,72,1273,1345
3064,Hardwick,Worcester County,MA,Hardwick,2003,6.7,90,1263,1353
3065,Hardwick,Worcester County,MA,Hardwick,2004,6.4,86,1257,1343
3066,Hardwick,Worcester County,MA,Hardwick,2005,5.5,72,1248,1320
3067,Hardwick,Worcester County,MA,Hardwick,2006,5.6,75,1264,1339
3068,Hardwick,Worcester County,MA,Hardwick,2007,5.8,78,1265,1343
3069,Hardwick,Worcester County,MA,Hardwick,2008,6.2,82,1235,1317
3070,Hardwick,Worcester County,MA,Hardwick,2009,9.8,131,1199,1330
3071,Hardwick,Worcester County,MA,Hardwick,2010,8.6,127,1346,1473
3072,Hardwick,Worcester County,MA,Hardwick,2011,8.6,127,1357,1484
3073,Hardwick,Worcester County,MA,Hardwick,2012,7.1,103,1357,1460
3074,Harvard,Worcester County,MA,Harvard,1990,3.8,140,3586,3726
3075,Harvard,Worcester County,MA,Harvard,1991,3.7,136,3563,3699
3076,Harvard,Worcester County,MA,Harvard,1992,4,139,3363,3502
3077,Harvard,Worcester County,MA,Harvard,1993,4.7,155,3175,3330
3078,Harvard,Worcester County,MA,Harvard,1994,3.5,116,3195,3311
3079,Harvard,Worcester County,MA,Harvard,1995,2.9,100,3333,3433
3080,Harvard,Worcester County,MA,Harvard,1996,1.8,61,3388,3449
3081,Harvard,Worcester County,MA,Harvard,1997,1.8,66,3685,3751
3082,Harvard,Worcester County,MA,Harvard,1998,2,72,3534,3606
3083,Harvard,Worcester County,MA,Harvard,1999,2.1,76,3590,3666
3084,Harvard,Worcester County,MA,Harvard,2000,1.8,52,2878,2930
3085,Harvard,Worcester County,MA,Harvard,2001,2.9,87,2894,2981
3086,Harvard,Worcester County,MA,Harvard,2002,5,151,2860,3011
3087,Harvard,Worcester County,MA,Harvard,2003,4.8,142,2822,2964
3088,Harvard,Worcester County,MA,Harvard,2004,4.2,123,2813,2936
3089,Harvard,Worcester County,MA,Harvard,2005,3.6,106,2837,2943
3090,Harvard,Worcester County,MA,Harvard,2006,3.4,101,2840,2941
3091,Harvard,Worcester County,MA,Harvard,2007,3.1,92,2867,2959
3092,Harvard,Worcester County,MA,Harvard,2008,3.8,111,2825,2936
3093,Harvard,Worcester County,MA,Harvard,2009,6.3,185,2742,2927
3094,Harvard,Worcester County,MA,Harvard,2010,5.8,180,2950,3130
3095,Harvard,Worcester County,MA,Harvard,2011,5,156,2971,3127
3096,Harvard,Worcester County,MA,Harvard,2012,4.9,154,3003,3157
3097,Harwich,Barnstable County,MA,Harwich,1990,7.5,354,4336,4690
3098,Harwich,Barnstable County,MA,Harwich,1991,10.7,510,4236,4746
3099,Harwich,Barnstable County,MA,Harwich,1992,9.6,446,4198,4644
3100,Harwich,Barnstable County,MA,Harwich,1993,9.4,449,4331,4780
3101,Harwich,Barnstable County,MA,Harwich,1994,7.7,376,4488,4864
3102,Harwich,Barnstable County,MA,Harwich,1995,6.8,334,4613,4947
3103,Harwich,Barnstable County,MA,Harwich,1996,5.8,294,4734,5028
3104,Harwich,Barnstable County,MA,Harwich,1997,5.6,287,4819,5106
3105,Harwich,Barnstable County,MA,Harwich,1998,4.7,245,4957,5202
3106,Harwich,Barnstable County,MA,Harwich,1999,4,217,5172,5389
3107,Harwich,Barnstable County,MA,Harwich,2000,3.5,210,5728,5938
3108,Harwich,Barnstable County,MA,Harwich,2001,3.9,238,5794,6032
3109,Harwich,Barnstable County,MA,Harwich,2002,4.8,303,5947,6250
3110,Harwich,Barnstable County,MA,Harwich,2003,5.3,343,6072,6415
3111,Harwich,Barnstable County,MA,Harwich,2004,5.1,330,6122,6452
3112,Harwich,Barnstable County,MA,Harwich,2005,5.3,343,6094,6437
3113,Harwich,Barnstable County,MA,Harwich,2006,5,323,6085,6408
3114,Harwich,Barnstable County,MA,Harwich,2007,5,320,6047,6367
3115,Harwich,Barnstable County,MA,Harwich,2008,6.2,396,5997,6393
3116,Harwich,Barnstable County,MA,Harwich,2009,8.9,568,5808,6376
3117,Harwich,Barnstable County,MA,Harwich,2010,9.6,627,5886,6513
3118,Harwich,Barnstable County,MA,Harwich,2011,8.7,563,5876,6439
3119,Harwich,Barnstable County,MA,Harwich,2012,7.6,489,5974,6463
3120,Hatfield,Hampshire County,MA,Hatfield,1990,6,107,1677,1784
3121,Hatfield,Hampshire County,MA,Hatfield,1991,7.5,130,1608,1738
3122,Hatfield,Hampshire County,MA,Hatfield,1992,8.2,145,1627,1772
3123,Hatfield,Hampshire County,MA,Hatfield,1993,6.9,119,1607,1726
3124,Hatfield,Hampshire County,MA,Hatfield,1994,6.5,112,1608,1720
3125,Hatfield,Hampshire County,MA,Hatfield,1995,4,69,1645,1714
3126,Hatfield,Hampshire County,MA,Hatfield,1996,3.4,59,1674,1733
3127,Hatfield,Hampshire County,MA,Hatfield,1997,3.2,56,1706,1762
3128,Hatfield,Hampshire County,MA,Hatfield,1998,3.1,54,1709,1763
3129,Hatfield,Hampshire County,MA,Hatfield,1999,3.1,55,1727,1782
3130,Hatfield,Hampshire County,MA,Hatfield,2000,2.3,46,1977,2023
3131,Hatfield,Hampshire County,MA,Hatfield,2001,2.4,49,1985,2034
3132,Hatfield,Hampshire County,MA,Hatfield,2002,3.7,76,1991,2067
3133,Hatfield,Hampshire County,MA,Hatfield,2003,4.4,90,1976,2066
3134,Hatfield,Hampshire County,MA,Hatfield,2004,4.3,89,1970,2059
3135,Hatfield,Hampshire County,MA,Hatfield,2005,3.9,80,1964,2044
3136,Hatfield,Hampshire County,MA,Hatfield,2006,3.7,76,1964,2040
3137,Hatfield,Hampshire County,MA,Hatfield,2007,4,81,1967,2048
3138,Hatfield,Hampshire County,MA,Hatfield,2008,4.1,82,1931,2013
3139,Hatfield,Hampshire County,MA,Hatfield,2009,6,118,1855,1973
3140,Hatfield,Hampshire County,MA,Hatfield,2010,5.9,118,1878,1996
3141,Hatfield,Hampshire County,MA,Hatfield,2011,5.8,114,1854,1968
3142,Hatfield,Hampshire County,MA,Hatfield,2012,5.6,110,1855,1965
3143,Haverhill,Essex County,MA,Haverhill,1990,7.1,1891,24679,26570
3144,Haverhill,Essex County,MA,Haverhill,1991,10,2698,24289,26987
3145,Haverhill,Essex County,MA,Haverhill,1992,9.6,2613,24545,27158
3146,Haverhill,Essex County,MA,Haverhill,1993,8.7,2368,24982,27350
3147,Haverhill,Essex County,MA,Haverhill,1994,7.5,2079,25460,27539
3148,Haverhill,Essex County,MA,Haverhill,1995,6.1,1700,26091,27791
3149,Haverhill,Essex County,MA,Haverhill,1996,5,1415,26976,28391
3150,Haverhill,Essex County,MA,Haverhill,1997,5.2,1503,27403,28906
3151,Haverhill,Essex County,MA,Haverhill,1998,4.4,1278,27881,29159
3152,Haverhill,Essex County,MA,Haverhill,1999,4,1190,28610,29800
3153,Haverhill,Essex County,MA,Haverhill,2000,2.7,840,30749,31589
3154,Haverhill,Essex County,MA,Haverhill,2001,4.1,1322,30534,31856
3155,Haverhill,Essex County,MA,Haverhill,2002,6.4,2038,29624,31662
3156,Haverhill,Essex County,MA,Haverhill,2003,6.6,2052,29189,31241
3157,Haverhill,Essex County,MA,Haverhill,2004,5.8,1783,28897,30680
3158,Haverhill,Essex County,MA,Haverhill,2005,5.3,1630,29018,30648
3159,Haverhill,Essex County,MA,Haverhill,2006,5,1542,29252,30794
3160,Haverhill,Essex County,MA,Haverhill,2007,4.8,1478,29162,30640
3161,Haverhill,Essex County,MA,Haverhill,2008,5.9,1852,29391,31243
3162,Haverhill,Essex County,MA,Haverhill,2009,9.2,2878,28571,31449
3163,Haverhill,Essex County,MA,Haverhill,2010,9.1,2885,28946,31831
3164,Haverhill,Essex County,MA,Haverhill,2011,8.1,2600,29316,31916
3165,Haverhill,Essex County,MA,Haverhill,2012,7.3,2328,29701,32029
3166,Hawley,Franklin County,MA,Hawley,1990,3.9,6,146,152
3167,Hawley,Franklin County,MA,Hawley,1991,7.3,11,140,151
3168,Hawley,Franklin County,MA,Hawley,1992,6.3,9,134,143
3169,Hawley,Franklin County,MA,Hawley,1993,7.1,10,130,140
3170,Hawley,Franklin County,MA,Hawley,1994,6,8,126,134
3171,Hawley,Franklin County,MA,Hawley,1995,6.6,11,155,166
3172,Hawley,Franklin County,MA,Hawley,1996,4.3,7,154,161
3173,Hawley,Franklin County,MA,Hawley,1997,4.3,7,157,164
3174,Hawley,Franklin County,MA,Hawley,1998,3.6,6,159,165
3175,Hawley,Franklin County,MA,Hawley,1999,2.4,4,162,166
3176,Hawley,Franklin County,MA,Hawley,2000,2.4,4,166,170
3177,Hawley,Franklin County,MA,Hawley,2001,2.9,5,167,172
3178,Hawley,Franklin County,MA,Hawley,2002,5.1,9,168,177
3179,Hawley,Franklin County,MA,Hawley,2003,6,11,171,182
3180,Hawley,Franklin County,MA,Hawley,2004,4,7,169,176
3181,Hawley,Franklin County,MA,Hawley,2005,4,7,168,175
3182,Hawley,Franklin County,MA,Hawley,2006,4,7,168,175
3183,Hawley,Franklin County,MA,Hawley,2007,4.1,7,164,171
3184,Hawley,Franklin County,MA,Hawley,2008,4.7,8,162,170
3185,Hawley,Franklin County,MA,Hawley,2009,6,10,157,167
3186,Hawley,Franklin County,MA,Hawley,2010,7,12,159,171
3187,Hawley,Franklin County,MA,Hawley,2011,7,12,160,172
3188,Hawley,Franklin County,MA,Hawley,2012,6.4,11,161,172
3189,Heath,Franklin County,MA,Heath,1990,2.6,9,335,344
3190,Heath,Franklin County,MA,Heath,1991,3.9,14,341,355
3191,Heath,Franklin County,MA,Heath,1992,3.9,13,323,336
3192,Heath,Franklin County,MA,Heath,1993,4.1,14,329,343
3193,Heath,Franklin County,MA,Heath,1994,4,14,340,354
3194,Heath,Franklin County,MA,Heath,1995,3.3,12,352,364
3195,Heath,Franklin County,MA,Heath,1996,3.3,12,354,366
3196,Heath,Franklin County,MA,Heath,1997,2.4,9,361,370
3197,Heath,Franklin County,MA,Heath,1998,2.9,11,369,380
3198,Heath,Franklin County,MA,Heath,1999,3.1,12,377,389
3199,Heath,Franklin County,MA,Heath,2000,1.7,8,459,467
3200,Heath,Franklin County,MA,Heath,2001,2.1,10,457,467
3201,Heath,Franklin County,MA,Heath,2002,2.9,14,463,477
3202,Heath,Franklin County,MA,Heath,2003,3.5,17,463,480
3203,Heath,Franklin County,MA,Heath,2004,3.4,16,456,472
3204,Heath,Franklin County,MA,Heath,2005,3,14,454,468
3205,Heath,Franklin County,MA,Heath,2006,3.8,18,455,473
3206,Heath,Franklin County,MA,Heath,2007,3.6,17,449,466
3207,Heath,Franklin County,MA,Heath,2008,4.9,23,443,466
3208,Heath,Franklin County,MA,Heath,2009,5.7,26,429,455
3209,Heath,Franklin County,MA,Heath,2010,7,29,387,416
3210,Heath,Franklin County,MA,Heath,2011,6.1,25,388,413
3211,Heath,Franklin County,MA,Heath,2012,5.1,21,389,410
3212,Hingham,Plymouth County,MA,Hingham,1990,4.3,448,10063,10511
3213,Hingham,Plymouth County,MA,Hingham,1991,6,621,9761,10382
3214,Hingham,Plymouth County,MA,Hingham,1992,6.1,630,9647,10277
3215,Hingham,Plymouth County,MA,Hingham,1993,4.8,489,9796,10285
3216,Hingham,Plymouth County,MA,Hingham,1994,4.2,439,9982,10421
3217,Hingham,Plymouth County,MA,Hingham,1995,3.4,357,10137,10494
3218,Hingham,Plymouth County,MA,Hingham,1996,3.1,333,10353,10686
3219,Hingham,Plymouth County,MA,Hingham,1997,2.7,296,10628,10924
3220,Hingham,Plymouth County,MA,Hingham,1998,2,221,10803,11024
3221,Hingham,Plymouth County,MA,Hingham,1999,1.9,215,10938,11153
3222,Hingham,Plymouth County,MA,Hingham,2000,2,206,9969,10175
3223,Hingham,Plymouth County,MA,Hingham,2001,2.6,272,10005,10277
3224,Hingham,Plymouth County,MA,Hingham,2002,4,411,9877,10288
3225,Hingham,Plymouth County,MA,Hingham,2003,4.4,450,9798,10248
3226,Hingham,Plymouth County,MA,Hingham,2004,3.9,411,10210,10621
3227,Hingham,Plymouth County,MA,Hingham,2005,3.4,363,10468,10831
3228,Hingham,Plymouth County,MA,Hingham,2006,3.6,385,10393,10778
3229,Hingham,Plymouth County,MA,Hingham,2007,3.3,366,10821,11187
3230,Hingham,Plymouth County,MA,Hingham,2008,4,452,10864,11316
3231,Hingham,Plymouth County,MA,Hingham,2009,6.1,698,10827,11525
3232,Hingham,Plymouth County,MA,Hingham,2010,6.1,673,10446,11119
3233,Hingham,Plymouth County,MA,Hingham,2011,5,557,10548,11105
3234,Hingham,Plymouth County,MA,Hingham,2012,4.8,532,10664,11196
3235,Hinsdale,Berkshire County,MA,Hinsdale,1990,8,82,938,1020
3236,Hinsdale,Berkshire County,MA,Hinsdale,1991,11.5,118,904,1022
3237,Hinsdale,Berkshire County,MA,Hinsdale,1992,14.1,148,901,1049
3238,Hinsdale,Berkshire County,MA,Hinsdale,1993,11.1,113,909,1022
3239,Hinsdale,Berkshire County,MA,Hinsdale,1994,10.7,109,905,1014
3240,Hinsdale,Berkshire County,MA,Hinsdale,1995,8,74,850,924
3241,Hinsdale,Berkshire County,MA,Hinsdale,1996,8,75,862,937
3242,Hinsdale,Berkshire County,MA,Hinsdale,1997,7.7,72,868,940
3243,Hinsdale,Berkshire County,MA,Hinsdale,1998,6.7,62,865,927
3244,Hinsdale,Berkshire County,MA,Hinsdale,1999,7.2,67,866,933
3245,Hinsdale,Berkshire County,MA,Hinsdale,2000,3.6,37,995,1032
3246,Hinsdale,Berkshire County,MA,Hinsdale,2001,4.4,46,992,1038
3247,Hinsdale,Berkshire County,MA,Hinsdale,2002,5.7,61,1003,1064
3248,Hinsdale,Berkshire County,MA,Hinsdale,2003,5.8,61,995,1056
3249,Hinsdale,Berkshire County,MA,Hinsdale,2004,4.8,50,991,1041
3250,Hinsdale,Berkshire County,MA,Hinsdale,2005,4.4,46,1002,1048
3251,Hinsdale,Berkshire County,MA,Hinsdale,2006,4.6,49,1012,1061
3252,Hinsdale,Berkshire County,MA,Hinsdale,2007,4.2,48,1097,1145
3253,Hinsdale,Berkshire County,MA,Hinsdale,2008,6.5,75,1076,1151
3254,Hinsdale,Berkshire County,MA,Hinsdale,2009,10.2,119,1044,1163
3255,Hinsdale,Berkshire County,MA,Hinsdale,2010,10.8,130,1072,1202
3256,Hinsdale,Berkshire County,MA,Hinsdale,2011,9.6,115,1082,1197
3257,Hinsdale,Berkshire County,MA,Hinsdale,2012,8.4,99,1077,1176
3258,Holbrook,Norfolk County,MA,Holbrook,1990,6.3,382,5711,6093
3259,Holbrook,Norfolk County,MA,Holbrook,1991,9,546,5512,6058
3260,Holbrook,Norfolk County,MA,Holbrook,1992,9.6,585,5490,6075
3261,Holbrook,Norfolk County,MA,Holbrook,1993,8.3,503,5550,6053
3262,Holbrook,Norfolk County,MA,Holbrook,1994,5.9,357,5651,6008
3263,Holbrook,Norfolk County,MA,Holbrook,1995,5.3,315,5685,6000
3264,Holbrook,Norfolk County,MA,Holbrook,1996,4.5,271,5786,6057
3265,Holbrook,Norfolk County,MA,Holbrook,1997,4.1,252,5917,6169
3266,Holbrook,Norfolk County,MA,Holbrook,1998,3,185,5995,6180
3267,Holbrook,Norfolk County,MA,Holbrook,1999,2.9,181,6058,6239
3268,Holbrook,Norfolk County,MA,Holbrook,2000,2.9,170,5658,5828
3269,Holbrook,Norfolk County,MA,Holbrook,2001,3.6,210,5642,5852
3270,Holbrook,Norfolk County,MA,Holbrook,2002,5.4,315,5558,5873
3271,Holbrook,Norfolk County,MA,Holbrook,2003,6,350,5478,5828
3272,Holbrook,Norfolk County,MA,Holbrook,2004,5.7,331,5472,5803
3273,Holbrook,Norfolk County,MA,Holbrook,2005,5.5,322,5499,5821
3274,Holbrook,Norfolk County,MA,Holbrook,2006,6,341,5389,5730
3275,Holbrook,Norfolk County,MA,Holbrook,2007,5.6,320,5414,5734
3276,Holbrook,Norfolk County,MA,Holbrook,2008,5.9,341,5407,5748
3277,Holbrook,Norfolk County,MA,Holbrook,2009,9,517,5226,5743
3278,Holbrook,Norfolk County,MA,Holbrook,2010,9.1,537,5334,5871
3279,Holbrook,Norfolk County,MA,Holbrook,2011,8,470,5394,5864
3280,Holbrook,Norfolk County,MA,Holbrook,2012,7.1,414,5453,5867
3281,Holden,Worcester County,MA,Holden,1990,4.9,383,7469,7852
3282,Holden,Worcester County,MA,Holden,1991,7.2,565,7261,7826
3283,Holden,Worcester County,MA,Holden,1992,6.8,535,7335,7870
3284,Holden,Worcester County,MA,Holden,1993,5,401,7568,7969
3285,Holden,Worcester County,MA,Holden,1994,4,324,7764,8088
3286,Holden,Worcester County,MA,Holden,1995,3.4,269,7568,7837
3287,Holden,Worcester County,MA,Holden,1996,2.8,220,7691,7911
3288,Holden,Worcester County,MA,Holden,1997,2.6,208,7902,8110
3289,Holden,Worcester County,MA,Holden,1998,2.2,184,8080,8264
3290,Holden,Worcester County,MA,Holden,1999,2.4,201,8087,8288
3291,Holden,Worcester County,MA,Holden,2000,2.1,179,8185,8364
3292,Holden,Worcester County,MA,Holden,2001,2.7,232,8255,8487
3293,Holden,Worcester County,MA,Holden,2002,4.3,373,8230,8603
3294,Holden,Worcester County,MA,Holden,2003,4.9,428,8302,8730
3295,Holden,Worcester County,MA,Holden,2004,4.7,410,8369,8779
3296,Holden,Worcester County,MA,Holden,2005,4.2,362,8342,8704
3297,Holden,Worcester County,MA,Holden,2006,4,365,8723,9088
3298,Holden,Worcester County,MA,Holden,2007,3.9,355,8846,9201
3299,Holden,Worcester County,MA,Holden,2008,4.5,410,8685,9095
3300,Holden,Worcester County,MA,Holden,2009,7.3,669,8467,9136
3301,Holden,Worcester County,MA,Holden,2010,7.2,651,8348,8999
3302,Holden,Worcester County,MA,Holden,2011,6.2,557,8423,8980
3303,Holden,Worcester County,MA,Holden,2012,5.8,517,8420,8937
3304,Holland,Hampden County,MA,Holland,1990,4.8,55,1084,1139
3305,Holland,Hampden County,MA,Holland,1991,7.4,89,1112,1201
3306,Holland,Hampden County,MA,Holland,1992,8,85,981,1066
3307,Holland,Hampden County,MA,Holland,1993,8.1,89,1009,1098
3308,Holland,Hampden County,MA,Holland,1994,8.4,93,1018,1111
3309,Holland,Hampden County,MA,Holland,1995,5.6,58,987,1045
3310,Holland,Hampden County,MA,Holland,1996,5.3,56,994,1050
3311,Holland,Hampden County,MA,Holland,1997,4.5,48,1009,1057
3312,Holland,Hampden County,MA,Holland,1998,3.7,39,1015,1054
3313,Holland,Hampden County,MA,Holland,1999,3.6,38,1005,1043
3314,Holland,Hampden County,MA,Holland,2000,2.9,40,1350,1390
3315,Holland,Hampden County,MA,Holland,2001,3.5,49,1344,1393
3316,Holland,Hampden County,MA,Holland,2002,4.8,67,1340,1407
3317,Holland,Hampden County,MA,Holland,2003,5.9,84,1345,1429
3318,Holland,Hampden County,MA,Holland,2004,5.3,76,1346,1422
3319,Holland,Hampden County,MA,Holland,2005,4.9,70,1369,1439
3320,Holland,Hampden County,MA,Holland,2006,5.4,80,1388,1468
3321,Holland,Hampden County,MA,Holland,2007,5.2,77,1393,1470
3322,Holland,Hampden County,MA,Holland,2008,6.3,91,1354,1445
3323,Holland,Hampden County,MA,Holland,2009,8.5,122,1321,1443
3324,Holland,Hampden County,MA,Holland,2010,9.5,134,1282,1416
3325,Holland,Hampden County,MA,Holland,2011,8,112,1290,1402
3326,Holland,Hampden County,MA,Holland,2012,7.8,109,1290,1399
3327,Holliston,Middlesex County,MA,Holliston,1990,4.9,371,7133,7504
3328,Holliston,Middlesex County,MA,Holliston,1991,6.8,506,6939,7445
3329,Holliston,Middlesex County,MA,Holliston,1992,6.5,483,6933,7416
3330,Holliston,Middlesex County,MA,Holliston,1993,4.6,345,7076,7421
3331,Holliston,Middlesex County,MA,Holliston,1994,4.2,314,7248,7562
3332,Holliston,Middlesex County,MA,Holliston,1995,3.7,281,7251,7532
3333,Holliston,Middlesex County,MA,Holliston,1996,2.9,220,7432,7652
3334,Holliston,Middlesex County,MA,Holliston,1997,2.7,214,7658,7872
3335,Holliston,Middlesex County,MA,Holliston,1998,2.2,179,7813,7992
3336,Holliston,Middlesex County,MA,Holliston,1999,2.1,173,7919,8092
3337,Holliston,Middlesex County,MA,Holliston,2000,2.1,155,7369,7524
3338,Holliston,Middlesex County,MA,Holliston,2001,2.7,208,7405,7613
3339,Holliston,Middlesex County,MA,Holliston,2002,4.7,353,7235,7588
3340,Holliston,Middlesex County,MA,Holliston,2003,4.8,359,7108,7467
3341,Holliston,Middlesex County,MA,Holliston,2004,4.1,308,7141,7449
3342,Holliston,Middlesex County,MA,Holliston,2005,3.6,267,7217,7484
3343,Holliston,Middlesex County,MA,Holliston,2006,3.5,267,7283,7550
3344,Holliston,Middlesex County,MA,Holliston,2007,3.3,252,7397,7649
3345,Holliston,Middlesex County,MA,Holliston,2008,3.8,296,7442,7738
3346,Holliston,Middlesex County,MA,Holliston,2009,6.4,493,7246,7739
3347,Holliston,Middlesex County,MA,Holliston,2010,6.2,452,6846,7298
3348,Holliston,Middlesex County,MA,Holliston,2011,5.6,410,6913,7323
3349,Holliston,Middlesex County,MA,Holliston,2012,5,366,6976,7342
3350,Holyoke,Hampden County,MA,Holyoke,1990,8.7,1542,16161,17703
3351,Holyoke,Hampden County,MA,Holyoke,1991,12.1,2117,15354,17471
3352,Holyoke,Hampden County,MA,Holyoke,1992,11.1,1876,15016,16892
3353,Holyoke,Hampden County,MA,Holyoke,1993,10.3,1688,14669,16357
3354,Holyoke,Hampden County,MA,Holyoke,1994,9.4,1508,14518,16026
3355,Holyoke,Hampden County,MA,Holyoke,1995,8.6,1428,15085,16513
3356,Holyoke,Hampden County,MA,Holyoke,1996,6.6,1073,15197,16270
3357,Holyoke,Hampden County,MA,Holyoke,1997,5.8,958,15479,16437
3358,Holyoke,Hampden County,MA,Holyoke,1998,5.8,952,15470,16422
3359,Holyoke,Hampden County,MA,Holyoke,1999,5,817,15445,16262
3360,Holyoke,Hampden County,MA,Holyoke,2000,4.1,652,15265,15917
3361,Holyoke,Hampden County,MA,Holyoke,2001,5.3,854,15297,16151
3362,Holyoke,Hampden County,MA,Holyoke,2002,7,1140,15200,16340
3363,Holyoke,Hampden County,MA,Holyoke,2003,8,1300,15041,16341
3364,Holyoke,Hampden County,MA,Holyoke,2004,7.5,1211,15037,16248
3365,Holyoke,Hampden County,MA,Holyoke,2005,7.5,1224,15058,16282
3366,Holyoke,Hampden County,MA,Holyoke,2006,7.1,1154,15087,16241
3367,Holyoke,Hampden County,MA,Holyoke,2007,6.7,1082,15119,16201
3368,Holyoke,Hampden County,MA,Holyoke,2008,7.9,1284,15064,16348
3369,Holyoke,Hampden County,MA,Holyoke,2009,11.2,1842,14539,16381
3370,Holyoke,Hampden County,MA,Holyoke,2010,11.3,1835,14389,16224
3371,Holyoke,Hampden County,MA,Holyoke,2011,10.6,1692,14245,15937
3372,Holyoke,Hampden County,MA,Holyoke,2012,10.3,1631,14254,15885
3373,Hopedale,Worcester County,MA,Hopedale,1990,6.9,206,2772,2978
3374,Hopedale,Worcester County,MA,Hopedale,1991,8.2,238,2670,2908
3375,Hopedale,Worcester County,MA,Hopedale,1992,7.9,227,2651,2878
3376,Hopedale,Worcester County,MA,Hopedale,1993,7.2,211,2703,2914
3377,Hopedale,Worcester County,MA,Hopedale,1994,5,143,2743,2886
3378,Hopedale,Worcester County,MA,Hopedale,1995,4.4,126,2720,2846
3379,Hopedale,Worcester County,MA,Hopedale,1996,3.7,106,2760,2866
3380,Hopedale,Worcester County,MA,Hopedale,1997,3.7,110,2826,2936
3381,Hopedale,Worcester County,MA,Hopedale,1998,3.1,91,2885,2976
3382,Hopedale,Worcester County,MA,Hopedale,1999,2.4,73,2967,3040
3383,Hopedale,Worcester County,MA,Hopedale,2000,2.3,73,3164,3237
3384,Hopedale,Worcester County,MA,Hopedale,2001,3.1,102,3201,3303
3385,Hopedale,Worcester County,MA,Hopedale,2002,4.6,152,3179,3331
3386,Hopedale,Worcester County,MA,Hopedale,2003,5.3,176,3163,3339
3387,Hopedale,Worcester County,MA,Hopedale,2004,4.5,151,3199,3350
3388,Hopedale,Worcester County,MA,Hopedale,2005,4.1,141,3260,3401
3389,Hopedale,Worcester County,MA,Hopedale,2006,4,137,3270,3407
3390,Hopedale,Worcester County,MA,Hopedale,2007,3.8,130,3278,3408
3391,Hopedale,Worcester County,MA,Hopedale,2008,4.7,164,3295,3459
3392,Hopedale,Worcester County,MA,Hopedale,2009,7.2,249,3195,3444
3393,Hopedale,Worcester County,MA,Hopedale,2010,7.1,229,2994,3223
3394,Hopedale,Worcester County,MA,Hopedale,2011,6.5,209,3002,3211
3395,Hopedale,Worcester County,MA,Hopedale,2012,5.7,182,3030,3212
3396,Hopkinton,Middlesex County,MA,Hopkinton,1990,4.8,253,4977,5230
3397,Hopkinton,Middlesex County,MA,Hopkinton,1991,6.8,364,4987,5351
3398,Hopkinton,Middlesex County,MA,Hopkinton,1992,6.7,364,5106,5470
3399,Hopkinton,Middlesex County,MA,Hopkinton,1993,5.5,310,5351,5661
3400,Hopkinton,Middlesex County,MA,Hopkinton,1994,4.2,247,5628,5875
3401,Hopkinton,Middlesex County,MA,Hopkinton,1995,4.2,242,5517,5759
3402,Hopkinton,Middlesex County,MA,Hopkinton,1996,3.2,192,5830,6022
3403,Hopkinton,Middlesex County,MA,Hopkinton,1997,2.8,175,6123,6298
3404,Hopkinton,Middlesex County,MA,Hopkinton,1998,2.3,151,6331,6482
3405,Hopkinton,Middlesex County,MA,Hopkinton,1999,2.2,145,6556,6701
3406,Hopkinton,Middlesex County,MA,Hopkinton,2000,2,141,6905,7046
3407,Hopkinton,Middlesex County,MA,Hopkinton,2001,3,219,7056,7275
3408,Hopkinton,Middlesex County,MA,Hopkinton,2002,4.7,342,6960,7302
3409,Hopkinton,Middlesex County,MA,Hopkinton,2003,5,363,6889,7252
3410,Hopkinton,Middlesex County,MA,Hopkinton,2004,4.2,302,6945,7247
3411,Hopkinton,Middlesex County,MA,Hopkinton,2005,3.7,275,7095,7370
3412,Hopkinton,Middlesex County,MA,Hopkinton,2006,3.4,254,7166,7420
3413,Hopkinton,Middlesex County,MA,Hopkinton,2007,3.2,241,7323,7564
3414,Hopkinton,Middlesex County,MA,Hopkinton,2008,3.9,302,7406,7708
3415,Hopkinton,Middlesex County,MA,Hopkinton,2009,6,464,7219,7683
3416,Hopkinton,Middlesex County,MA,Hopkinton,2010,6.4,496,7277,7773
3417,Hopkinton,Middlesex County,MA,Hopkinton,2011,5.1,395,7348,7743
3418,Hopkinton,Middlesex County,MA,Hopkinton,2012,4.7,369,7415,7784
3419,Hubbardston,Worcester County,MA,Hubbardston,1990,7.1,109,1427,1536
3420,Hubbardston,Worcester County,MA,Hubbardston,1991,11.5,183,1410,1593
3421,Hubbardston,Worcester County,MA,Hubbardston,1992,10.7,178,1482,1660
3422,Hubbardston,Worcester County,MA,Hubbardston,1993,9,155,1565,1720
3423,Hubbardston,Worcester County,MA,Hubbardston,1994,8.6,149,1587,1736
3424,Hubbardston,Worcester County,MA,Hubbardston,1995,6.7,111,1552,1663
3425,Hubbardston,Worcester County,MA,Hubbardston,1996,7.2,121,1566,1687
3426,Hubbardston,Worcester County,MA,Hubbardston,1997,6,104,1638,1742
3427,Hubbardston,Worcester County,MA,Hubbardston,1998,5.5,99,1701,1800
3428,Hubbardston,Worcester County,MA,Hubbardston,1999,4.7,86,1745,1831
3429,Hubbardston,Worcester County,MA,Hubbardston,2000,2.6,59,2177,2236
3430,Hubbardston,Worcester County,MA,Hubbardston,2001,3.8,88,2225,2313
3431,Hubbardston,Worcester County,MA,Hubbardston,2002,5.3,126,2239,2365
3432,Hubbardston,Worcester County,MA,Hubbardston,2003,5.8,140,2261,2401
3433,Hubbardston,Worcester County,MA,Hubbardston,2004,4.9,117,2282,2399
3434,Hubbardston,Worcester County,MA,Hubbardston,2005,4.9,119,2317,2436
3435,Hubbardston,Worcester County,MA,Hubbardston,2006,4.9,123,2362,2485
3436,Hubbardston,Worcester County,MA,Hubbardston,2007,4.9,123,2377,2500
3437,Hubbardston,Worcester County,MA,Hubbardston,2008,5.5,135,2327,2462
3438,Hubbardston,Worcester County,MA,Hubbardston,2009,8.9,221,2274,2495
3439,Hubbardston,Worcester County,MA,Hubbardston,2010,8.6,210,2234,2444
3440,Hubbardston,Worcester County,MA,Hubbardston,2011,7.5,183,2253,2436
3441,Hubbardston,Worcester County,MA,Hubbardston,2012,6.3,151,2253,2404
3442,Hudson,Middlesex County,MA,Hudson,1990,5.7,582,9677,10259
3443,Hudson,Middlesex County,MA,Hudson,1991,8,819,9381,10200
3444,Hudson,Middlesex County,MA,Hudson,1992,9,922,9310,10232
3445,Hudson,Middlesex County,MA,Hudson,1993,6.8,691,9441,10132
3446,Hudson,Middlesex County,MA,Hudson,1994,6.4,658,9590,10248
3447,Hudson,Middlesex County,MA,Hudson,1995,5.1,529,9801,10330
3448,Hudson,Middlesex County,MA,Hudson,1996,4,420,10001,10421
3449,Hudson,Middlesex County,MA,Hudson,1997,3.8,403,10245,10648
3450,Hudson,Middlesex County,MA,Hudson,1998,3,318,10430,10748
3451,Hudson,Middlesex County,MA,Hudson,1999,3.5,383,10565,10948
3452,Hudson,Middlesex County,MA,Hudson,2000,2.5,265,10420,10685
3453,Hudson,Middlesex County,MA,Hudson,2001,3.7,398,10444,10842
3454,Hudson,Middlesex County,MA,Hudson,2002,5.8,624,10226,10850
3455,Hudson,Middlesex County,MA,Hudson,2003,5.7,607,10060,10667
3456,Hudson,Middlesex County,MA,Hudson,2004,4.9,528,10358,10886
3457,Hudson,Middlesex County,MA,Hudson,2005,4.3,480,10643,11123
3458,Hudson,Middlesex County,MA,Hudson,2006,4.3,496,10989,11485
3459,Hudson,Middlesex County,MA,Hudson,2007,4.1,481,11200,11681
3460,Hudson,Middlesex County,MA,Hudson,2008,4.9,578,11312,11890
3461,Hudson,Middlesex County,MA,Hudson,2009,7.8,925,11010,11935
3462,Hudson,Middlesex County,MA,Hudson,2010,7.2,802,10386,11188
3463,Hudson,Middlesex County,MA,Hudson,2011,6.7,748,10490,11238
3464,Hudson,Middlesex County,MA,Hudson,2012,5.8,652,10585,11237
3465,Hull,Plymouth County,MA,Hull,1990,7,407,5386,5793
3466,Hull,Plymouth County,MA,Hull,1991,10.7,627,5216,5843
3467,Hull,Plymouth County,MA,Hull,1992,10.3,599,5235,5834
3468,Hull,Plymouth County,MA,Hull,1993,8.2,478,5350,5828
3469,Hull,Plymouth County,MA,Hull,1994,7.5,437,5422,5859
3470,Hull,Plymouth County,MA,Hull,1995,7.3,417,5323,5740
3471,Hull,Plymouth County,MA,Hull,1996,5.5,314,5422,5736
3472,Hull,Plymouth County,MA,Hull,1997,5.3,314,5556,5870
3473,Hull,Plymouth County,MA,Hull,1998,4.2,248,5642,5890
3474,Hull,Plymouth County,MA,Hull,1999,4,237,5703,5940
3475,Hull,Plymouth County,MA,Hull,2000,3.1,197,6091,6288
3476,Hull,Plymouth County,MA,Hull,2001,3.6,231,6134,6365
3477,Hull,Plymouth County,MA,Hull,2002,5.4,349,6096,6445
3478,Hull,Plymouth County,MA,Hull,2003,6.6,425,5997,6422
3479,Hull,Plymouth County,MA,Hull,2004,5.7,361,5987,6348
3480,Hull,Plymouth County,MA,Hull,2005,4.8,305,6029,6334
3481,Hull,Plymouth County,MA,Hull,2006,4.9,300,5871,6171
3482,Hull,Plymouth County,MA,Hull,2007,4.9,304,5876,6180
3483,Hull,Plymouth County,MA,Hull,2008,5.8,364,5859,6223
3484,Hull,Plymouth County,MA,Hull,2009,8.7,540,5673,6213
3485,Hull,Plymouth County,MA,Hull,2010,9,524,5329,5853
3486,Hull,Plymouth County,MA,Hull,2011,7.6,440,5381,5821
3487,Hull,Plymouth County,MA,Hull,2012,7,407,5440,5847
3488,Huntington,Hampshire County,MA,Huntington,1990,7.8,82,972,1054
3489,Huntington,Hampshire County,MA,Huntington,1991,10.7,115,961,1076
3490,Huntington,Hampshire County,MA,Huntington,1992,11,120,975,1095
3491,Huntington,Hampshire County,MA,Huntington,1993,8.9,98,1005,1103
3492,Huntington,Hampshire County,MA,Huntington,1994,8.3,92,1011,1103
3493,Huntington,Hampshire County,MA,Huntington,1995,7.6,83,1007,1090
3494,Huntington,Hampshire County,MA,Huntington,1996,4.9,53,1025,1078
3495,Huntington,Hampshire County,MA,Huntington,1997,4.3,47,1047,1094
3496,Huntington,Hampshire County,MA,Huntington,1998,3.7,41,1057,1098
3497,Huntington,Hampshire County,MA,Huntington,1999,4.1,45,1065,1110
3498,Huntington,Hampshire County,MA,Huntington,2000,3,37,1215,1252
3499,Huntington,Hampshire County,MA,Huntington,2001,3.3,42,1216,1258
3500,Huntington,Hampshire County,MA,Huntington,2002,5.4,69,1209,1278
3501,Huntington,Hampshire County,MA,Huntington,2003,5.6,72,1206,1278
3502,Huntington,Hampshire County,MA,Huntington,2004,4.8,60,1202,1262
3503,Huntington,Hampshire County,MA,Huntington,2005,5.4,69,1199,1268
3504,Huntington,Hampshire County,MA,Huntington,2006,4.2,53,1218,1271
3505,Huntington,Hampshire County,MA,Huntington,2007,4.6,59,1217,1276
3506,Huntington,Hampshire County,MA,Huntington,2008,5.3,68,1220,1288
3507,Huntington,Hampshire County,MA,Huntington,2009,9.2,118,1166,1284
3508,Huntington,Hampshire County,MA,Huntington,2010,9.1,115,1147,1262
3509,Huntington,Hampshire County,MA,Huntington,2011,8.4,104,1134,1238
3510,Huntington,Hampshire County,MA,Huntington,2012,8.4,104,1135,1239
3511,Ipswich,Essex County,MA,Ipswich,1990,5,328,6285,6613
3512,Ipswich,Essex County,MA,Ipswich,1991,6.5,426,6116,6542
3513,Ipswich,Essex County,MA,Ipswich,1992,6.4,421,6111,6532
3514,Ipswich,Essex County,MA,Ipswich,1993,5.3,352,6268,6620
3515,Ipswich,Essex County,MA,Ipswich,1994,4.5,301,6433,6734
3516,Ipswich,Essex County,MA,Ipswich,1995,4,264,6391,6655
3517,Ipswich,Essex County,MA,Ipswich,1996,3.7,255,6564,6819
3518,Ipswich,Essex County,MA,Ipswich,1997,3.2,224,6780,7004
3519,Ipswich,Essex County,MA,Ipswich,1998,2.9,205,6953,7158
3520,Ipswich,Essex County,MA,Ipswich,1999,2.6,189,7071,7260
3521,Ipswich,Essex County,MA,Ipswich,2000,2.2,163,7144,7307
3522,Ipswich,Essex County,MA,Ipswich,2001,3,225,7206,7431
3523,Ipswich,Essex County,MA,Ipswich,2002,4.2,310,7129,7439
3524,Ipswich,Essex County,MA,Ipswich,2003,5.2,386,7057,7443
3525,Ipswich,Essex County,MA,Ipswich,2004,4.3,319,7055,7374
3526,Ipswich,Essex County,MA,Ipswich,2005,4.1,306,7096,7402
3527,Ipswich,Essex County,MA,Ipswich,2006,3.9,282,7001,7283
3528,Ipswich,Essex County,MA,Ipswich,2007,3.7,274,7041,7315
3529,Ipswich,Essex County,MA,Ipswich,2008,4.2,310,7039,7349
3530,Ipswich,Essex County,MA,Ipswich,2009,6.9,503,6827,7330
3531,Ipswich,Essex County,MA,Ipswich,2010,6.7,491,6808,7299
3532,Ipswich,Essex County,MA,Ipswich,2011,6.1,450,6891,7341
3533,Ipswich,Essex County,MA,Ipswich,2012,5.6,411,6967,7378
3534,Kingston,Plymouth County,MA,Kingston,1990,6.5,326,4718,5044
3535,Kingston,Plymouth County,MA,Kingston,1991,7.9,397,4610,5007
3536,Kingston,Plymouth County,MA,Kingston,1992,9,477,4794,5271
3537,Kingston,Plymouth County,MA,Kingston,1993,7.6,412,5015,5427
3538,Kingston,Plymouth County,MA,Kingston,1994,5.9,324,5208,5532
3539,Kingston,Plymouth County,MA,Kingston,1995,5.2,291,5276,5567
3540,Kingston,Plymouth County,MA,Kingston,1996,4.9,282,5443,5725
3541,Kingston,Plymouth County,MA,Kingston,1997,3.8,222,5698,5920
3542,Kingston,Plymouth County,MA,Kingston,1998,2.9,174,5910,6084
3543,Kingston,Plymouth County,MA,Kingston,1999,2.7,171,6100,6271
3544,Kingston,Plymouth County,MA,Kingston,2000,2.5,155,5965,6120
3545,Kingston,Plymouth County,MA,Kingston,2001,3.1,190,6018,6208
3546,Kingston,Plymouth County,MA,Kingston,2002,4.1,253,5988,6241
3547,Kingston,Plymouth County,MA,Kingston,2003,5.1,316,5940,6256
3548,Kingston,Plymouth County,MA,Kingston,2004,4.9,307,5997,6304
3549,Kingston,Plymouth County,MA,Kingston,2005,4.3,277,6116,6393
3550,Kingston,Plymouth County,MA,Kingston,2006,4.6,290,6003,6293
3551,Kingston,Plymouth County,MA,Kingston,2007,4.5,285,6025,6310
3552,Kingston,Plymouth County,MA,Kingston,2008,5.3,336,6016,6352
3553,Kingston,Plymouth County,MA,Kingston,2009,8.6,548,5848,6396
3554,Kingston,Plymouth County,MA,Kingston,2010,8,524,6005,6529
3555,Kingston,Plymouth County,MA,Kingston,2011,7,458,6063,6521
3556,Kingston,Plymouth County,MA,Kingston,2012,5.9,383,6130,6513
3557,Lakeville,Plymouth County,MA,Lakeville,1990,5,204,3844,4048
3558,Lakeville,Plymouth County,MA,Lakeville,1991,8.6,356,3780,4136
3559,Lakeville,Plymouth County,MA,Lakeville,1992,10.2,432,3821,4253
3560,Lakeville,Plymouth County,MA,Lakeville,1993,7.2,315,4079,4394
3561,Lakeville,Plymouth County,MA,Lakeville,1994,6.2,291,4385,4676
3562,Lakeville,Plymouth County,MA,Lakeville,1995,6.2,279,4236,4515
3563,Lakeville,Plymouth County,MA,Lakeville,1996,5,225,4311,4536
3564,Lakeville,Plymouth County,MA,Lakeville,1997,4.5,209,4485,4694
3565,Lakeville,Plymouth County,MA,Lakeville,1998,3.5,168,4590,4758
3566,Lakeville,Plymouth County,MA,Lakeville,1999,3.5,173,4732,4905
3567,Lakeville,Plymouth County,MA,Lakeville,2000,2.4,132,5358,5490
3568,Lakeville,Plymouth County,MA,Lakeville,2001,3.1,176,5465,5641
3569,Lakeville,Plymouth County,MA,Lakeville,2002,4.3,246,5529,5775
3570,Lakeville,Plymouth County,MA,Lakeville,2003,5,295,5560,5855
3571,Lakeville,Plymouth County,MA,Lakeville,2004,5.2,303,5549,5852
3572,Lakeville,Plymouth County,MA,Lakeville,2005,4.5,268,5704,5972
3573,Lakeville,Plymouth County,MA,Lakeville,2006,4.4,264,5775,6039
3574,Lakeville,Plymouth County,MA,Lakeville,2007,4.2,257,5796,6053
3575,Lakeville,Plymouth County,MA,Lakeville,2008,5.3,324,5749,6073
3576,Lakeville,Plymouth County,MA,Lakeville,2009,8.3,509,5590,6099
3577,Lakeville,Plymouth County,MA,Lakeville,2010,8.5,516,5553,6069
3578,Lakeville,Plymouth County,MA,Lakeville,2011,7.3,441,5634,6075
3579,Lakeville,Plymouth County,MA,Lakeville,2012,6.5,391,5617,6008
3580,Lancaster,Worcester County,MA,Lancaster,1990,4.8,168,3357,3525
3581,Lancaster,Worcester County,MA,Lancaster,1991,6.5,224,3240,3464
3582,Lancaster,Worcester County,MA,Lancaster,1992,6.4,219,3195,3414
3583,Lancaster,Worcester County,MA,Lancaster,1993,5.1,175,3233,3408
3584,Lancaster,Worcester County,MA,Lancaster,1994,5.2,178,3243,3421
3585,Lancaster,Worcester County,MA,Lancaster,1995,4.9,167,3260,3427
3586,Lancaster,Worcester County,MA,Lancaster,1996,3.6,124,3338,3462
3587,Lancaster,Worcester County,MA,Lancaster,1997,3.2,115,3458,3573
3588,Lancaster,Worcester County,MA,Lancaster,1998,2.4,85,3465,3550
3589,Lancaster,Worcester County,MA,Lancaster,1999,2.6,93,3531,3624
3590,Lancaster,Worcester County,MA,Lancaster,2000,2.8,81,2807,2888
3591,Lancaster,Worcester County,MA,Lancaster,2001,4.3,126,2787,2913
3592,Lancaster,Worcester County,MA,Lancaster,2002,6.1,183,2797,2980
3593,Lancaster,Worcester County,MA,Lancaster,2003,6.9,209,2808,3017
3594,Lancaster,Worcester County,MA,Lancaster,2004,6.6,200,2850,3050
3595,Lancaster,Worcester County,MA,Lancaster,2005,5.4,166,2887,3053
3596,Lancaster,Worcester County,MA,Lancaster,2006,5.5,172,2978,3150
3597,Lancaster,Worcester County,MA,Lancaster,2007,5,158,3008,3166
3598,Lancaster,Worcester County,MA,Lancaster,2008,5.6,174,2908,3082
3599,Lancaster,Worcester County,MA,Lancaster,2009,9.1,284,2830,3114
3600,Lancaster,Worcester County,MA,Lancaster,2010,8.7,311,3252,3563
3601,Lancaster,Worcester County,MA,Lancaster,2011,7.3,258,3279,3537
3602,Lancaster,Worcester County,MA,Lancaster,2012,6.9,241,3277,3518
3603,Lanesborough,Berkshire County,MA,Lanesborough,1990,6.1,103,1591,1694
3604,Lanesborough,Berkshire County,MA,Lanesborough,1991,10.4,176,1522,1698
3605,Lanesborough,Berkshire County,MA,Lanesborough,1992,8.6,140,1480,1620
3606,Lanesborough,Berkshire County,MA,Lanesborough,1993,7.4,120,1502,1622
3607,Lanesborough,Berkshire County,MA,Lanesborough,1994,7.7,123,1472,1595
3608,Lanesborough,Berkshire County,MA,Lanesborough,1995,5.7,91,1509,1600
3609,Lanesborough,Berkshire County,MA,Lanesborough,1996,4.9,80,1537,1617
3610,Lanesborough,Berkshire County,MA,Lanesborough,1997,4.7,76,1556,1632
3611,Lanesborough,Berkshire County,MA,Lanesborough,1998,4,65,1560,1625
3612,Lanesborough,Berkshire County,MA,Lanesborough,1999,3.5,57,1567,1624
3613,Lanesborough,Berkshire County,MA,Lanesborough,2000,2.4,41,1695,1736
3614,Lanesborough,Berkshire County,MA,Lanesborough,2001,2.6,45,1694,1739
3615,Lanesborough,Berkshire County,MA,Lanesborough,2002,4,72,1720,1792
3616,Lanesborough,Berkshire County,MA,Lanesborough,2003,4.4,79,1711,1790
3617,Lanesborough,Berkshire County,MA,Lanesborough,2004,4.2,75,1714,1789
3618,Lanesborough,Berkshire County,MA,Lanesborough,2005,3.7,67,1737,1804
3619,Lanesborough,Berkshire County,MA,Lanesborough,2006,3.7,68,1757,1825
3620,Lanesborough,Berkshire County,MA,Lanesborough,2007,4.1,74,1743,1817
3621,Lanesborough,Berkshire County,MA,Lanesborough,2008,5.1,93,1716,1809
3622,Lanesborough,Berkshire County,MA,Lanesborough,2009,7.6,136,1661,1797
3623,Lanesborough,Berkshire County,MA,Lanesborough,2010,8.2,155,1735,1890
3624,Lanesborough,Berkshire County,MA,Lanesborough,2011,6.8,127,1751,1878
3625,Lanesborough,Berkshire County,MA,Lanesborough,2012,6.5,121,1743,1864
3626,Lawrence,Essex County,MA,Lawrence,1990,11.9,3333,24601,27934
3627,Lawrence,Essex County,MA,Lawrence,1991,15.1,4184,23502,27686
3628,Lawrence,Essex County,MA,Lawrence,1992,14.8,3982,22833,26815
3629,Lawrence,Essex County,MA,Lawrence,1993,14.1,3704,22566,26270
3630,Lawrence,Essex County,MA,Lawrence,1994,12.9,3304,22354,25658
3631,Lawrence,Essex County,MA,Lawrence,1995,10.3,2869,24854,27723
3632,Lawrence,Essex County,MA,Lawrence,1996,9.9,2774,25347,28121
3633,Lawrence,Essex County,MA,Lawrence,1997,9,2534,25554,28088
3634,Lawrence,Essex County,MA,Lawrence,1998,8.7,2475,25850,28325
3635,Lawrence,Essex County,MA,Lawrence,1999,8.3,2406,26495,28901
3636,Lawrence,Essex County,MA,Lawrence,2000,5.6,1578,26831,28409
3637,Lawrence,Essex County,MA,Lawrence,2001,8.8,2567,26733,29300
3638,Lawrence,Essex County,MA,Lawrence,2002,12.3,3683,26276,29959
3639,Lawrence,Essex County,MA,Lawrence,2003,12.3,3663,26156,29819
3640,Lawrence,Essex County,MA,Lawrence,2004,11.1,3269,26086,29355
3641,Lawrence,Essex County,MA,Lawrence,2005,10.1,2921,26122,29043
3642,Lawrence,Essex County,MA,Lawrence,2006,9.7,2803,26225,29028
3643,Lawrence,Essex County,MA,Lawrence,2007,9,2616,26325,28941
3644,Lawrence,Essex County,MA,Lawrence,2008,10.8,3156,26182,29338
3645,Lawrence,Essex County,MA,Lawrence,2009,15.9,4801,25482,30283
3646,Lawrence,Essex County,MA,Lawrence,2010,16,5087,26657,31744
3647,Lawrence,Essex County,MA,Lawrence,2011,15.7,5074,27182,32256
3648,Lawrence,Essex County,MA,Lawrence,2012,14.4,4646,27555,32201
3649,Lee,Berkshire County,MA,Lee,1990,6,189,2948,3137
3650,Lee,Berkshire County,MA,Lee,1991,9.9,306,2780,3086
3651,Lee,Berkshire County,MA,Lee,1992,11.4,349,2718,3067
3652,Lee,Berkshire County,MA,Lee,1993,9,274,2776,3050
3653,Lee,Berkshire County,MA,Lee,1994,7.8,234,2755,2989
3654,Lee,Berkshire County,MA,Lee,1995,7,207,2753,2960
3655,Lee,Berkshire County,MA,Lee,1996,5.2,153,2794,2947
3656,Lee,Berkshire County,MA,Lee,1997,5.1,151,2811,2962
3657,Lee,Berkshire County,MA,Lee,1998,4.1,121,2798,2919
3658,Lee,Berkshire County,MA,Lee,1999,3.8,110,2805,2915
3659,Lee,Berkshire County,MA,Lee,2000,2.5,89,3411,3500
3660,Lee,Berkshire County,MA,Lee,2001,3,108,3516,3624
3661,Lee,Berkshire County,MA,Lee,2002,4,149,3600,3749
3662,Lee,Berkshire County,MA,Lee,2003,4.6,175,3603,3778
3663,Lee,Berkshire County,MA,Lee,2004,4.2,157,3574,3731
3664,Lee,Berkshire County,MA,Lee,2005,3.5,131,3640,3771
3665,Lee,Berkshire County,MA,Lee,2006,4,154,3653,3807
3666,Lee,Berkshire County,MA,Lee,2007,4,148,3570,3718
3667,Lee,Berkshire County,MA,Lee,2008,5.1,192,3554,3746
3668,Lee,Berkshire County,MA,Lee,2009,6.9,254,3440,3694
3669,Lee,Berkshire County,MA,Lee,2010,7,272,3593,3865
3670,Lee,Berkshire County,MA,Lee,2011,5.4,207,3612,3819
3671,Lee,Berkshire County,MA,Lee,2012,5.3,200,3583,3783
3672,Leicester,Worcester County,MA,Leicester,1990,6.2,353,5297,5650
3673,Leicester,Worcester County,MA,Leicester,1991,10.2,570,5042,5612
3674,Leicester,Worcester County,MA,Leicester,1992,9.6,536,5048,5584
3675,Leicester,Worcester County,MA,Leicester,1993,7.5,415,5125,5540
3676,Leicester,Worcester County,MA,Leicester,1994,5.6,310,5239,5549
3677,Leicester,Worcester County,MA,Leicester,1995,5.6,317,5326,5643
3678,Leicester,Worcester County,MA,Leicester,1996,4.7,268,5413,5681
3679,Leicester,Worcester County,MA,Leicester,1997,3.7,211,5553,5764
3680,Leicester,Worcester County,MA,Leicester,1998,3.2,190,5702,5892
3681,Leicester,Worcester County,MA,Leicester,1999,3.7,217,5701,5918
3682,Leicester,Worcester County,MA,Leicester,2000,2.7,157,5722,5879
3683,Leicester,Worcester County,MA,Leicester,2001,3.4,201,5740,5941
3684,Leicester,Worcester County,MA,Leicester,2002,5.3,321,5733,6054
3685,Leicester,Worcester County,MA,Leicester,2003,6.1,369,5722,6091
3686,Leicester,Worcester County,MA,Leicester,2004,5.4,328,5741,6069
3687,Leicester,Worcester County,MA,Leicester,2005,5.4,326,5756,6082
3688,Leicester,Worcester County,MA,Leicester,2006,4.7,286,5822,6108
3689,Leicester,Worcester County,MA,Leicester,2007,5,308,5853,6161
3690,Leicester,Worcester County,MA,Leicester,2008,5.8,351,5715,6066
3691,Leicester,Worcester County,MA,Leicester,2009,8.9,542,5577,6119
3692,Leicester,Worcester County,MA,Leicester,2010,8.5,512,5511,6023
3693,Leicester,Worcester County,MA,Leicester,2011,7.5,451,5560,6011
3694,Leicester,Worcester County,MA,Leicester,2012,7.1,426,5558,5984
3695,Lenox,Berkshire County,MA,Lenox,1990,6.1,150,2292,2442
3696,Lenox,Berkshire County,MA,Lenox,1991,8.8,216,2230,2446
3697,Lenox,Berkshire County,MA,Lenox,1992,9,218,2205,2423
3698,Lenox,Berkshire County,MA,Lenox,1993,7.1,169,2202,2371
3699,Lenox,Berkshire County,MA,Lenox,1994,6.5,153,2185,2338
3700,Lenox,Berkshire County,MA,Lenox,1995,7.4,173,2152,2325
3701,Lenox,Berkshire County,MA,Lenox,1996,5.1,118,2183,2301
3702,Lenox,Berkshire County,MA,Lenox,1997,4.2,99,2261,2360
3703,Lenox,Berkshire County,MA,Lenox,1998,3.8,89,2260,2349
3704,Lenox,Berkshire County,MA,Lenox,1999,3.5,83,2273,2356
3705,Lenox,Berkshire County,MA,Lenox,2000,2.8,72,2479,2551
3706,Lenox,Berkshire County,MA,Lenox,2001,2.9,76,2520,2596
3707,Lenox,Berkshire County,MA,Lenox,2002,3.8,100,2566,2666
3708,Lenox,Berkshire County,MA,Lenox,2003,4.1,111,2564,2675
3709,Lenox,Berkshire County,MA,Lenox,2004,4.3,116,2565,2681
3710,Lenox,Berkshire County,MA,Lenox,2005,4.1,112,2606,2718
3711,Lenox,Berkshire County,MA,Lenox,2006,3.9,109,2665,2774
3712,Lenox,Berkshire County,MA,Lenox,2007,3.6,100,2645,2745
3713,Lenox,Berkshire County,MA,Lenox,2008,4.2,115,2621,2736
3714,Lenox,Berkshire County,MA,Lenox,2009,6.7,183,2542,2725
3715,Lenox,Berkshire County,MA,Lenox,2010,6.9,181,2424,2605
3716,Lenox,Berkshire County,MA,Lenox,2011,5.7,149,2446,2595
3717,Lenox,Berkshire County,MA,Lenox,2012,5.3,136,2435,2571
3718,Leominster,Worcester County,MA,Leominster,1990,7.6,1581,19340,20921
3719,Leominster,Worcester County,MA,Leominster,1991,10.1,2082,18623,20705
3720,Leominster,Worcester County,MA,Leominster,1992,8.9,1869,19083,20952
3721,Leominster,Worcester County,MA,Leominster,1993,7.8,1633,19365,20998
3722,Leominster,Worcester County,MA,Leominster,1994,6.9,1440,19414,20854
3723,Leominster,Worcester County,MA,Leominster,1995,6.5,1368,19727,21095
3724,Leominster,Worcester County,MA,Leominster,1996,5.6,1164,19807,20971
3725,Leominster,Worcester County,MA,Leominster,1997,4.7,1007,20418,21425
3726,Leominster,Worcester County,MA,Leominster,1998,3.9,836,20388,21224
3727,Leominster,Worcester County,MA,Leominster,1999,4.1,868,20410,21278
3728,Leominster,Worcester County,MA,Leominster,2000,3.1,651,20630,21281
3729,Leominster,Worcester County,MA,Leominster,2001,4.5,956,20379,21335
3730,Leominster,Worcester County,MA,Leominster,2002,6.5,1395,20183,21578
3731,Leominster,Worcester County,MA,Leominster,2003,6.9,1473,19963,21436
3732,Leominster,Worcester County,MA,Leominster,2004,6.4,1359,19811,21170
3733,Leominster,Worcester County,MA,Leominster,2005,5.9,1231,19543,20774
3734,Leominster,Worcester County,MA,Leominster,2006,5.7,1193,19592,20785
3735,Leominster,Worcester County,MA,Leominster,2007,5.5,1134,19475,20609
3736,Leominster,Worcester County,MA,Leominster,2008,6.5,1329,19179,20508
3737,Leominster,Worcester County,MA,Leominster,2009,10.2,2107,18631,20738
3738,Leominster,Worcester County,MA,Leominster,2010,10.7,2193,18362,20555
3739,Leominster,Worcester County,MA,Leominster,2011,9.6,1960,18352,20312
3740,Leominster,Worcester County,MA,Leominster,2012,8.8,1769,18339,20108
3741,Leverett,Franklin County,MA,Leverett,1990,2.3,24,1035,1059
3742,Leverett,Franklin County,MA,Leverett,1991,4.5,48,1015,1063
3743,Leverett,Franklin County,MA,Leverett,1992,4.3,45,991,1036
3744,Leverett,Franklin County,MA,Leverett,1993,4.1,43,1003,1046
3745,Leverett,Franklin County,MA,Leverett,1994,2.7,29,1048,1077
3746,Leverett,Franklin County,MA,Leverett,1995,2.1,23,1072,1095
3747,Leverett,Franklin County,MA,Leverett,1996,1.9,21,1078,1099
3748,Leverett,Franklin County,MA,Leverett,1997,2.2,25,1106,1131
3749,Leverett,Franklin County,MA,Leverett,1998,1.8,21,1134,1155
3750,Leverett,Franklin County,MA,Leverett,1999,1.4,16,1160,1176
3751,Leverett,Franklin County,MA,Leverett,2000,1.9,18,936,954
3752,Leverett,Franklin County,MA,Leverett,2001,1.8,18,964,982
3753,Leverett,Franklin County,MA,Leverett,2002,2.2,22,968,990
3754,Leverett,Franklin County,MA,Leverett,2003,3,31,988,1019
3755,Leverett,Franklin County,MA,Leverett,2004,3.2,33,1004,1037
3756,Leverett,Franklin County,MA,Leverett,2005,3.4,36,1010,1046
3757,Leverett,Franklin County,MA,Leverett,2006,3.5,37,1025,1062
3758,Leverett,Franklin County,MA,Leverett,2007,3,31,1012,1043
3759,Leverett,Franklin County,MA,Leverett,2008,3.5,36,991,1027
3760,Leverett,Franklin County,MA,Leverett,2009,5.2,53,968,1021
3761,Leverett,Franklin County,MA,Leverett,2010,5.2,54,979,1033
3762,Leverett,Franklin County,MA,Leverett,2011,5.1,53,989,1042
3763,Leverett,Franklin County,MA,Leverett,2012,4.3,45,998,1043
3764,Lexington,Middlesex County,MA,Lexington,1990,3.2,505,15201,15706
3765,Lexington,Middlesex County,MA,Lexington,1991,4.8,745,14711,15456
3766,Lexington,Middlesex County,MA,Lexington,1992,4.8,728,14579,15307
3767,Lexington,Middlesex County,MA,Lexington,1993,4,607,14718,15325
3768,Lexington,Middlesex County,MA,Lexington,1994,3.5,541,14935,15476
3769,Lexington,Middlesex County,MA,Lexington,1995,2.8,435,15217,15652
3770,Lexington,Middlesex County,MA,Lexington,1996,2.2,350,15526,15876
3771,Lexington,Middlesex County,MA,Lexington,1997,2,323,15914,16237
3772,Lexington,Middlesex County,MA,Lexington,1998,1.6,263,16132,16395
3773,Lexington,Middlesex County,MA,Lexington,1999,1.7,287,16248,16535
3774,Lexington,Middlesex County,MA,Lexington,2000,1.8,280,15129,15409
3775,Lexington,Middlesex County,MA,Lexington,2001,2.9,451,15117,15568
3776,Lexington,Middlesex County,MA,Lexington,2002,4.2,651,14856,15507
3777,Lexington,Middlesex County,MA,Lexington,2003,4.5,684,14629,15313
3778,Lexington,Middlesex County,MA,Lexington,2004,3.8,569,14581,15150
3779,Lexington,Middlesex County,MA,Lexington,2005,3.3,508,14660,15168
3780,Lexington,Middlesex County,MA,Lexington,2006,3.3,495,14483,14978
3781,Lexington,Middlesex County,MA,Lexington,2007,3.1,462,14612,15074
3782,Lexington,Middlesex County,MA,Lexington,2008,3.7,556,14631,15187
3783,Lexington,Middlesex County,MA,Lexington,2009,5.8,882,14294,15176
3784,Lexington,Middlesex County,MA,Lexington,2010,5.7,884,14729,15613
3785,Lexington,Middlesex County,MA,Lexington,2011,4.7,738,14945,15683
3786,Lexington,Middlesex County,MA,Lexington,2012,4.3,680,15108,15788
3787,Leyden,Franklin County,MA,Leyden,1990,7.1,27,355,382
3788,Leyden,Franklin County,MA,Leyden,1991,11.1,45,361,406
3789,Leyden,Franklin County,MA,Leyden,1992,5.9,22,350,372
3790,Leyden,Franklin County,MA,Leyden,1993,7.7,31,372,403
3791,Leyden,Franklin County,MA,Leyden,1994,4.4,18,390,408
3792,Leyden,Franklin County,MA,Leyden,1995,3.9,15,371,386
3793,Leyden,Franklin County,MA,Leyden,1996,5,20,379,399
3794,Leyden,Franklin County,MA,Leyden,1997,3.4,14,394,408
3795,Leyden,Franklin County,MA,Leyden,1998,3.6,15,402,417
3796,Leyden,Franklin County,MA,Leyden,1999,2.4,10,411,421
3797,Leyden,Franklin County,MA,Leyden,2000,2.5,12,459,471
3798,Leyden,Franklin County,MA,Leyden,2001,2.9,14,461,475
3799,Leyden,Franklin County,MA,Leyden,2002,3.3,16,474,490
3800,Leyden,Franklin County,MA,Leyden,2003,4,20,477,497
3801,Leyden,Franklin County,MA,Leyden,2004,4.2,21,474,495
3802,Leyden,Franklin County,MA,Leyden,2005,3,15,478,493
3803,Leyden,Franklin County,MA,Leyden,2006,4.4,22,478,500
3804,Leyden,Franklin County,MA,Leyden,2007,4.1,20,470,490
3805,Leyden,Franklin County,MA,Leyden,2008,5.1,25,461,486
3806,Leyden,Franklin County,MA,Leyden,2009,6,29,453,482
3807,Leyden,Franklin County,MA,Leyden,2010,5.8,25,405,430
3808,Leyden,Franklin County,MA,Leyden,2011,3.8,16,406,422
3809,Leyden,Franklin County,MA,Leyden,2012,4,17,407,424
3810,Lincoln,Middlesex County,MA,Lincoln,1990,2,67,3248,3315
3811,Lincoln,Middlesex County,MA,Lincoln,1991,3.3,106,3130,3236
3812,Lincoln,Middlesex County,MA,Lincoln,1992,3.1,101,3163,3264
3813,Lincoln,Middlesex County,MA,Lincoln,1993,2.7,90,3275,3365
3814,Lincoln,Middlesex County,MA,Lincoln,1994,2.3,79,3400,3479
3815,Lincoln,Middlesex County,MA,Lincoln,1995,2,68,3264,3332
3816,Lincoln,Middlesex County,MA,Lincoln,1996,1.5,51,3341,3392
3817,Lincoln,Middlesex County,MA,Lincoln,1997,1.1,39,3425,3464
3818,Lincoln,Middlesex County,MA,Lincoln,1998,1.2,42,3480,3522
3819,Lincoln,Middlesex County,MA,Lincoln,1999,1.3,45,3508,3553
3820,Lincoln,Middlesex County,MA,Lincoln,2000,1.6,55,3343,3398
3821,Lincoln,Middlesex County,MA,Lincoln,2001,2.4,82,3339,3421
3822,Lincoln,Middlesex County,MA,Lincoln,2002,3.4,114,3275,3389
3823,Lincoln,Middlesex County,MA,Lincoln,2003,3.6,121,3210,3331
3824,Lincoln,Middlesex County,MA,Lincoln,2004,3.3,109,3193,3302
3825,Lincoln,Middlesex County,MA,Lincoln,2005,3,100,3199,3299
3826,Lincoln,Middlesex County,MA,Lincoln,2006,2.9,95,3168,3263
3827,Lincoln,Middlesex County,MA,Lincoln,2007,2.7,95,3379,3474
3828,Lincoln,Middlesex County,MA,Lincoln,2008,3,107,3419,3526
3829,Lincoln,Middlesex County,MA,Lincoln,2009,5,177,3331,3508
3830,Lincoln,Middlesex County,MA,Lincoln,2010,5.6,147,2486,2633
3831,Lincoln,Middlesex County,MA,Lincoln,2011,5,134,2523,2657
3832,Lincoln,Middlesex County,MA,Lincoln,2012,4.8,130,2551,2681
3833,Littleton,Middlesex County,MA,Littleton,1990,4.4,178,3827,4005
3834,Littleton,Middlesex County,MA,Littleton,1991,6.4,255,3732,3987
3835,Littleton,Middlesex County,MA,Littleton,1992,6.5,260,3738,3998
3836,Littleton,Middlesex County,MA,Littleton,1993,5.9,242,3849,4091
3837,Littleton,Middlesex County,MA,Littleton,1994,5.1,213,3995,4208
3838,Littleton,Middlesex County,MA,Littleton,1995,4.1,174,4082,4256
3839,Littleton,Middlesex County,MA,Littleton,1996,3,129,4190,4319
3840,Littleton,Middlesex County,MA,Littleton,1997,2.7,122,4342,4464
3841,Littleton,Middlesex County,MA,Littleton,1998,2,94,4547,4641
3842,Littleton,Middlesex County,MA,Littleton,1999,2.2,104,4640,4744
3843,Littleton,Middlesex County,MA,Littleton,2000,2,90,4459,4549
3844,Littleton,Middlesex County,MA,Littleton,2001,3.4,159,4529,4688
3845,Littleton,Middlesex County,MA,Littleton,2002,5.2,249,4494,4743
3846,Littleton,Middlesex County,MA,Littleton,2003,5.2,244,4471,4715
3847,Littleton,Middlesex County,MA,Littleton,2004,4.2,195,4477,4672
3848,Littleton,Middlesex County,MA,Littleton,2005,4.1,192,4531,4723
3849,Littleton,Middlesex County,MA,Littleton,2006,3.9,181,4492,4673
3850,Littleton,Middlesex County,MA,Littleton,2007,3.6,168,4554,4722
3851,Littleton,Middlesex County,MA,Littleton,2008,4.1,196,4565,4761
3852,Littleton,Middlesex County,MA,Littleton,2009,6.4,311,4517,4828
3853,Littleton,Middlesex County,MA,Littleton,2010,6.6,320,4560,4880
3854,Littleton,Middlesex County,MA,Littleton,2011,5.7,279,4626,4905
3855,Littleton,Middlesex County,MA,Littleton,2012,5,247,4677,4924
3856,Longmeadow,Hampden County,MA,Longmeadow,1990,3.8,301,7607,7908
3857,Longmeadow,Hampden County,MA,Longmeadow,1991,5,384,7365,7749
3858,Longmeadow,Hampden County,MA,Longmeadow,1992,4.7,365,7366,7731
3859,Longmeadow,Hampden County,MA,Longmeadow,1993,4.5,346,7358,7704
3860,Longmeadow,Hampden County,MA,Longmeadow,1994,4.2,328,7425,7753
3861,Longmeadow,Hampden County,MA,Longmeadow,1995,3.7,279,7169,7448
3862,Longmeadow,Hampden County,MA,Longmeadow,1996,3.1,230,7229,7459
3863,Longmeadow,Hampden County,MA,Longmeadow,1997,2.6,197,7366,7563
3864,Longmeadow,Hampden County,MA,Longmeadow,1998,2.2,169,7386,7555
3865,Longmeadow,Hampden County,MA,Longmeadow,1999,2.1,162,7384,7546
3866,Longmeadow,Hampden County,MA,Longmeadow,2000,2.2,171,7755,7926
3867,Longmeadow,Hampden County,MA,Longmeadow,2001,2.5,198,7750,7948
3868,Longmeadow,Hampden County,MA,Longmeadow,2002,3.3,259,7709,7968
3869,Longmeadow,Hampden County,MA,Longmeadow,2003,3.8,304,7620,7924
3870,Longmeadow,Hampden County,MA,Longmeadow,2004,3.6,281,7598,7879
3871,Longmeadow,Hampden County,MA,Longmeadow,2005,3.4,271,7597,7868
3872,Longmeadow,Hampden County,MA,Longmeadow,2006,3.5,277,7606,7883
3873,Longmeadow,Hampden County,MA,Longmeadow,2007,3.3,255,7546,7801
3874,Longmeadow,Hampden County,MA,Longmeadow,2008,3.7,286,7485,7771
3875,Longmeadow,Hampden County,MA,Longmeadow,2009,5.8,444,7224,7668
3876,Longmeadow,Hampden County,MA,Longmeadow,2010,5.9,466,7375,7841
3877,Longmeadow,Hampden County,MA,Longmeadow,2011,5.1,389,7301,7690
3878,Longmeadow,Hampden County,MA,Longmeadow,2012,4.8,369,7306,7675
3879,Lowell,Middlesex County,MA,Lowell,1990,8.6,4492,47682,52174
3880,Lowell,Middlesex County,MA,Lowell,1991,12,6158,44970,51128
3881,Lowell,Middlesex County,MA,Lowell,1992,13,6500,43525,50025
3882,Lowell,Middlesex County,MA,Lowell,1993,10.7,5076,42549,47625
3883,Lowell,Middlesex County,MA,Lowell,1994,8.6,3977,42059,46036
3884,Lowell,Middlesex County,MA,Lowell,1995,6.8,3270,44598,47868
3885,Lowell,Middlesex County,MA,Lowell,1996,5.2,2488,45812,48300
3886,Lowell,Middlesex County,MA,Lowell,1997,5.2,2600,47490,50090
3887,Lowell,Middlesex County,MA,Lowell,1998,4.5,2301,48476,50777
3888,Lowell,Middlesex County,MA,Lowell,1999,4.3,2250,49646,51896
3889,Lowell,Middlesex County,MA,Lowell,2000,3.1,1608,49514,51122
3890,Lowell,Middlesex County,MA,Lowell,2001,5.3,2777,49469,52246
3891,Lowell,Middlesex County,MA,Lowell,2002,7.7,4010,48309,52319
3892,Lowell,Middlesex County,MA,Lowell,2003,8,4142,47359,51501
3893,Lowell,Middlesex County,MA,Lowell,2004,7.1,3552,46814,50366
3894,Lowell,Middlesex County,MA,Lowell,2005,6.4,3233,46901,50134
3895,Lowell,Middlesex County,MA,Lowell,2006,5.9,2961,46907,49868
3896,Lowell,Middlesex County,MA,Lowell,2007,5.6,2779,47017,49796
3897,Lowell,Middlesex County,MA,Lowell,2008,6.9,3492,46937,50429
3898,Lowell,Middlesex County,MA,Lowell,2009,10.8,5539,45918,51457
3899,Lowell,Middlesex County,MA,Lowell,2010,10.3,5414,47197,52611
3900,Lowell,Middlesex County,MA,Lowell,2011,9.4,4942,47684,52626
3901,Lowell,Middlesex County,MA,Lowell,2012,8.7,4610,48210,52820
3902,Ludlow,Hampden County,MA,Ludlow,1990,6.9,734,9917,10651
3903,Ludlow,Hampden County,MA,Ludlow,1991,9.7,1042,9683,10725
3904,Ludlow,Hampden County,MA,Ludlow,1992,9.7,1052,9753,10805
3905,Ludlow,Hampden County,MA,Ludlow,1993,9.4,1029,9890,10919
3906,Ludlow,Hampden County,MA,Ludlow,1994,8.8,958,9973,10931
3907,Ludlow,Hampden County,MA,Ludlow,1995,6.9,715,9586,10301
3908,Ludlow,Hampden County,MA,Ludlow,1996,5.6,582,9752,10334
3909,Ludlow,Hampden County,MA,Ludlow,1997,5.6,600,10050,10650
3910,Ludlow,Hampden County,MA,Ludlow,1998,4.8,506,10144,10650
3911,Ludlow,Hampden County,MA,Ludlow,1999,4.2,450,10230,10680
3912,Ludlow,Hampden County,MA,Ludlow,2000,3.4,364,10369,10733
3913,Ludlow,Hampden County,MA,Ludlow,2001,4.2,457,10500,10957
3914,Ludlow,Hampden County,MA,Ludlow,2002,5.4,599,10507,11106
3915,Ludlow,Hampden County,MA,Ludlow,2003,6.7,745,10447,11192
3916,Ludlow,Hampden County,MA,Ludlow,2004,6.1,683,10497,11180
3917,Ludlow,Hampden County,MA,Ludlow,2005,5.8,645,10542,11187
3918,Ludlow,Hampden County,MA,Ludlow,2006,6.1,694,10617,11311
3919,Ludlow,Hampden County,MA,Ludlow,2007,5.5,625,10700,11325
3920,Ludlow,Hampden County,MA,Ludlow,2008,6.7,769,10772,11541
3921,Ludlow,Hampden County,MA,Ludlow,2009,9.3,1039,10168,11207
3922,Ludlow,Hampden County,MA,Ludlow,2010,9.6,1034,9706,10740
3923,Ludlow,Hampden County,MA,Ludlow,2011,9.6,1025,9608,10633
3924,Ludlow,Hampden County,MA,Ludlow,2012,8.7,911,9614,10525
3925,Lunenburg,Worcester County,MA,Lunenburg,1990,5.8,294,4815,5109
3926,Lunenburg,Worcester County,MA,Lunenburg,1991,8.6,443,4702,5145
3927,Lunenburg,Worcester County,MA,Lunenburg,1992,7.3,379,4797,5176
3928,Lunenburg,Worcester County,MA,Lunenburg,1993,6.9,365,4923,5288
3929,Lunenburg,Worcester County,MA,Lunenburg,1994,5.5,293,5004,5297
3930,Lunenburg,Worcester County,MA,Lunenburg,1995,5.1,259,4861,5120
3931,Lunenburg,Worcester County,MA,Lunenburg,1996,4.6,236,4877,5113
3932,Lunenburg,Worcester County,MA,Lunenburg,1997,4.2,217,5007,5224
3933,Lunenburg,Worcester County,MA,Lunenburg,1998,3,155,4937,5092
3934,Lunenburg,Worcester County,MA,Lunenburg,1999,3.4,176,4955,5131
3935,Lunenburg,Worcester County,MA,Lunenburg,2000,2.8,144,5089,5233
3936,Lunenburg,Worcester County,MA,Lunenburg,2001,3.5,186,5092,5278
3937,Lunenburg,Worcester County,MA,Lunenburg,2002,5.7,308,5089,5397
3938,Lunenburg,Worcester County,MA,Lunenburg,2003,6.2,336,5083,5419
3939,Lunenburg,Worcester County,MA,Lunenburg,2004,5.8,313,5096,5409
3940,Lunenburg,Worcester County,MA,Lunenburg,2005,5.1,274,5062,5336
3941,Lunenburg,Worcester County,MA,Lunenburg,2006,5,269,5099,5368
3942,Lunenburg,Worcester County,MA,Lunenburg,2007,5,266,5088,5354
3943,Lunenburg,Worcester County,MA,Lunenburg,2008,5.8,308,5019,5327
3944,Lunenburg,Worcester County,MA,Lunenburg,2009,9,480,4834,5314
3945,Lunenburg,Worcester County,MA,Lunenburg,2010,8.8,473,4908,5381
3946,Lunenburg,Worcester County,MA,Lunenburg,2011,8.2,439,4906,5345
3947,Lunenburg,Worcester County,MA,Lunenburg,2012,7.9,418,4903,5321
3948,Lynn,Essex County,MA,Lynn,1990,7.9,3065,35836,38901
3949,Lynn,Essex County,MA,Lynn,1991,10.3,3918,34226,38144
3950,Lynn,Essex County,MA,Lynn,1992,11.1,4191,33513,37704
3951,Lynn,Essex County,MA,Lynn,1993,8,2942,33663,36605
3952,Lynn,Essex County,MA,Lynn,1994,7.4,2702,33925,36627
3953,Lynn,Essex County,MA,Lynn,1995,6.2,2314,35174,37488
3954,Lynn,Essex County,MA,Lynn,1996,5.3,2013,35817,37830
3955,Lynn,Essex County,MA,Lynn,1997,4.9,1881,36774,38655
3956,Lynn,Essex County,MA,Lynn,1998,4.1,1594,37337,38931
3957,Lynn,Essex County,MA,Lynn,1999,4.2,1628,37553,39181
3958,Lynn,Essex County,MA,Lynn,2000,3.2,1355,40582,41937
3959,Lynn,Essex County,MA,Lynn,2001,4.3,1841,40651,42492
3960,Lynn,Essex County,MA,Lynn,2002,6.2,2676,40169,42845
3961,Lynn,Essex County,MA,Lynn,2003,7.4,3165,39714,42879
3962,Lynn,Essex County,MA,Lynn,2004,6.6,2784,39330,42114
3963,Lynn,Essex County,MA,Lynn,2005,6.2,2579,39095,41674
3964,Lynn,Essex County,MA,Lynn,2006,6,2487,39212,41699
3965,Lynn,Essex County,MA,Lynn,2007,5.5,2263,38969,41232
3966,Lynn,Essex County,MA,Lynn,2008,6.4,2660,38947,41607
3967,Lynn,Essex County,MA,Lynn,2009,9.5,3994,38032,42026
3968,Lynn,Essex County,MA,Lynn,2010,9.2,4009,39332,43341
3969,Lynn,Essex County,MA,Lynn,2011,8.4,3640,39788,43428
3970,Lynn,Essex County,MA,Lynn,2012,7.9,3438,40094,43532
3971,Lynnfield,Essex County,MA,Lynnfield,1990,3.9,235,5750,5985
3972,Lynnfield,Essex County,MA,Lynnfield,1991,5.4,318,5556,5874
3973,Lynnfield,Essex County,MA,Lynnfield,1992,6.7,397,5520,5917
3974,Lynnfield,Essex County,MA,Lynnfield,1993,5.5,331,5634,5965
3975,Lynnfield,Essex County,MA,Lynnfield,1994,4.2,254,5762,6016
3976,Lynnfield,Essex County,MA,Lynnfield,1995,3.8,225,5760,5985
3977,Lynnfield,Essex County,MA,Lynnfield,1996,2.6,158,5883,6041
3978,Lynnfield,Essex County,MA,Lynnfield,1997,2.6,161,6045,6206
3979,Lynnfield,Essex County,MA,Lynnfield,1998,2.1,130,6190,6320
3980,Lynnfield,Essex County,MA,Lynnfield,1999,2.1,132,6251,6383
3981,Lynnfield,Essex County,MA,Lynnfield,2000,2.1,122,5671,5793
3982,Lynnfield,Essex County,MA,Lynnfield,2001,2.8,166,5679,5845
3983,Lynnfield,Essex County,MA,Lynnfield,2002,4.2,247,5597,5844
3984,Lynnfield,Essex County,MA,Lynnfield,2003,5.1,295,5520,5815
3985,Lynnfield,Essex County,MA,Lynnfield,2004,4.6,265,5494,5759
3986,Lynnfield,Essex County,MA,Lynnfield,2005,4,228,5512,5740
3987,Lynnfield,Essex County,MA,Lynnfield,2006,3.9,216,5335,5551
3988,Lynnfield,Essex County,MA,Lynnfield,2007,3.7,205,5379,5584
3989,Lynnfield,Essex County,MA,Lynnfield,2008,4.6,259,5406,5665
3990,Lynnfield,Essex County,MA,Lynnfield,2009,6.8,400,5481,5881
3991,Lynnfield,Essex County,MA,Lynnfield,2010,6.7,382,5362,5744
3992,Lynnfield,Essex County,MA,Lynnfield,2011,5.5,313,5427,5740
3993,Lynnfield,Essex County,MA,Lynnfield,2012,4.9,282,5487,5769
3994,Malden,Middlesex County,MA,Malden,1990,6.2,1886,28567,30453
3995,Malden,Middlesex County,MA,Malden,1991,8.7,2612,27480,30092
3996,Malden,Middlesex County,MA,Malden,1992,8.9,2649,27163,29812
3997,Malden,Middlesex County,MA,Malden,1993,7.2,2059,26729,28788
3998,Malden,Middlesex County,MA,Malden,1994,6.1,1749,26909,28658
3999,Malden,Middlesex County,MA,Malden,1995,5.8,1717,27683,29400
4000,Malden,Middlesex County,MA,Malden,1996,4.4,1299,28120,29419
4001,Malden,Middlesex County,MA,Malden,1997,4.1,1230,28764,29994
4002,Malden,Middlesex County,MA,Malden,1998,3.3,1006,29065,30071
4003,Malden,Middlesex County,MA,Malden,1999,3.4,1032,29194,30226
4004,Malden,Middlesex County,MA,Malden,2000,2.6,808,30867,31675
4005,Malden,Middlesex County,MA,Malden,2001,3.7,1165,30679,31844
4006,Malden,Middlesex County,MA,Malden,2002,5.3,1681,29984,31665
4007,Malden,Middlesex County,MA,Malden,2003,6.2,1940,29383,31323
4008,Malden,Middlesex County,MA,Malden,2004,5.3,1621,29196,30817
4009,Malden,Middlesex County,MA,Malden,2005,4.7,1471,29789,31260
4010,Malden,Middlesex County,MA,Malden,2006,4.7,1435,29257,30692
4011,Malden,Middlesex County,MA,Malden,2007,4.4,1348,29459,30807
4012,Malden,Middlesex County,MA,Malden,2008,5.4,1668,29389,31057
4013,Malden,Middlesex County,MA,Malden,2009,8,2494,28566,31060
4014,Malden,Middlesex County,MA,Malden,2010,7.8,2592,30702,33294
4015,Malden,Middlesex County,MA,Malden,2011,6.7,2245,31155,33400
4016,Malden,Middlesex County,MA,Malden,2012,5.9,1985,31496,33481
4017,Manchester-by-the-Sea,Essex County,MA,Manchester-by-the-Sea,1990,3.9,112,2782,2894
4018,Manchester-by-the-Sea,Essex County,MA,Manchester-by-the-Sea,1991,5.7,165,2723,2888
4019,Manchester-by-the-Sea,Essex County,MA,Manchester-by-the-Sea,1992,6.1,178,2728,2906
4020,Manchester-by-the-Sea,Essex County,MA,Manchester-by-the-Sea,1993,4.7,137,2752,2889
4021,Manchester-by-the-Sea,Essex County,MA,Manchester-by-the-Sea,1994,3.5,101,2815,2916
4022,Manchester-by-the-Sea,Essex County,MA,Manchester-by-the-Sea,1995,3,86,2779,2865
4023,Manchester-by-the-Sea,Essex County,MA,Manchester-by-the-Sea,1996,2.8,82,2836,2918
4024,Manchester-by-the-Sea,Essex County,MA,Manchester-by-the-Sea,1997,2.8,84,2928,3012
4025,Manchester-by-the-Sea,Essex County,MA,Manchester-by-the-Sea,1998,2,63,3019,3082
4026,Manchester-by-the-Sea,Essex County,MA,Manchester-by-the-Sea,1999,1.9,58,3048,3106
4027,Manchester-by-the-Sea,Essex County,MA,Manchester-by-the-Sea,2000,2.1,57,2714,2771
4028,Manchester-by-the-Sea,Essex County,MA,Manchester-by-the-Sea,2001,2.9,81,2722,2803
4029,Manchester-by-the-Sea,Essex County,MA,Manchester-by-the-Sea,2002,4.3,122,2683,2805
4030,Manchester-by-the-Sea,Essex County,MA,Manchester-by-the-Sea,2003,4.8,135,2664,2799
4031,Manchester-by-the-Sea,Essex County,MA,Manchester-by-the-Sea,2004,4.3,120,2676,2796
4032,Manchester-by-the-Sea,Essex County,MA,Manchester-by-the-Sea,2005,3.3,93,2689,2782
4033,Manchester-by-the-Sea,Essex County,MA,Manchester-by-the-Sea,2006,3.7,99,2575,2674
4034,Manchester-by-the-Sea,Essex County,MA,Manchester-by-the-Sea,2007,3.4,90,2584,2674
4035,Manchester-by-the-Sea,Essex County,MA,Manchester-by-the-Sea,2008,4,107,2578,2685
4036,Manchester-by-the-Sea,Essex County,MA,Manchester-by-the-Sea,2009,6.5,173,2502,2675
4037,Manchester-by-the-Sea,Essex County,MA,Manchester-by-the-Sea,2010,6.7,180,2507,2687
4038,Manchester-by-the-Sea,Essex County,MA,Manchester-by-the-Sea,2011,5.4,144,2538,2682
4039,Manchester-by-the-Sea,Essex County,MA,Manchester-by-the-Sea,2012,5.6,153,2566,2719
4040,Mansfield,Bristol County,MA,Mansfield,1990,6.7,664,9252,9916
4041,Mansfield,Bristol County,MA,Mansfield,1991,7.3,729,9251,9980
4042,Mansfield,Bristol County,MA,Mansfield,1992,7.8,812,9539,10351
4043,Mansfield,Bristol County,MA,Mansfield,1993,6,643,10099,10742
4044,Mansfield,Bristol County,MA,Mansfield,1994,5.4,595,10482,11077
4045,Mansfield,Bristol County,MA,Mansfield,1995,5.1,548,10218,10766
4046,Mansfield,Bristol County,MA,Mansfield,1996,3.6,397,10513,10910
4047,Mansfield,Bristol County,MA,Mansfield,1997,3.5,388,10851,11239
4048,Mansfield,Bristol County,MA,Mansfield,1998,2.7,315,11227,11542
4049,Mansfield,Bristol County,MA,Mansfield,1999,2.4,289,11509,11798
4050,Mansfield,Bristol County,MA,Mansfield,2000,2.4,299,11973,12272
4051,Mansfield,Bristol County,MA,Mansfield,2001,3.3,413,12024,12437
4052,Mansfield,Bristol County,MA,Mansfield,2002,4.9,620,11918,12538
4053,Mansfield,Bristol County,MA,Mansfield,2003,5.4,676,11834,12510
4054,Mansfield,Bristol County,MA,Mansfield,2004,4.6,566,11791,12357
4055,Mansfield,Bristol County,MA,Mansfield,2005,4.1,507,11911,12418
4056,Mansfield,Bristol County,MA,Mansfield,2006,4.2,518,11728,12246
4057,Mansfield,Bristol County,MA,Mansfield,2007,3.8,476,12013,12489
4058,Mansfield,Bristol County,MA,Mansfield,2008,4.6,592,12208,12800
4059,Mansfield,Bristol County,MA,Mansfield,2009,7.2,914,11797,12711
4060,Mansfield,Bristol County,MA,Mansfield,2010,7.3,916,11640,12556
4061,Mansfield,Bristol County,MA,Mansfield,2011,6.5,814,11704,12518
4062,Mansfield,Bristol County,MA,Mansfield,2012,5.8,728,11833,12561
4063,Marblehead,Essex County,MA,Marblehead,1990,4.2,491,11280,11771
4064,Marblehead,Essex County,MA,Marblehead,1991,5.9,699,11060,11759
4065,Marblehead,Essex County,MA,Marblehead,1992,5.7,663,11060,11723
4066,Marblehead,Essex County,MA,Marblehead,1993,4.6,541,11256,11797
4067,Marblehead,Essex County,MA,Marblehead,1994,3.7,443,11479,11922
4068,Marblehead,Essex County,MA,Marblehead,1995,3.3,382,11132,11514
4069,Marblehead,Essex County,MA,Marblehead,1996,2.4,281,11341,11622
4070,Marblehead,Essex County,MA,Marblehead,1997,2.2,266,11623,11889
4071,Marblehead,Essex County,MA,Marblehead,1998,2,246,11791,12037
4072,Marblehead,Essex County,MA,Marblehead,1999,1.9,227,11885,12112
4073,Marblehead,Essex County,MA,Marblehead,2000,1.9,220,11089,11309
4074,Marblehead,Essex County,MA,Marblehead,2001,3,339,11101,11440
4075,Marblehead,Essex County,MA,Marblehead,2002,4.4,505,10958,11463
4076,Marblehead,Essex County,MA,Marblehead,2003,4.4,496,10820,11316
4077,Marblehead,Essex County,MA,Marblehead,2004,4,441,10693,11134
4078,Marblehead,Essex County,MA,Marblehead,2005,3.7,405,10674,11079
4079,Marblehead,Essex County,MA,Marblehead,2006,3.4,382,10768,11150
4080,Marblehead,Essex County,MA,Marblehead,2007,3.3,361,10705,11066
4081,Marblehead,Essex County,MA,Marblehead,2008,3.9,435,10673,11108
4082,Marblehead,Essex County,MA,Marblehead,2009,6.3,693,10360,11053
4083,Marblehead,Essex County,MA,Marblehead,2010,5.8,639,10301,10940
4084,Marblehead,Essex County,MA,Marblehead,2011,5,550,10421,10971
4085,Marblehead,Essex County,MA,Marblehead,2012,5,556,10501,11057
4086,Marion,Plymouth County,MA,Marion,1990,6.6,152,2140,2292
4087,Marion,Plymouth County,MA,Marion,1991,8.5,199,2139,2338
4088,Marion,Plymouth County,MA,Marion,1992,8.1,188,2133,2321
4089,Marion,Plymouth County,MA,Marion,1993,6.4,151,2224,2375
4090,Marion,Plymouth County,MA,Marion,1994,6.3,156,2324,2480
4091,Marion,Plymouth County,MA,Marion,1995,6,144,2270,2414
4092,Marion,Plymouth County,MA,Marion,1996,5.5,135,2301,2436
4093,Marion,Plymouth County,MA,Marion,1997,4.8,121,2415,2536
4094,Marion,Plymouth County,MA,Marion,1998,3.2,82,2459,2541
4095,Marion,Plymouth County,MA,Marion,1999,3.7,96,2511,2607
4096,Marion,Plymouth County,MA,Marion,2000,2.2,64,2817,2881
4097,Marion,Plymouth County,MA,Marion,2001,2.5,74,2863,2937
4098,Marion,Plymouth County,MA,Marion,2002,3.8,115,2927,3042
4099,Marion,Plymouth County,MA,Marion,2003,4.1,128,2978,3106
4100,Marion,Plymouth County,MA,Marion,2004,3.8,119,3023,3142
4101,Marion,Plymouth County,MA,Marion,2005,3.4,107,3041,3148
4102,Marion,Plymouth County,MA,Marion,2006,3.7,116,3051,3167
4103,Marion,Plymouth County,MA,Marion,2007,3.4,106,3029,3135
4104,Marion,Plymouth County,MA,Marion,2008,4.4,139,2985,3124
4105,Marion,Plymouth County,MA,Marion,2009,6.1,191,2921,3112
4106,Marion,Plymouth County,MA,Marion,2010,6.5,195,2805,3000
4107,Marion,Plymouth County,MA,Marion,2011,6.3,188,2816,3004
4108,Marion,Plymouth County,MA,Marion,2012,5.3,159,2863,3022
4109,Marlborough,Middlesex County,MA,Marlborough,1990,5.7,1092,18008,19100
4110,Marlborough,Middlesex County,MA,Marlborough,1991,7.9,1511,17543,19054
4111,Marlborough,Middlesex County,MA,Marlborough,1992,8.1,1541,17478,19019
4112,Marlborough,Middlesex County,MA,Marlborough,1993,6.7,1289,17887,19176
4113,Marlborough,Middlesex County,MA,Marlborough,1994,5.4,1059,18453,19512
4114,Marlborough,Middlesex County,MA,Marlborough,1995,5.1,990,18331,19321
4115,Marlborough,Middlesex County,MA,Marlborough,1996,3.7,716,18764,19480
4116,Marlborough,Middlesex County,MA,Marlborough,1997,3.3,661,19307,19968
4117,Marlborough,Middlesex County,MA,Marlborough,1998,2.8,571,19632,20203
4118,Marlborough,Middlesex County,MA,Marlborough,1999,3,623,19829,20452
4119,Marlborough,Middlesex County,MA,Marlborough,2000,2.3,492,21229,21721
4120,Marlborough,Middlesex County,MA,Marlborough,2001,3.2,730,21900,22630
4121,Marlborough,Middlesex County,MA,Marlborough,2002,5.1,1164,21488,22652
4122,Marlborough,Middlesex County,MA,Marlborough,2003,5.5,1218,21032,22250
4123,Marlborough,Middlesex County,MA,Marlborough,2004,4.3,944,21068,22012
4124,Marlborough,Middlesex County,MA,Marlborough,2005,4,895,21257,22152
4125,Marlborough,Middlesex County,MA,Marlborough,2006,3.8,853,21732,22585
4126,Marlborough,Middlesex County,MA,Marlborough,2007,3.6,819,22000,22819
4127,Marlborough,Middlesex County,MA,Marlborough,2008,4.2,979,22123,23102
4128,Marlborough,Middlesex County,MA,Marlborough,2009,6.6,1522,21393,22915
4129,Marlborough,Middlesex County,MA,Marlborough,2010,6.7,1521,21194,22715
4130,Marlborough,Middlesex County,MA,Marlborough,2011,5.6,1263,21398,22661
4131,Marlborough,Middlesex County,MA,Marlborough,2012,5.4,1233,21593,22826
4132,Marshfield,Plymouth County,MA,Marshfield,1990,6.5,796,11489,12285
4133,Marshfield,Plymouth County,MA,Marshfield,1991,8.7,1071,11306,12377
4134,Marshfield,Plymouth County,MA,Marshfield,1992,8.9,1111,11338,12449
4135,Marshfield,Plymouth County,MA,Marshfield,1993,7.5,940,11649,12589
4136,Marshfield,Plymouth County,MA,Marshfield,1994,5.8,738,12075,12813
4137,Marshfield,Plymouth County,MA,Marshfield,1995,5.2,660,11940,12600
4138,Marshfield,Plymouth County,MA,Marshfield,1996,4.6,598,12273,12871
4139,Marshfield,Plymouth County,MA,Marshfield,1997,3.7,489,12694,13183
4140,Marshfield,Plymouth County,MA,Marshfield,1998,3.2,433,13031,13464
4141,Marshfield,Plymouth County,MA,Marshfield,1999,3,405,13310,13715
4142,Marshfield,Plymouth County,MA,Marshfield,2000,2.3,317,13296,13613
4143,Marshfield,Plymouth County,MA,Marshfield,2001,2.9,402,13342,13744
4144,Marshfield,Plymouth County,MA,Marshfield,2002,4.2,584,13225,13809
4145,Marshfield,Plymouth County,MA,Marshfield,2003,4.8,660,13039,13699
4146,Marshfield,Plymouth County,MA,Marshfield,2004,4.6,633,13029,13662
4147,Marshfield,Plymouth County,MA,Marshfield,2005,4.1,565,13207,13772
4148,Marshfield,Plymouth County,MA,Marshfield,2006,4.2,567,12872,13439
4149,Marshfield,Plymouth County,MA,Marshfield,2007,4.4,595,12935,13530
4150,Marshfield,Plymouth County,MA,Marshfield,2008,5,682,13001,13683
4151,Marshfield,Plymouth County,MA,Marshfield,2009,7.5,1024,12601,13625
4152,Marshfield,Plymouth County,MA,Marshfield,2010,7.7,1072,12916,13988
4153,Marshfield,Plymouth County,MA,Marshfield,2011,6.5,910,13043,13953
4154,Marshfield,Plymouth County,MA,Marshfield,2012,5.9,823,13186,14009
4155,Mashpee,Barnstable County,MA,Mashpee,1990,6.3,272,4048,4320
4156,Mashpee,Barnstable County,MA,Mashpee,1991,10,448,4051,4499
4157,Mashpee,Barnstable County,MA,Mashpee,1992,11.2,522,4123,4645
4158,Mashpee,Barnstable County,MA,Mashpee,1993,9.5,461,4408,4869
4159,Mashpee,Barnstable County,MA,Mashpee,1994,7.9,398,4610,5008
4160,Mashpee,Barnstable County,MA,Mashpee,1995,7.4,346,4311,4657
4161,Mashpee,Barnstable County,MA,Mashpee,1996,7,333,4455,4788
4162,Mashpee,Barnstable County,MA,Mashpee,1997,6.9,337,4538,4875
4163,Mashpee,Barnstable County,MA,Mashpee,1998,5.7,285,4727,5012
4164,Mashpee,Barnstable County,MA,Mashpee,1999,4.8,251,5005,5256
4165,Mashpee,Barnstable County,MA,Mashpee,2000,3.1,213,6692,6905
4166,Mashpee,Barnstable County,MA,Mashpee,2001,3.4,245,6924,7169
4167,Mashpee,Barnstable County,MA,Mashpee,2002,4.2,320,7220,7540
4168,Mashpee,Barnstable County,MA,Mashpee,2003,4.8,379,7454,7833
4169,Mashpee,Barnstable County,MA,Mashpee,2004,4.6,366,7595,7961
4170,Mashpee,Barnstable County,MA,Mashpee,2005,4.5,356,7629,7985
4171,Mashpee,Barnstable County,MA,Mashpee,2006,4.5,365,7737,8102
4172,Mashpee,Barnstable County,MA,Mashpee,2007,4.5,368,7737,8105
4173,Mashpee,Barnstable County,MA,Mashpee,2008,5.4,444,7709,8153
4174,Mashpee,Barnstable County,MA,Mashpee,2009,7.9,645,7568,8213
4175,Mashpee,Barnstable County,MA,Mashpee,2010,8.6,700,7482,8182
4176,Mashpee,Barnstable County,MA,Mashpee,2011,7.4,601,7470,8071
4177,Mashpee,Barnstable County,MA,Mashpee,2012,6.8,558,7595,8153
4178,Mattapoisett,Plymouth County,MA,Mattapoisett,1990,5.5,181,3097,3278
4179,Mattapoisett,Plymouth County,MA,Mattapoisett,1991,8.8,287,2993,3280
4180,Mattapoisett,Plymouth County,MA,Mattapoisett,1992,9,293,2980,3273
4181,Mattapoisett,Plymouth County,MA,Mattapoisett,1993,6.8,225,3084,3309
4182,Mattapoisett,Plymouth County,MA,Mattapoisett,1994,5.7,188,3121,3309
4183,Mattapoisett,Plymouth County,MA,Mattapoisett,1995,5.5,185,3190,3375
4184,Mattapoisett,Plymouth County,MA,Mattapoisett,1996,4.9,164,3201,3365
4185,Mattapoisett,Plymouth County,MA,Mattapoisett,1997,3.8,132,3311,3443
4186,Mattapoisett,Plymouth County,MA,Mattapoisett,1998,3,105,3372,3477
4187,Mattapoisett,Plymouth County,MA,Mattapoisett,1999,3.2,113,3421,3534
4188,Mattapoisett,Plymouth County,MA,Mattapoisett,2000,2.6,87,3257,3344
4189,Mattapoisett,Plymouth County,MA,Mattapoisett,2001,3.1,104,3240,3344
4190,Mattapoisett,Plymouth County,MA,Mattapoisett,2002,4,137,3267,3404
4191,Mattapoisett,Plymouth County,MA,Mattapoisett,2003,4.6,156,3228,3384
4192,Mattapoisett,Plymouth County,MA,Mattapoisett,2004,4.7,160,3247,3407
4193,Mattapoisett,Plymouth County,MA,Mattapoisett,2005,4,139,3305,3444
4194,Mattapoisett,Plymouth County,MA,Mattapoisett,2006,4.2,146,3358,3504
4195,Mattapoisett,Plymouth County,MA,Mattapoisett,2007,3.8,131,3355,3486
4196,Mattapoisett,Plymouth County,MA,Mattapoisett,2008,4.7,161,3275,3436
4197,Mattapoisett,Plymouth County,MA,Mattapoisett,2009,6.8,234,3212,3446
4198,Mattapoisett,Plymouth County,MA,Mattapoisett,2010,8,254,2938,3192
4199,Mattapoisett,Plymouth County,MA,Mattapoisett,2011,7.6,246,2981,3227
4200,Mattapoisett,Plymouth County,MA,Mattapoisett,2012,6.7,218,3017,3235
4201,Maynard,Middlesex County,MA,Maynard,1990,4.9,296,5696,5992
4202,Maynard,Middlesex County,MA,Maynard,1991,6.9,410,5508,5918
4203,Maynard,Middlesex County,MA,Maynard,1992,7,416,5529,5945
4204,Maynard,Middlesex County,MA,Maynard,1993,6.1,364,5597,5961
4205,Maynard,Middlesex County,MA,Maynard,1994,5.5,326,5644,5970
4206,Maynard,Middlesex County,MA,Maynard,1995,4.8,283,5670,5953
4207,Maynard,Middlesex County,MA,Maynard,1996,3.7,220,5788,6008
4208,Maynard,Middlesex County,MA,Maynard,1997,3.4,206,5925,6131
4209,Maynard,Middlesex County,MA,Maynard,1998,2.6,162,6014,6176
4210,Maynard,Middlesex County,MA,Maynard,1999,2.8,177,6072,6249
4211,Maynard,Middlesex County,MA,Maynard,2000,2.3,146,6123,6269
4212,Maynard,Middlesex County,MA,Maynard,2001,3.5,221,6089,6310
4213,Maynard,Middlesex County,MA,Maynard,2002,5.3,333,5972,6305
4214,Maynard,Middlesex County,MA,Maynard,2003,5.3,328,5848,6176
4215,Maynard,Middlesex County,MA,Maynard,2004,4.7,286,5832,6118
4216,Maynard,Middlesex County,MA,Maynard,2005,4.2,256,5841,6097
4217,Maynard,Middlesex County,MA,Maynard,2006,4.3,259,5793,6052
4218,Maynard,Middlesex County,MA,Maynard,2007,3.7,228,5869,6097
4219,Maynard,Middlesex County,MA,Maynard,2008,4.3,266,5905,6171
4220,Maynard,Middlesex County,MA,Maynard,2009,6.7,414,5790,6204
4221,Maynard,Middlesex County,MA,Maynard,2010,7,418,5589,6007
4222,Maynard,Middlesex County,MA,Maynard,2011,6.4,390,5672,6062
4223,Maynard,Middlesex County,MA,Maynard,2012,5.5,331,5734,6065
4224,Medfield,Norfolk County,MA,Medfield,1990,4.2,247,5626,5873
4225,Medfield,Norfolk County,MA,Medfield,1991,5.4,314,5501,5815
4226,Medfield,Norfolk County,MA,Medfield,1992,5.5,323,5504,5827
4227,Medfield,Norfolk County,MA,Medfield,1993,4.5,268,5709,5977
4228,Medfield,Norfolk County,MA,Medfield,1994,3.2,199,5982,6181
4229,Medfield,Norfolk County,MA,Medfield,1995,3.1,193,5952,6145
4230,Medfield,Norfolk County,MA,Medfield,1996,2.5,159,6139,6298
4231,Medfield,Norfolk County,MA,Medfield,1997,2.2,142,6354,6496
4232,Medfield,Norfolk County,MA,Medfield,1998,1.6,108,6480,6588
4233,Medfield,Norfolk County,MA,Medfield,1999,1.8,120,6563,6683
4234,Medfield,Norfolk County,MA,Medfield,2000,2,124,5959,6083
4235,Medfield,Norfolk County,MA,Medfield,2001,2.7,164,5990,6154
4236,Medfield,Norfolk County,MA,Medfield,2002,4,246,5880,6126
4237,Medfield,Norfolk County,MA,Medfield,2003,4.6,276,5786,6062
4238,Medfield,Norfolk County,MA,Medfield,2004,3.9,233,5783,6016
4239,Medfield,Norfolk County,MA,Medfield,2005,3.4,203,5817,6020
4240,Medfield,Norfolk County,MA,Medfield,2006,3.7,219,5654,5873
4241,Medfield,Norfolk County,MA,Medfield,2007,3.3,197,5703,5900
4242,Medfield,Norfolk County,MA,Medfield,2008,4.2,252,5709,5961
4243,Medfield,Norfolk County,MA,Medfield,2009,6.4,376,5517,5893
4244,Medfield,Norfolk County,MA,Medfield,2010,6.6,386,5489,5875
4245,Medfield,Norfolk County,MA,Medfield,2011,5.3,309,5551,5860
4246,Medfield,Norfolk County,MA,Medfield,2012,5,298,5612,5910
4247,Medford,Middlesex County,MA,Medford,1990,5.4,1724,30306,32030
4248,Medford,Middlesex County,MA,Medford,1991,7.5,2365,29279,31644
4249,Medford,Middlesex County,MA,Medford,1992,7.7,2406,28760,31166
4250,Medford,Middlesex County,MA,Medford,1993,6.1,1853,28711,30564
4251,Medford,Middlesex County,MA,Medford,1994,5.4,1649,28827,30476
4252,Medford,Middlesex County,MA,Medford,1995,4.8,1485,29411,30896
4253,Medford,Middlesex County,MA,Medford,1996,3.9,1226,29860,31086
4254,Medford,Middlesex County,MA,Medford,1997,3.6,1127,30526,31653
4255,Medford,Middlesex County,MA,Medford,1998,2.7,844,30700,31544
4256,Medford,Middlesex County,MA,Medford,1999,2.6,835,30795,31630
4257,Medford,Middlesex County,MA,Medford,2000,2.4,736,29882,30618
4258,Medford,Middlesex County,MA,Medford,2001,3.4,1032,29659,30691
4259,Medford,Middlesex County,MA,Medford,2002,5,1503,28812,30315
4260,Medford,Middlesex County,MA,Medford,2003,5.6,1676,28206,29882
4261,Medford,Middlesex County,MA,Medford,2004,4.9,1452,27974,29426
4262,Medford,Middlesex County,MA,Medford,2005,4.4,1291,27984,29275
4263,Medford,Middlesex County,MA,Medford,2006,4.4,1317,28808,30125
4264,Medford,Middlesex County,MA,Medford,2007,4,1220,28908,30128
4265,Medford,Middlesex County,MA,Medford,2008,4.8,1464,28800,30264
4266,Medford,Middlesex County,MA,Medford,2009,7.6,2287,27729,30016
4267,Medford,Middlesex County,MA,Medford,2010,7.4,2259,28446,30705
4268,Medford,Middlesex County,MA,Medford,2011,6,1858,28856,30714
4269,Medford,Middlesex County,MA,Medford,2012,5.6,1738,29172,30910
4270,Medway,Norfolk County,MA,Medway,1990,6.8,379,5218,5597
4271,Medway,Norfolk County,MA,Medway,1991,8.2,462,5183,5645
4272,Medway,Norfolk County,MA,Medway,1992,8.3,478,5254,5732
4273,Medway,Norfolk County,MA,Medway,1993,5.6,329,5501,5830
4274,Medway,Norfolk County,MA,Medway,1994,4.5,272,5755,6027
4275,Medway,Norfolk County,MA,Medway,1995,4.2,252,5789,6041
4276,Medway,Norfolk County,MA,Medway,1996,3,186,5989,6175
4277,Medway,Norfolk County,MA,Medway,1997,2.7,175,6213,6388
4278,Medway,Norfolk County,MA,Medway,1998,2.3,148,6401,6549
4279,Medway,Norfolk County,MA,Medway,1999,2.4,157,6517,6674
4280,Medway,Norfolk County,MA,Medway,2000,2,137,6885,7022
4281,Medway,Norfolk County,MA,Medway,2001,2.9,207,6942,7149
4282,Medway,Norfolk County,MA,Medway,2002,4.3,312,6938,7250
4283,Medway,Norfolk County,MA,Medway,2003,4.6,331,6854,7185
4284,Medway,Norfolk County,MA,Medway,2004,3.6,258,6843,7101
4285,Medway,Norfolk County,MA,Medway,2005,3.8,272,6873,7145
4286,Medway,Norfolk County,MA,Medway,2006,3.9,277,6794,7071
4287,Medway,Norfolk County,MA,Medway,2007,3.4,244,6838,7082
4288,Medway,Norfolk County,MA,Medway,2008,4.7,334,6827,7161
4289,Medway,Norfolk County,MA,Medway,2009,7.1,504,6612,7116
4290,Medway,Norfolk County,MA,Medway,2010,6.8,487,6626,7113
4291,Medway,Norfolk County,MA,Medway,2011,6.1,437,6701,7138
4292,Medway,Norfolk County,MA,Medway,2012,5,358,6775,7133
4293,Melrose,Middlesex County,MA,Melrose,1990,4.6,720,14789,15509
4294,Melrose,Middlesex County,MA,Melrose,1991,6.6,999,14182,15181
4295,Melrose,Middlesex County,MA,Melrose,1992,7.1,1058,13940,14998
4296,Melrose,Middlesex County,MA,Melrose,1993,5.3,781,13868,14649
4297,Melrose,Middlesex County,MA,Melrose,1994,4.5,654,14025,14679
4298,Melrose,Middlesex County,MA,Melrose,1995,4,600,14272,14872
4299,Melrose,Middlesex County,MA,Melrose,1996,3.6,537,14500,15037
4300,Melrose,Middlesex County,MA,Melrose,1997,3.2,485,14836,15321
4301,Melrose,Middlesex County,MA,Melrose,1998,2.4,368,14963,15331
4302,Melrose,Middlesex County,MA,Melrose,1999,2.4,376,15021,15397
4303,Melrose,Middlesex County,MA,Melrose,2000,2.1,330,15170,15500
4304,Melrose,Middlesex County,MA,Melrose,2001,3,459,15057,15516
4305,Melrose,Middlesex County,MA,Melrose,2002,4.7,721,14695,15416
4306,Melrose,Middlesex County,MA,Melrose,2003,4.9,749,14394,15143
4307,Melrose,Middlesex County,MA,Melrose,2004,4.5,673,14288,14961
4308,Melrose,Middlesex County,MA,Melrose,2005,3.9,582,14348,14930
4309,Melrose,Middlesex County,MA,Melrose,2006,3.7,557,14322,14879
4310,Melrose,Middlesex County,MA,Melrose,2007,3.4,505,14456,14961
4311,Melrose,Middlesex County,MA,Melrose,2008,4.3,647,14425,15072
4312,Melrose,Middlesex County,MA,Melrose,2009,7,1056,14069,15125
4313,Melrose,Middlesex County,MA,Melrose,2010,6.5,987,14223,15210
4314,Melrose,Middlesex County,MA,Melrose,2011,5.5,838,14433,15271
4315,Melrose,Middlesex County,MA,Melrose,2012,4.8,742,14591,15333
4316,Mendon,Worcester County,MA,Mendon,1990,6.2,142,2138,2280
4317,Mendon,Worcester County,MA,Mendon,1991,8.6,202,2141,2343
4318,Mendon,Worcester County,MA,Mendon,1992,7.5,178,2184,2362
4319,Mendon,Worcester County,MA,Mendon,1993,6,146,2272,2418
4320,Mendon,Worcester County,MA,Mendon,1994,5.1,127,2369,2496
4321,Mendon,Worcester County,MA,Mendon,1995,5.2,124,2252,2376
4322,Mendon,Worcester County,MA,Mendon,1996,4.2,102,2333,2435
4323,Mendon,Worcester County,MA,Mendon,1997,3.4,86,2462,2548
4324,Mendon,Worcester County,MA,Mendon,1998,2.4,62,2568,2630
4325,Mendon,Worcester County,MA,Mendon,1999,2.3,64,2693,2757
4326,Mendon,Worcester County,MA,Mendon,2000,2.2,67,3020,3087
4327,Mendon,Worcester County,MA,Mendon,2001,2.8,90,3096,3186
4328,Mendon,Worcester County,MA,Mendon,2002,4.8,155,3091,3246
4329,Mendon,Worcester County,MA,Mendon,2003,4.6,150,3093,3243
4330,Mendon,Worcester County,MA,Mendon,2004,4.2,137,3139,3276
4331,Mendon,Worcester County,MA,Mendon,2005,3.6,120,3184,3304
4332,Mendon,Worcester County,MA,Mendon,2006,3.7,123,3210,3333
4333,Mendon,Worcester County,MA,Mendon,2007,3.6,121,3249,3370
4334,Mendon,Worcester County,MA,Mendon,2008,4.2,142,3276,3418
4335,Mendon,Worcester County,MA,Mendon,2009,6.5,215,3089,3304
4336,Mendon,Worcester County,MA,Mendon,2010,6.6,220,3133,3353
4337,Mendon,Worcester County,MA,Mendon,2011,5.9,196,3143,3339
4338,Mendon,Worcester County,MA,Mendon,2012,5.2,173,3172,3345
4339,Merrimac,Essex County,MA,Merrimac,1990,6.6,191,2696,2887
4340,Merrimac,Essex County,MA,Merrimac,1991,9,262,2665,2927
4341,Merrimac,Essex County,MA,Merrimac,1992,8.1,246,2781,3027
4342,Merrimac,Essex County,MA,Merrimac,1993,6.9,211,2863,3074
4343,Merrimac,Essex County,MA,Merrimac,1994,6.2,201,3020,3221
4344,Merrimac,Essex County,MA,Merrimac,1995,5.5,172,2947,3119
4345,Merrimac,Essex County,MA,Merrimac,1996,4.2,134,3068,3202
4346,Merrimac,Essex County,MA,Merrimac,1997,4.1,133,3149,3282
4347,Merrimac,Essex County,MA,Merrimac,1998,3.3,113,3274,3387
4348,Merrimac,Essex County,MA,Merrimac,1999,2.9,102,3408,3510
4349,Merrimac,Essex County,MA,Merrimac,2000,2.2,79,3478,3557
4350,Merrimac,Essex County,MA,Merrimac,2001,3.4,121,3466,3587
4351,Merrimac,Essex County,MA,Merrimac,2002,5.4,193,3381,3574
4352,Merrimac,Essex County,MA,Merrimac,2003,5.2,181,3309,3490
4353,Merrimac,Essex County,MA,Merrimac,2004,4.7,163,3277,3440
4354,Merrimac,Essex County,MA,Merrimac,2005,4.2,146,3325,3471
4355,Merrimac,Essex County,MA,Merrimac,2006,3.9,136,3373,3509
4356,Merrimac,Essex County,MA,Merrimac,2007,3.8,134,3395,3529
4357,Merrimac,Essex County,MA,Merrimac,2008,4.7,168,3387,3555
4358,Merrimac,Essex County,MA,Merrimac,2009,7.4,266,3329,3595
4359,Merrimac,Essex County,MA,Merrimac,2010,7.5,267,3271,3538
4360,Merrimac,Essex County,MA,Merrimac,2011,6.3,221,3314,3535
4361,Merrimac,Essex County,MA,Merrimac,2012,5.9,211,3357,3568
4362,Methuen,Essex County,MA,Methuen,1990,7.5,1498,18572,20070
4363,Methuen,Essex County,MA,Methuen,1991,10.4,2122,18270,20392
4364,Methuen,Essex County,MA,Methuen,1992,10.6,2205,18521,20726
4365,Methuen,Essex County,MA,Methuen,1993,9.9,2069,18805,20874
4366,Methuen,Essex County,MA,Methuen,1994,8.9,1870,19079,20949
4367,Methuen,Essex County,MA,Methuen,1995,7.3,1511,19322,20833
4368,Methuen,Essex County,MA,Methuen,1996,6.4,1348,19875,21223
4369,Methuen,Essex County,MA,Methuen,1997,5.9,1254,20168,21422
4370,Methuen,Essex County,MA,Methuen,1998,5,1085,20652,21737
4371,Methuen,Essex County,MA,Methuen,1999,4.8,1072,21148,22220
4372,Methuen,Essex County,MA,Methuen,2000,3.3,737,21702,22439
4373,Methuen,Essex County,MA,Methuen,2001,4.6,1062,21817,22879
4374,Methuen,Essex County,MA,Methuen,2002,7.3,1708,21574,23282
4375,Methuen,Essex County,MA,Methuen,2003,7.6,1779,21585,23364
4376,Methuen,Essex County,MA,Methuen,2004,6.7,1558,21627,23185
4377,Methuen,Essex County,MA,Methuen,2005,6.1,1401,21708,23109
4378,Methuen,Essex County,MA,Methuen,2006,5.8,1339,21821,23160
4379,Methuen,Essex County,MA,Methuen,2007,5.4,1248,21951,23199
4380,Methuen,Essex County,MA,Methuen,2008,6.5,1532,21886,23418
4381,Methuen,Essex County,MA,Methuen,2009,10.2,2418,21278,23696
4382,Methuen,Essex County,MA,Methuen,2010,10,2429,21910,24339
4383,Methuen,Essex County,MA,Methuen,2011,8.7,2124,22342,24466
4384,Methuen,Essex County,MA,Methuen,2012,8.5,2091,22649,24740
4385,Middleborough,Plymouth County,MA,Middleborough,1990,9.3,885,8609,9494
4386,Middleborough,Plymouth County,MA,Middleborough,1991,12.7,1203,8255,9458
4387,Middleborough,Plymouth County,MA,Middleborough,1992,12.9,1217,8207,9424
4388,Middleborough,Plymouth County,MA,Middleborough,1993,10.7,1031,8565,9596
4389,Middleborough,Plymouth County,MA,Middleborough,1994,8,792,9099,9891
4390,Middleborough,Plymouth County,MA,Middleborough,1995,6.9,691,9319,10010
4391,Middleborough,Plymouth County,MA,Middleborough,1996,5.8,583,9463,10046
4392,Middleborough,Plymouth County,MA,Middleborough,1997,5.6,580,9816,10396
4393,Middleborough,Plymouth County,MA,Middleborough,1998,4.3,448,9935,10383
4394,Middleborough,Plymouth County,MA,Middleborough,1999,4.1,438,10136,10574
4395,Middleborough,Plymouth County,MA,Middleborough,2000,3,331,10721,11052
4396,Middleborough,Plymouth County,MA,Middleborough,2001,3.5,389,10777,11166
4397,Middleborough,Plymouth County,MA,Middleborough,2002,5.2,587,10776,11363
4398,Middleborough,Plymouth County,MA,Middleborough,2003,5.8,651,10621,11272
4399,Middleborough,Plymouth County,MA,Middleborough,2004,5.3,594,10699,11293
4400,Middleborough,Plymouth County,MA,Middleborough,2005,5.4,609,10771,11380
4401,Middleborough,Plymouth County,MA,Middleborough,2006,5.6,652,10967,11619
4402,Middleborough,Plymouth County,MA,Middleborough,2007,5.6,657,11086,11743
4403,Middleborough,Plymouth County,MA,Middleborough,2008,6.7,785,10942,11727
4404,Middleborough,Plymouth County,MA,Middleborough,2009,9.6,1136,10702,11838
4405,Middleborough,Plymouth County,MA,Middleborough,2010,9.6,1230,11562,12792
4406,Middleborough,Plymouth County,MA,Middleborough,2011,8.5,1090,11670,12760
4407,Middleborough,Plymouth County,MA,Middleborough,2012,7.4,938,11773,12711
4408,Middlefield,Hampshire County,MA,Middlefield,1990,3.8,8,200,208
4409,Middlefield,Hampshire County,MA,Middlefield,1991,9.8,21,194,215
4410,Middlefield,Hampshire County,MA,Middlefield,1992,8.6,20,213,233
4411,Middlefield,Hampshire County,MA,Middlefield,1993,5.8,14,228,242
4412,Middlefield,Hampshire County,MA,Middlefield,1994,4.3,11,247,258
4413,Middlefield,Hampshire County,MA,Middlefield,1995,3,8,260,268
4414,Middlefield,Hampshire County,MA,Middlefield,1996,4.1,11,256,267
4415,Middlefield,Hampshire County,MA,Middlefield,1997,3.4,9,258,267
4416,Middlefield,Hampshire County,MA,Middlefield,1998,1.8,5,271,276
4417,Middlefield,Hampshire County,MA,Middlefield,1999,2.7,8,293,301
4418,Middlefield,Hampshire County,MA,Middlefield,2000,1.9,6,314,320
4419,Middlefield,Hampshire County,MA,Middlefield,2001,2.2,7,315,322
4420,Middlefield,Hampshire County,MA,Middlefield,2002,2.8,9,312,321
4421,Middlefield,Hampshire County,MA,Middlefield,2003,3.4,11,310,321
4422,Middlefield,Hampshire County,MA,Middlefield,2004,3.7,12,309,321
4423,Middlefield,Hampshire County,MA,Middlefield,2005,3.7,12,312,324
4424,Middlefield,Hampshire County,MA,Middlefield,2006,3.7,12,315,327
4425,Middlefield,Hampshire County,MA,Middlefield,2007,2.8,9,316,325
4426,Middlefield,Hampshire County,MA,Middlefield,2008,3.4,11,316,327
4427,Middlefield,Hampshire County,MA,Middlefield,2009,7.4,24,302,326
4428,Middlefield,Hampshire County,MA,Middlefield,2010,6.3,19,284,303
4429,Middlefield,Hampshire County,MA,Middlefield,2011,6.3,19,281,300
4430,Middlefield,Hampshire County,MA,Middlefield,2012,5.1,15,281,296
4454,Middleton,Essex County,MA,Middleton,1990,5.7,162,2698,2860
4455,Middleton,Essex County,MA,Middleton,1991,6.8,194,2652,2846
4456,Middleton,Essex County,MA,Middleton,1992,8.2,242,2700,2942
4457,Middleton,Essex County,MA,Middleton,1993,7.2,215,2751,2966
4458,Middleton,Essex County,MA,Middleton,1994,5.9,182,2887,3069
4459,Middleton,Essex County,MA,Middleton,1995,3.9,119,2954,3073
4460,Middleton,Essex County,MA,Middleton,1996,3.7,119,3095,3214
4461,Middleton,Essex County,MA,Middleton,1997,3.7,125,3271,3396
4462,Middleton,Essex County,MA,Middleton,1998,3.2,113,3420,3533
4463,Middleton,Essex County,MA,Middleton,1999,2.7,97,3549,3646
4464,Middleton,Essex County,MA,Middleton,2000,2.4,88,3567,3655
4465,Middleton,Essex County,MA,Middleton,2001,3.2,128,3873,4001
4466,Middleton,Essex County,MA,Middleton,2002,4.4,177,3870,4047
4467,Middleton,Essex County,MA,Middleton,2003,4.8,195,3898,4093
4468,Middleton,Essex County,MA,Middleton,2004,5,206,3948,4154
4469,Middleton,Essex County,MA,Middleton,2005,4.4,186,4063,4249
4470,Middleton,Essex County,MA,Middleton,2006,4.1,164,3827,3991
4471,Middleton,Essex County,MA,Middleton,2007,4.1,165,3896,4061
4472,Middleton,Essex County,MA,Middleton,2008,5,207,3963,4170
4473,Middleton,Essex County,MA,Middleton,2009,7.7,324,3864,4188
4474,Middleton,Essex County,MA,Middleton,2010,8.4,349,3814,4163
4475,Middleton,Essex County,MA,Middleton,2011,7,290,3857,4147
4476,Middleton,Essex County,MA,Middleton,2012,6,250,3899,4149
4477,Milford,Worcester County,MA,Milford,1990,7.2,1006,12910,13916
4478,Milford,Worcester County,MA,Milford,1991,9.7,1337,12400,13737
4479,Milford,Worcester County,MA,Milford,1992,9.1,1231,12243,13474
4480,Milford,Worcester County,MA,Milford,1993,7,924,12342,13266
4481,Milford,Worcester County,MA,Milford,1994,6.1,815,12588,13403
4482,Milford,Worcester County,MA,Milford,1995,6.2,840,12705,13545
4483,Milford,Worcester County,MA,Milford,1996,4.8,651,12911,13562
4484,Milford,Worcester County,MA,Milford,1997,4.5,625,13269,13894
4485,Milford,Worcester County,MA,Milford,1998,3.7,522,13559,14081
4486,Milford,Worcester County,MA,Milford,1999,3.4,492,13847,14339
4487,Milford,Worcester County,MA,Milford,2000,2.6,378,14409,14787
4488,Milford,Worcester County,MA,Milford,2001,3.4,518,14506,15024
4489,Milford,Worcester County,MA,Milford,2002,5.6,844,14292,15136
4490,Milford,Worcester County,MA,Milford,2003,6.1,918,14105,15023
4491,Milford,Worcester County,MA,Milford,2004,5.2,773,14203,14976
4492,Milford,Worcester County,MA,Milford,2005,4.4,674,14482,15156
4493,Milford,Worcester County,MA,Milford,2006,4.5,679,14567,15246
4494,Milford,Worcester County,MA,Milford,2007,4.3,655,14606,15261
4495,Milford,Worcester County,MA,Milford,2008,5.2,804,14730,15534
4496,Milford,Worcester County,MA,Milford,2009,7.8,1200,14223,15423
4497,Milford,Worcester County,MA,Milford,2010,7.7,1190,14288,15478
4498,Milford,Worcester County,MA,Milford,2011,6.5,991,14328,15319
4499,Milford,Worcester County,MA,Milford,2012,6,915,14459,15374
4500,Millbury,Worcester County,MA,Millbury,1990,6.8,461,6315,6776
4501,Millbury,Worcester County,MA,Millbury,1991,10,680,6110,6790
4502,Millbury,Worcester County,MA,Millbury,1992,9.7,657,6100,6757
4503,Millbury,Worcester County,MA,Millbury,1993,7.3,494,6299,6793
4504,Millbury,Worcester County,MA,Millbury,1994,5.2,347,6358,6705
4505,Millbury,Worcester County,MA,Millbury,1995,5.1,345,6361,6706
4506,Millbury,Worcester County,MA,Millbury,1996,4.3,292,6429,6721
4507,Millbury,Worcester County,MA,Millbury,1997,4,271,6570,6841
4508,Millbury,Worcester County,MA,Millbury,1998,3.1,216,6653,6869
4509,Millbury,Worcester County,MA,Millbury,1999,3.3,225,6623,6848
4510,Millbury,Worcester County,MA,Millbury,2000,2.4,174,7054,7228
4511,Millbury,Worcester County,MA,Millbury,2001,3.6,262,7108,7370
4512,Millbury,Worcester County,MA,Millbury,2002,4.9,368,7074,7442
4513,Millbury,Worcester County,MA,Millbury,2003,5.3,398,7079,7477
4514,Millbury,Worcester County,MA,Millbury,2004,4.8,359,7104,7463
4515,Millbury,Worcester County,MA,Millbury,2005,4.7,349,7127,7476
4516,Millbury,Worcester County,MA,Millbury,2006,4.6,349,7226,7575
4517,Millbury,Worcester County,MA,Millbury,2007,4.6,346,7217,7563
4518,Millbury,Worcester County,MA,Millbury,2008,5.6,417,7060,7477
4519,Millbury,Worcester County,MA,Millbury,2009,8.4,628,6859,7487
4520,Millbury,Worcester County,MA,Millbury,2010,8.4,619,6722,7341
4521,Millbury,Worcester County,MA,Millbury,2011,7.7,564,6782,7346
4522,Millbury,Worcester County,MA,Millbury,2012,6.9,502,6779,7281
4523,Millis,Norfolk County,MA,Millis,1990,5.4,244,4274,4518
4524,Millis,Norfolk County,MA,Millis,1991,7,318,4223,4541
4525,Millis,Norfolk County,MA,Millis,1992,6.6,299,4248,4547
4526,Millis,Norfolk County,MA,Millis,1993,5.4,244,4301,4545
4527,Millis,Norfolk County,MA,Millis,1994,4.6,212,4394,4606
4528,Millis,Norfolk County,MA,Millis,1995,4.2,190,4386,4576
4529,Millis,Norfolk County,MA,Millis,1996,3.5,163,4509,4672
4530,Millis,Norfolk County,MA,Millis,1997,2.6,127,4666,4793
4531,Millis,Norfolk County,MA,Millis,1998,2.5,120,4729,4849
4532,Millis,Norfolk County,MA,Millis,1999,2.5,124,4762,4886
4533,Millis,Norfolk County,MA,Millis,2000,2.2,99,4425,4524
4534,Millis,Norfolk County,MA,Millis,2001,3,137,4438,4575
4535,Millis,Norfolk County,MA,Millis,2002,4.5,207,4370,4577
4536,Millis,Norfolk County,MA,Millis,2003,5.3,240,4316,4556
4537,Millis,Norfolk County,MA,Millis,2004,4.4,197,4306,4503
4538,Millis,Norfolk County,MA,Millis,2005,4,180,4333,4513
4539,Millis,Norfolk County,MA,Millis,2006,4.1,184,4273,4457
4540,Millis,Norfolk County,MA,Millis,2007,4.1,186,4302,4488
4541,Millis,Norfolk County,MA,Millis,2008,4.8,219,4315,4534
4542,Millis,Norfolk County,MA,Millis,2009,7.5,336,4168,4504
4543,Millis,Norfolk County,MA,Millis,2010,7.3,329,4158,4487
4544,Millis,Norfolk County,MA,Millis,2011,6.4,288,4204,4492
4545,Millis,Norfolk County,MA,Millis,2012,5.7,259,4250,4509
4546,Millville,Worcester County,MA,Millville,1990,7,88,1172,1260
4547,Millville,Worcester County,MA,Millville,1991,9.9,126,1145,1271
4548,Millville,Worcester County,MA,Millville,1992,9,120,1210,1330
4549,Millville,Worcester County,MA,Millville,1993,9.1,125,1251,1376
4550,Millville,Worcester County,MA,Millville,1994,5.1,70,1307,1377
4551,Millville,Worcester County,MA,Millville,1995,7.1,95,1235,1330
4552,Millville,Worcester County,MA,Millville,1996,5.8,78,1271,1349
4553,Millville,Worcester County,MA,Millville,1997,4.8,66,1322,1388
4554,Millville,Worcester County,MA,Millville,1998,4.1,58,1369,1427
4555,Millville,Worcester County,MA,Millville,1999,3.6,53,1400,1453
4556,Millville,Worcester County,MA,Millville,2000,3.2,49,1467,1516
4557,Millville,Worcester County,MA,Millville,2001,4.4,68,1476,1544
4558,Millville,Worcester County,MA,Millville,2002,6.7,108,1515,1623
4559,Millville,Worcester County,MA,Millville,2003,6.2,103,1552,1655
4560,Millville,Worcester County,MA,Millville,2004,5.2,86,1562,1648
4561,Millville,Worcester County,MA,Millville,2005,4.8,79,1577,1656
4562,Millville,Worcester County,MA,Millville,2006,5.5,93,1598,1691
4563,Millville,Worcester County,MA,Millville,2007,5.2,84,1537,1621
4564,Millville,Worcester County,MA,Millville,2008,6.5,105,1521,1626
4565,Millville,Worcester County,MA,Millville,2009,10.7,181,1508,1689
4566,Millville,Worcester County,MA,Millville,2010,11,200,1621,1821
4567,Millville,Worcester County,MA,Millville,2011,9.2,166,1635,1801
4568,Millville,Worcester County,MA,Millville,2012,8.9,161,1638,1799
4569,Milton,Norfolk County,MA,Milton,1990,3.8,508,12720,13228
4570,Milton,Norfolk County,MA,Milton,1991,5.4,697,12260,12957
4571,Milton,Norfolk County,MA,Milton,1992,5.2,670,12247,12917
4572,Milton,Norfolk County,MA,Milton,1993,5,653,12535,13188
4573,Milton,Norfolk County,MA,Milton,1994,4.1,529,12501,13030
4574,Milton,Norfolk County,MA,Milton,1995,3.7,488,12627,13115
4575,Milton,Norfolk County,MA,Milton,1996,3,402,12832,13234
4576,Milton,Norfolk County,MA,Milton,1997,2.4,327,13095,13422
4577,Milton,Norfolk County,MA,Milton,1998,2.1,284,13260,13544
4578,Milton,Norfolk County,MA,Milton,1999,2,268,13288,13556
4579,Milton,Norfolk County,MA,Milton,2000,2.2,301,13460,13761
4580,Milton,Norfolk County,MA,Milton,2001,2.7,370,13384,13754
4581,Milton,Norfolk County,MA,Milton,2002,4.2,571,13105,13676
4582,Milton,Norfolk County,MA,Milton,2003,4.5,603,12845,13448
4583,Milton,Norfolk County,MA,Milton,2004,4.2,562,12862,13424
4584,Milton,Norfolk County,MA,Milton,2005,3.8,522,13084,13606
4585,Milton,Norfolk County,MA,Milton,2006,4.1,558,13190,13748
4586,Milton,Norfolk County,MA,Milton,2007,3.6,492,13144,13636
4587,Milton,Norfolk County,MA,Milton,2008,4.3,588,13054,13642
4588,Milton,Norfolk County,MA,Milton,2009,7,950,12559,13509
4589,Milton,Norfolk County,MA,Milton,2010,6.6,934,13145,14079
4590,Milton,Norfolk County,MA,Milton,2011,5.5,774,13288,14062
4591,Milton,Norfolk County,MA,Milton,2012,5,712,13434,14146
4592,Monroe,Franklin County,MA,Monroe,1990,4.3,3,67,70
4593,Monroe,Franklin County,MA,Monroe,1991,5.6,4,68,72
4594,Monroe,Franklin County,MA,Monroe,1992,11.5,9,69,78
4595,Monroe,Franklin County,MA,Monroe,1993,10.6,7,59,66
4596,Monroe,Franklin County,MA,Monroe,1994,11.1,6,48,54
4597,Monroe,Franklin County,MA,Monroe,1995,4.2,3,68,71
4598,Monroe,Franklin County,MA,Monroe,1996,4.2,3,68,71
4599,Monroe,Franklin County,MA,Monroe,1997,5.6,4,68,72
4600,Monroe,Franklin County,MA,Monroe,1998,4.1,3,70,73
4601,Monroe,Franklin County,MA,Monroe,1999,6.5,5,72,77
4602,Monroe,Franklin County,MA,Monroe,2000,12,3,22,25
4603,Monroe,Franklin County,MA,Monroe,2001,11.5,3,23,26
4604,Monroe,Franklin County,MA,Monroe,2002,11.5,3,23,26
4605,Monroe,Franklin County,MA,Monroe,2003,14.8,4,23,27
4606,Monroe,Franklin County,MA,Monroe,2004,11.5,3,23,26
4607,Monroe,Franklin County,MA,Monroe,2005,7.7,2,24,26
4608,Monroe,Franklin County,MA,Monroe,2006,7.7,2,24,26
4609,Monroe,Franklin County,MA,Monroe,2007,11.1,3,24,27
4610,Monroe,Franklin County,MA,Monroe,2008,7.7,2,24,26
4611,Monroe,Franklin County,MA,Monroe,2009,15.4,4,22,26
4612,Monroe,Franklin County,MA,Monroe,2010,15.2,5,28,33
4613,Monroe,Franklin County,MA,Monroe,2011,9.7,3,28,31
4614,Monroe,Franklin County,MA,Monroe,2012,17.6,6,28,34
4615,Monson,Hampden County,MA,Monson,1990,6.3,245,3623,3868
4616,Monson,Hampden County,MA,Monson,1991,8.3,320,3557,3877
4617,Monson,Hampden County,MA,Monson,1992,8.3,328,3615,3943
4618,Monson,Hampden County,MA,Monson,1993,9,363,3673,4036
4619,Monson,Hampden County,MA,Monson,1994,7.5,300,3692,3992
4620,Monson,Hampden County,MA,Monson,1995,6.7,258,3569,3827
4621,Monson,Hampden County,MA,Monson,1996,4.4,168,3629,3797
4622,Monson,Hampden County,MA,Monson,1997,4.3,166,3727,3893
4623,Monson,Hampden County,MA,Monson,1998,3.5,137,3777,3914
4624,Monson,Hampden County,MA,Monson,1999,3.6,144,3819,3963
4625,Monson,Hampden County,MA,Monson,2000,2.8,123,4338,4461
4626,Monson,Hampden County,MA,Monson,2001,3.7,170,4375,4545
4627,Monson,Hampden County,MA,Monson,2002,5.2,242,4388,4630
4628,Monson,Hampden County,MA,Monson,2003,5.8,268,4377,4645
4629,Monson,Hampden County,MA,Monson,2004,5.3,247,4408,4655
4630,Monson,Hampden County,MA,Monson,2005,4.8,223,4466,4689
4631,Monson,Hampden County,MA,Monson,2006,5.1,241,4511,4752
4632,Monson,Hampden County,MA,Monson,2007,4.8,226,4521,4747
4633,Monson,Hampden County,MA,Monson,2008,5.6,270,4565,4835
4634,Monson,Hampden County,MA,Monson,2009,8.1,389,4408,4797
4635,Monson,Hampden County,MA,Monson,2010,8.9,410,4176,4586
4636,Monson,Hampden County,MA,Monson,2011,7.9,357,4135,4492
4637,Monson,Hampden County,MA,Monson,2012,7.2,323,4137,4460
4638,Montague,Franklin County,MA,Montague,1990,4.9,206,4018,4224
4639,Montague,Franklin County,MA,Montague,1991,8,343,3970,4313
4640,Montague,Franklin County,MA,Montague,1992,9.6,416,3923,4339
4641,Montague,Franklin County,MA,Montague,1993,7.1,300,3908,4208
4642,Montague,Franklin County,MA,Montague,1994,6,257,4040,4297
4643,Montague,Franklin County,MA,Montague,1995,6.5,285,4073,4358
4644,Montague,Franklin County,MA,Montague,1996,4.9,209,4083,4292
4645,Montague,Franklin County,MA,Montague,1997,4.4,194,4166,4360
4646,Montague,Franklin County,MA,Montague,1998,3.7,166,4261,4427
4647,Montague,Franklin County,MA,Montague,1999,3.3,146,4334,4480
4648,Montague,Franklin County,MA,Montague,2000,2.9,126,4235,4361
4649,Montague,Franklin County,MA,Montague,2001,3.5,151,4212,4363
4650,Montague,Franklin County,MA,Montague,2002,4.6,207,4260,4467
4651,Montague,Franklin County,MA,Montague,2003,4.9,217,4254,4471
4652,Montague,Franklin County,MA,Montague,2004,4.7,208,4175,4383
4653,Montague,Franklin County,MA,Montague,2005,5,217,4150,4367
4654,Montague,Franklin County,MA,Montague,2006,5,218,4153,4371
4655,Montague,Franklin County,MA,Montague,2007,5,215,4112,4327
4656,Montague,Franklin County,MA,Montague,2008,5.7,243,4039,4282
4657,Montague,Franklin County,MA,Montague,2009,9,381,3857,4238
4658,Montague,Franklin County,MA,Montague,2010,9,399,4053,4452
4659,Montague,Franklin County,MA,Montague,2011,8.2,362,4060,4422
4660,Montague,Franklin County,MA,Montague,2012,7.6,333,4071,4404
4661,Monterey,Berkshire County,MA,Monterey,1990,3.5,14,390,404
4662,Monterey,Berkshire County,MA,Monterey,1991,6.6,27,382,409
4663,Monterey,Berkshire County,MA,Monterey,1992,4.3,17,380,397
4664,Monterey,Berkshire County,MA,Monterey,1993,4.2,17,392,409
4665,Monterey,Berkshire County,MA,Monterey,1994,5.5,23,393,416
4666,Monterey,Berkshire County,MA,Monterey,1995,6.5,29,416,445
4667,Monterey,Berkshire County,MA,Monterey,1996,3.8,17,425,442
4668,Monterey,Berkshire County,MA,Monterey,1997,2.7,12,438,450
4669,Monterey,Berkshire County,MA,Monterey,1998,2.1,9,423,432
4670,Monterey,Berkshire County,MA,Monterey,1999,1.9,8,422,430
4671,Monterey,Berkshire County,MA,Monterey,2000,2.4,13,529,542
4672,Monterey,Berkshire County,MA,Monterey,2001,2.3,13,549,562
4673,Monterey,Berkshire County,MA,Monterey,2002,2.9,17,569,586
4674,Monterey,Berkshire County,MA,Monterey,2003,3.2,19,574,593
4675,Monterey,Berkshire County,MA,Monterey,2004,2.6,15,573,588
4676,Monterey,Berkshire County,MA,Monterey,2005,3,18,587,605
4677,Monterey,Berkshire County,MA,Monterey,2006,2.8,17,593,610
4678,Monterey,Berkshire County,MA,Monterey,2007,2.5,15,584,599
4679,Monterey,Berkshire County,MA,Monterey,2008,3.3,20,580,600
4680,Monterey,Berkshire County,MA,Monterey,2009,4.7,28,569,597
4681,Monterey,Berkshire County,MA,Monterey,2010,3.7,22,574,596
4682,Monterey,Berkshire County,MA,Monterey,2011,4,24,578,602
4683,Monterey,Berkshire County,MA,Monterey,2012,3.7,22,574,596
4684,Montgomery,Hampden County,MA,Montgomery,1990,2.6,11,414,425
4685,Montgomery,Hampden County,MA,Montgomery,1991,5.5,24,412,436
4686,Montgomery,Hampden County,MA,Montgomery,1992,4.7,20,407,427
4687,Montgomery,Hampden County,MA,Montgomery,1993,3.3,14,407,421
4688,Montgomery,Hampden County,MA,Montgomery,1994,4.6,21,432,453
4689,Montgomery,Hampden County,MA,Montgomery,1995,4.4,19,408,427
4690,Montgomery,Hampden County,MA,Montgomery,1996,2.8,12,421,433
4691,Montgomery,Hampden County,MA,Montgomery,1997,4.8,22,439,461
4692,Montgomery,Hampden County,MA,Montgomery,1998,7,30,398,428
4693,Montgomery,Hampden County,MA,Montgomery,1999,3.1,13,411,424
4694,Montgomery,Hampden County,MA,Montgomery,2000,2.3,9,383,392
4695,Montgomery,Hampden County,MA,Montgomery,2001,2.9,12,398,410
4696,Montgomery,Hampden County,MA,Montgomery,2002,3.3,14,409,423
4697,Montgomery,Hampden County,MA,Montgomery,2003,4.6,20,415,435
4698,Montgomery,Hampden County,MA,Montgomery,2004,4.1,18,420,438
4699,Montgomery,Hampden County,MA,Montgomery,2005,4.1,18,426,444
4700,Montgomery,Hampden County,MA,Montgomery,2006,5,23,434,457
4701,Montgomery,Hampden County,MA,Montgomery,2007,4,18,436,454
4702,Montgomery,Hampden County,MA,Montgomery,2008,3.3,14,411,425
4703,Montgomery,Hampden County,MA,Montgomery,2009,7.2,31,397,428
4704,Montgomery,Hampden County,MA,Montgomery,2010,7.5,37,459,496
4705,Montgomery,Hampden County,MA,Montgomery,2011,6,29,454,483
4706,Montgomery,Hampden County,MA,Montgomery,2012,5.8,28,454,482
4707,Mount Washington,Berkshire County,MA,Mount Washington,1990,7,5,66,71
4708,Mount Washington,Berkshire County,MA,Mount Washington,1991,6.3,4,60,64
4709,Mount Washington,Berkshire County,MA,Mount Washington,1992,1.5,1,64,65
4710,Mount Washington,Berkshire County,MA,Mount Washington,1993,1.3,1,75,76
4711,Mount Washington,Berkshire County,MA,Mount Washington,1994,1.2,1,82,83
4712,Mount Washington,Berkshire County,MA,Mount Washington,1995,4.1,3,71,74
4713,Mount Washington,Berkshire County,MA,Mount Washington,1996,1.4,1,72,73
4714,Mount Washington,Berkshire County,MA,Mount Washington,1997,2.7,2,73,75
4715,Mount Washington,Berkshire County,MA,Mount Washington,1998,1.3,1,74,75
4716,Mount Washington,Berkshire County,MA,Mount Washington,1999,3.9,3,73,76
4717,Mount Washington,Berkshire County,MA,Mount Washington,2000,2.3,2,86,88
4718,Mount Washington,Berkshire County,MA,Mount Washington,2001,2.2,2,89,91
4719,Mount Washington,Berkshire County,MA,Mount Washington,2002,3.2,3,92,95
4720,Mount Washington,Berkshire County,MA,Mount Washington,2003,4.1,4,93,97
4721,Mount Washington,Berkshire County,MA,Mount Washington,2004,2.1,2,94,96
4722,Mount Washington,Berkshire County,MA,Mount Washington,2005,4,4,97,101
4723,Mount Washington,Berkshire County,MA,Mount Washington,2006,2,2,100,102
4724,Mount Washington,Berkshire County,MA,Mount Washington,2007,1,1,98,99
4725,Mount Washington,Berkshire County,MA,Mount Washington,2008,1,1,98,99
4726,Mount Washington,Berkshire County,MA,Mount Washington,2009,3.1,3,94,97
4727,Mount Washington,Berkshire County,MA,Mount Washington,2010,3.3,4,117,121
4728,Mount Washington,Berkshire County,MA,Mount Washington,2011,3.3,4,117,121
4729,Mount Washington,Berkshire County,MA,Mount Washington,2012,2.5,3,116,119
4730,Nahant,Essex County,MA,Nahant,1990,4.4,92,2005,2097
4731,Nahant,Essex County,MA,Nahant,1991,7.2,149,1921,2070
4732,Nahant,Essex County,MA,Nahant,1992,7.1,144,1891,2035
4733,Nahant,Essex County,MA,Nahant,1993,6.8,140,1907,2047
4734,Nahant,Essex County,MA,Nahant,1994,5.4,110,1924,2034
4735,Nahant,Essex County,MA,Nahant,1995,4.1,84,1963,2047
4736,Nahant,Essex County,MA,Nahant,1996,4.5,93,1995,2088
4737,Nahant,Essex County,MA,Nahant,1997,3.6,76,2040,2116
4738,Nahant,Essex County,MA,Nahant,1998,2.8,59,2057,2116
4739,Nahant,Essex County,MA,Nahant,1999,2.9,61,2069,2130
4740,Nahant,Essex County,MA,Nahant,2000,2.1,43,1993,2036
4741,Nahant,Essex County,MA,Nahant,2001,3.3,67,1992,2059
4742,Nahant,Essex County,MA,Nahant,2002,5.2,108,1964,2072
4743,Nahant,Essex County,MA,Nahant,2003,5.3,108,1937,2045
4744,Nahant,Essex County,MA,Nahant,2004,4.4,88,1916,2004
4745,Nahant,Essex County,MA,Nahant,2005,4.1,81,1905,1986
4746,Nahant,Essex County,MA,Nahant,2006,4.4,88,1908,1996
4747,Nahant,Essex County,MA,Nahant,2007,4.4,87,1896,1983
4748,Nahant,Essex County,MA,Nahant,2008,4.7,94,1887,1981
4749,Nahant,Essex County,MA,Nahant,2009,7,142,1899,2041
4750,Nahant,Essex County,MA,Nahant,2010,7,135,1788,1923
4751,Nahant,Essex County,MA,Nahant,2011,7,137,1809,1946
4752,Nahant,Essex County,MA,Nahant,2012,5.8,112,1823,1935
4753,Nantucket,Nantucket County,MA,Nantucket,1990,3.2,153,4606,4759
4754,Nantucket,Nantucket County,MA,Nantucket,1991,5.5,269,4588,4857
4755,Nantucket,Nantucket County,MA,Nantucket,1992,4.7,235,4721,4956
4756,Nantucket,Nantucket County,MA,Nantucket,1993,3.9,207,5093,5300
4757,Nantucket,Nantucket County,MA,Nantucket,1994,2.7,152,5409,5561
4758,Nantucket,Nantucket County,MA,Nantucket,1995,2.7,151,5540,5691
4759,Nantucket,Nantucket County,MA,Nantucket,1996,2.4,139,5685,5824
4760,Nantucket,Nantucket County,MA,Nantucket,1997,2.3,141,5957,6098
4761,Nantucket,Nantucket County,MA,Nantucket,1998,1.7,113,6355,6468
4762,Nantucket,Nantucket County,MA,Nantucket,1999,1.7,115,6489,6604
4763,Nantucket,Nantucket County,MA,Nantucket,2000,1.5,108,7181,7289
4764,Nantucket,Nantucket County,MA,Nantucket,2001,1.6,116,7002,7118
4765,Nantucket,Nantucket County,MA,Nantucket,2002,1.9,145,7324,7469
4766,Nantucket,Nantucket County,MA,Nantucket,2003,2.5,195,7496,7691
4767,Nantucket,Nantucket County,MA,Nantucket,2004,2.5,197,7643,7840
4768,Nantucket,Nantucket County,MA,Nantucket,2005,2.4,198,7940,8138
4769,Nantucket,Nantucket County,MA,Nantucket,2006,2.3,194,8218,8412
4770,Nantucket,Nantucket County,MA,Nantucket,2007,2.3,199,8343,8542
4771,Nantucket,Nantucket County,MA,Nantucket,2008,3.3,277,8153,8430
4772,Nantucket,Nantucket County,MA,Nantucket,2009,6.8,530,7278,7808
4773,Nantucket,Nantucket County,MA,Nantucket,2010,7.5,586,7228,7814
4774,Nantucket,Nantucket County,MA,Nantucket,2011,6.7,526,7304,7830
4775,Nantucket,Nantucket County,MA,Nantucket,2012,6,487,7695,8182
4776,Natick,Middlesex County,MA,Natick,1990,4.4,819,17659,18478
4777,Natick,Middlesex County,MA,Natick,1991,6.1,1112,17033,18145
4778,Natick,Middlesex County,MA,Natick,1992,6.1,1106,16942,18048
4779,Natick,Middlesex County,MA,Natick,1993,4.7,853,17255,18108
4780,Natick,Middlesex County,MA,Natick,1994,4,727,17504,18231
4781,Natick,Middlesex County,MA,Natick,1995,3.6,675,17896,18571
4782,Natick,Middlesex County,MA,Natick,1996,2.9,537,18250,18787
4783,Natick,Middlesex County,MA,Natick,1997,2.6,497,18721,19218
4784,Natick,Middlesex County,MA,Natick,1998,1.9,370,19039,19409
4785,Natick,Middlesex County,MA,Natick,1999,2,383,19208,19591
4786,Natick,Middlesex County,MA,Natick,2000,1.9,356,18500,18856
4787,Natick,Middlesex County,MA,Natick,2001,2.7,515,18491,19006
4788,Natick,Middlesex County,MA,Natick,2002,4.1,771,18058,18829
4789,Natick,Middlesex County,MA,Natick,2003,4.5,837,17720,18557
4790,Natick,Middlesex County,MA,Natick,2004,3.7,691,17768,18459
4791,Natick,Middlesex County,MA,Natick,2005,3.3,621,17953,18574
4792,Natick,Middlesex County,MA,Natick,2006,3.5,646,18023,18669
4793,Natick,Middlesex County,MA,Natick,2007,3,575,18295,18870
4794,Natick,Middlesex County,MA,Natick,2008,3.6,692,18407,19099
4795,Natick,Middlesex County,MA,Natick,2009,5.8,1097,17804,18901
4796,Natick,Middlesex County,MA,Natick,2010,5.7,1082,17988,19070
4797,Natick,Middlesex County,MA,Natick,2011,4.7,898,18163,19061
4798,Natick,Middlesex County,MA,Natick,2012,4.3,830,18329,19159
4799,Needham,Norfolk County,MA,Needham,1990,3.7,536,14039,14575
4800,Needham,Norfolk County,MA,Needham,1991,4.9,691,13497,14188
4801,Needham,Norfolk County,MA,Needham,1992,4.9,694,13553,14247
4802,Needham,Norfolk County,MA,Needham,1993,3.9,558,13802,14360
4803,Needham,Norfolk County,MA,Needham,1994,3.5,513,14043,14556
4804,Needham,Norfolk County,MA,Needham,1995,3.3,477,14018,14495
4805,Needham,Norfolk County,MA,Needham,1996,2.2,325,14283,14608
4806,Needham,Norfolk County,MA,Needham,1997,1.9,285,14637,14922
4807,Needham,Norfolk County,MA,Needham,1998,1.7,251,14811,15062
4808,Needham,Norfolk County,MA,Needham,1999,1.6,240,14899,15139
4809,Needham,Norfolk County,MA,Needham,2000,2,284,14120,14404
4810,Needham,Norfolk County,MA,Needham,2001,2.7,396,14114,14510
4811,Needham,Norfolk County,MA,Needham,2002,4.1,597,13891,14488
4812,Needham,Norfolk County,MA,Needham,2003,4.3,619,13673,14292
4813,Needham,Norfolk County,MA,Needham,2004,3.8,537,13639,14176
4814,Needham,Norfolk County,MA,Needham,2005,3.4,484,13697,14181
4815,Needham,Norfolk County,MA,Needham,2006,3.3,465,13632,14097
4816,Needham,Norfolk County,MA,Needham,2007,3.1,432,13726,14158
4817,Needham,Norfolk County,MA,Needham,2008,3.7,530,13777,14307
4818,Needham,Norfolk County,MA,Needham,2009,6,855,13348,14203
4819,Needham,Norfolk County,MA,Needham,2010,5.5,790,13486,14276
4820,Needham,Norfolk County,MA,Needham,2011,4.8,689,13636,14325
4821,Needham,Norfolk County,MA,Needham,2012,4.4,638,13786,14424
4822,New Ashford,Berkshire County,MA,New Ashford,1990,4.1,5,116,121
4823,New Ashford,Berkshire County,MA,New Ashford,1991,7.6,9,109,118
4824,New Ashford,Berkshire County,MA,New Ashford,1992,8.9,11,113,124
4825,New Ashford,Berkshire County,MA,New Ashford,1993,7.5,9,111,120
4826,New Ashford,Berkshire County,MA,New Ashford,1994,9.8,12,111,123
4827,New Ashford,Berkshire County,MA,New Ashford,1995,3.5,4,111,115
4828,New Ashford,Berkshire County,MA,New Ashford,1996,3.5,4,111,115
4829,New Ashford,Berkshire County,MA,New Ashford,1997,5,6,115,121
4830,New Ashford,Berkshire County,MA,New Ashford,1998,5.5,7,120,127
4831,New Ashford,Berkshire County,MA,New Ashford,1999,3.1,4,126,130
4832,New Ashford,Berkshire County,MA,New Ashford,2000,4.5,7,147,154
4833,New Ashford,Berkshire County,MA,New Ashford,2001,3.3,5,148,153
4834,New Ashford,Berkshire County,MA,New Ashford,2002,4.5,7,150,157
4835,New Ashford,Berkshire County,MA,New Ashford,2003,4.5,7,148,155
4836,New Ashford,Berkshire County,MA,New Ashford,2004,3.9,6,148,154
4837,New Ashford,Berkshire County,MA,New Ashford,2005,4.4,7,152,159
4838,New Ashford,Berkshire County,MA,New Ashford,2006,3.7,6,156,162
4839,New Ashford,Berkshire County,MA,New Ashford,2007,3.7,6,157,163
4840,New Ashford,Berkshire County,MA,New Ashford,2008,3.7,6,155,161
4841,New Ashford,Berkshire County,MA,New Ashford,2009,4.4,7,151,158
4842,New Ashford,Berkshire County,MA,New Ashford,2010,4.3,6,133,139
4843,New Ashford,Berkshire County,MA,New Ashford,2011,5.6,8,136,144
4844,New Ashford,Berkshire County,MA,New Ashford,2012,4.9,7,135,142
4845,New Bedford,Bristol County,MA,New Bedford,1990,12.5,5669,39663,45332
4846,New Bedford,Bristol County,MA,New Bedford,1991,16.1,7278,37870,45148
4847,New Bedford,Bristol County,MA,New Bedford,1992,15.3,6718,37225,43943
4848,New Bedford,Bristol County,MA,New Bedford,1993,13.5,5878,37664,43542
4849,New Bedford,Bristol County,MA,New Bedford,1994,13,5664,37847,43511
4850,New Bedford,Bristol County,MA,New Bedford,1995,12.2,5314,38114,43428
4851,New Bedford,Bristol County,MA,New Bedford,1996,11.1,4709,37641,42350
4852,New Bedford,Bristol County,MA,New Bedford,1997,9.5,4040,38419,42459
4853,New Bedford,Bristol County,MA,New Bedford,1998,8.5,3507,37871,41378
4854,New Bedford,Bristol County,MA,New Bedford,1999,7.8,3191,37947,41138
4855,New Bedford,Bristol County,MA,New Bedford,2000,5.5,2306,39621,41927
4856,New Bedford,Bristol County,MA,New Bedford,2001,6.8,2838,39116,41954
4857,New Bedford,Bristol County,MA,New Bedford,2002,8.5,3644,39243,42887
4858,New Bedford,Bristol County,MA,New Bedford,2003,9.5,4012,38297,42309
4859,New Bedford,Bristol County,MA,New Bedford,2004,8.6,3618,38425,42043
4860,New Bedford,Bristol County,MA,New Bedford,2005,8.2,3466,38692,42158
4861,New Bedford,Bristol County,MA,New Bedford,2006,7.9,3374,39122,42496
4862,New Bedford,Bristol County,MA,New Bedford,2007,7.7,3250,38939,42189
4863,New Bedford,Bristol County,MA,New Bedford,2008,9.5,3965,37718,41683
4864,New Bedford,Bristol County,MA,New Bedford,2009,13.8,5837,36552,42389
4865,New Bedford,Bristol County,MA,New Bedford,2010,14,6126,37630,43756
4866,New Bedford,Bristol County,MA,New Bedford,2011,12.8,5592,38020,43612
4867,New Bedford,Bristol County,MA,New Bedford,2012,12.5,5492,38469,43961
4868,New Braintree,Worcester County,MA,New Braintree,1990,6.7,31,433,464
4869,New Braintree,Worcester County,MA,New Braintree,1991,9.7,45,419,464
4870,New Braintree,Worcester County,MA,New Braintree,1992,8.4,39,424,463
4871,New Braintree,Worcester County,MA,New Braintree,1993,4.9,23,450,473
4872,New Braintree,Worcester County,MA,New Braintree,1994,4.9,23,449,472
4873,New Braintree,Worcester County,MA,New Braintree,1995,4.9,22,429,451
4874,New Braintree,Worcester County,MA,New Braintree,1996,4.3,19,425,444
4875,New Braintree,Worcester County,MA,New Braintree,1997,4.8,22,437,459
4876,New Braintree,Worcester County,MA,New Braintree,1998,4.3,20,444,464
4877,New Braintree,Worcester County,MA,New Braintree,1999,3,14,449,463
4878,New Braintree,Worcester County,MA,New Braintree,2000,2.4,13,527,540
4879,New Braintree,Worcester County,MA,New Braintree,2001,2.5,14,542,556
4880,New Braintree,Worcester County,MA,New Braintree,2002,4.3,25,552,577
4881,New Braintree,Worcester County,MA,New Braintree,2003,4.9,29,568,597
4882,New Braintree,Worcester County,MA,New Braintree,2004,4.4,27,581,608
4883,New Braintree,Worcester County,MA,New Braintree,2005,5.7,36,594,630
4884,New Braintree,Worcester County,MA,New Braintree,2006,5.6,36,603,639
4885,New Braintree,Worcester County,MA,New Braintree,2007,5.5,36,613,649
4886,New Braintree,Worcester County,MA,New Braintree,2008,5.5,35,604,639
4887,New Braintree,Worcester County,MA,New Braintree,2009,8.4,54,589,643
4888,New Braintree,Worcester County,MA,New Braintree,2010,9.7,56,520,576
4889,New Braintree,Worcester County,MA,New Braintree,2011,7.3,41,524,565
4890,New Braintree,Worcester County,MA,New Braintree,2012,7.4,42,523,565
4891,New Marlborough,Berkshire County,MA,New Marlborough,1990,1.3,8,592,600
4892,New Marlborough,Berkshire County,MA,New Marlborough,1991,2.3,14,583,597
4893,New Marlborough,Berkshire County,MA,New Marlborough,1992,3.4,20,565,585
4894,New Marlborough,Berkshire County,MA,New Marlborough,1993,2.6,16,596,612
4895,New Marlborough,Berkshire County,MA,New Marlborough,1994,3,18,578,596
4896,New Marlborough,Berkshire County,MA,New Marlborough,1995,2.7,18,649,667
4897,New Marlborough,Berkshire County,MA,New Marlborough,1996,2.1,14,665,679
4898,New Marlborough,Berkshire County,MA,New Marlborough,1997,1.6,11,681,692
4899,New Marlborough,Berkshire County,MA,New Marlborough,1998,1.5,10,676,686
4900,New Marlborough,Berkshire County,MA,New Marlborough,1999,1.8,12,671,683
4901,New Marlborough,Berkshire County,MA,New Marlborough,2000,2.1,17,805,822
4902,New Marlborough,Berkshire County,MA,New Marlborough,2001,2.6,22,839,861
4903,New Marlborough,Berkshire County,MA,New Marlborough,2002,3.4,30,860,890
4904,New Marlborough,Berkshire County,MA,New Marlborough,2003,3.4,30,861,891
4905,New Marlborough,Berkshire County,MA,New Marlborough,2004,3,27,866,893
4906,New Marlborough,Berkshire County,MA,New Marlborough,2005,3.2,29,890,919
4907,New Marlborough,Berkshire County,MA,New Marlborough,2006,3.1,29,901,930
4908,New Marlborough,Berkshire County,MA,New Marlborough,2007,3.3,30,883,913
4909,New Marlborough,Berkshire County,MA,New Marlborough,2008,4.2,38,877,915
4910,New Marlborough,Berkshire County,MA,New Marlborough,2009,6.1,55,852,907
4911,New Marlborough,Berkshire County,MA,New Marlborough,2010,6.7,62,861,923
4912,New Marlborough,Berkshire County,MA,New Marlborough,2011,5,46,865,911
4913,New Marlborough,Berkshire County,MA,New Marlborough,2012,5.5,50,858,908
4914,New Salem,Franklin County,MA,New Salem,1990,5.3,24,426,450
4915,New Salem,Franklin County,MA,New Salem,1991,8.1,37,417,454
4916,New Salem,Franklin County,MA,New Salem,1992,7.1,30,390,420
4917,New Salem,Franklin County,MA,New Salem,1993,4.7,19,386,405
4918,New Salem,Franklin County,MA,New Salem,1994,8.7,37,387,424
4919,New Salem,Franklin County,MA,New Salem,1995,7.7,34,407,441
4920,New Salem,Franklin County,MA,New Salem,1996,4.7,20,404,424
4921,New Salem,Franklin County,MA,New Salem,1997,4,17,410,427
4922,New Salem,Franklin County,MA,New Salem,1998,4.2,18,407,425
4923,New Salem,Franklin County,MA,New Salem,1999,4.3,18,403,421
4924,New Salem,Franklin County,MA,New Salem,2000,2.3,13,546,559
4925,New Salem,Franklin County,MA,New Salem,2001,2.7,15,540,555
4926,New Salem,Franklin County,MA,New Salem,2002,3.4,19,548,567
4927,New Salem,Franklin County,MA,New Salem,2003,4.2,24,546,570
4928,New Salem,Franklin County,MA,New Salem,2004,3,17,543,560
4929,New Salem,Franklin County,MA,New Salem,2005,5.1,29,538,567
4930,New Salem,Franklin County,MA,New Salem,2006,4.2,23,531,554
4931,New Salem,Franklin County,MA,New Salem,2007,4,22,534,556
4932,New Salem,Franklin County,MA,New Salem,2008,4.9,28,539,567
4933,New Salem,Franklin County,MA,New Salem,2009,7.9,43,498,541
4934,New Salem,Franklin County,MA,New Salem,2010,7.3,40,511,551
4935,New Salem,Franklin County,MA,New Salem,2011,6.6,36,511,547
4936,New Salem,Franklin County,MA,New Salem,2012,6.1,33,512,545
4937,Newbury,Essex County,MA,Newbury,1990,4.9,152,2966,3118
4938,Newbury,Essex County,MA,Newbury,1991,6.7,212,2930,3142
4939,Newbury,Essex County,MA,Newbury,1992,6.4,208,3025,3233
4940,Newbury,Essex County,MA,Newbury,1993,5.7,191,3141,3332
4941,Newbury,Essex County,MA,Newbury,1994,5,172,3283,3455
4942,Newbury,Essex County,MA,Newbury,1995,4.1,133,3074,3207
4943,Newbury,Essex County,MA,Newbury,1996,3.2,105,3159,3264
4944,Newbury,Essex County,MA,Newbury,1997,3.1,105,3272,3377
4945,Newbury,Essex County,MA,Newbury,1998,2.9,102,3357,3459
4946,Newbury,Essex County,MA,Newbury,1999,2.7,93,3405,3498
4947,Newbury,Essex County,MA,Newbury,2000,2.2,83,3673,3756
4948,Newbury,Essex County,MA,Newbury,2001,3.1,118,3699,3817
4949,Newbury,Essex County,MA,Newbury,2002,4.3,166,3663,3829
4950,Newbury,Essex County,MA,Newbury,2003,5,191,3611,3802
4951,Newbury,Essex County,MA,Newbury,2004,4.6,176,3611,3787
4952,Newbury,Essex County,MA,Newbury,2005,4,156,3714,3870
4953,Newbury,Essex County,MA,Newbury,2006,4,147,3548,3695
4954,Newbury,Essex County,MA,Newbury,2007,3.6,134,3580,3714
4955,Newbury,Essex County,MA,Newbury,2008,4.8,180,3594,3774
4956,Newbury,Essex County,MA,Newbury,2009,6.9,259,3498,3757
4957,Newbury,Essex County,MA,Newbury,2010,7.3,269,3425,3694
4958,Newbury,Essex County,MA,Newbury,2011,6.5,243,3467,3710
4959,Newbury,Essex County,MA,Newbury,2012,6.1,227,3505,3732
4960,Newburyport,Essex County,MA,Newburyport,1990,6.1,577,8914,9491
4961,Newburyport,Essex County,MA,Newburyport,1991,7.5,694,8613,9307
4962,Newburyport,Essex County,MA,Newburyport,1992,7.4,693,8617,9310
4963,Newburyport,Essex County,MA,Newburyport,1993,6.2,577,8735,9312
4964,Newburyport,Essex County,MA,Newburyport,1994,5.1,483,8962,9445
4965,Newburyport,Essex County,MA,Newburyport,1995,4.6,425,8852,9277
4966,Newburyport,Essex County,MA,Newburyport,1996,3.7,346,9044,9390
4967,Newburyport,Essex County,MA,Newburyport,1997,3.1,300,9325,9625
4968,Newburyport,Essex County,MA,Newburyport,1998,2.5,245,9501,9746
4969,Newburyport,Essex County,MA,Newburyport,1999,2.6,257,9613,9870
4970,Newburyport,Essex County,MA,Newburyport,2000,2.2,220,9663,9883
4971,Newburyport,Essex County,MA,Newburyport,2001,3.3,334,9696,10030
4972,Newburyport,Essex County,MA,Newburyport,2002,5,511,9632,10143
4973,Newburyport,Essex County,MA,Newburyport,2003,5.5,548,9485,10033
4974,Newburyport,Essex County,MA,Newburyport,2004,4.4,440,9472,9912
4975,Newburyport,Essex County,MA,Newburyport,2005,4,393,9504,9897
4976,Newburyport,Essex County,MA,Newburyport,2006,4,386,9371,9757
4977,Newburyport,Essex County,MA,Newburyport,2007,3.5,344,9418,9762
4978,Newburyport,Essex County,MA,Newburyport,2008,4.2,412,9450,9862
4979,Newburyport,Essex County,MA,Newburyport,2009,6.7,655,9162,9817
4980,Newburyport,Essex County,MA,Newburyport,2010,7,695,9206,9901
4981,Newburyport,Essex County,MA,Newburyport,2011,5.9,579,9318,9897
4982,Newburyport,Essex County,MA,Newburyport,2012,5.2,520,9421,9941
4983,Newton,Middlesex County,MA,Newton,1990,3.5,1659,46233,47892
4984,Newton,Middlesex County,MA,Newton,1991,4.7,2203,45051,47254
4985,Newton,Middlesex County,MA,Newton,1992,5,2386,45104,47490
4986,Newton,Middlesex County,MA,Newton,1993,3.9,1853,45766,47619
4987,Newton,Middlesex County,MA,Newton,1994,3.3,1596,46858,48454
4988,Newton,Middlesex County,MA,Newton,1995,3.3,1501,44470,45971
4989,Newton,Middlesex County,MA,Newton,1996,2.3,1062,45204,46266
4990,Newton,Middlesex County,MA,Newton,1997,2.3,1096,46301,47397
4991,Newton,Middlesex County,MA,Newton,1998,1.7,824,46812,47636
4992,Newton,Middlesex County,MA,Newton,1999,1.7,813,47091,47904
4993,Newton,Middlesex County,MA,Newton,2000,1.8,857,46486,47343
4994,Newton,Middlesex County,MA,Newton,2001,2.7,1290,46216,47506
4995,Newton,Middlesex County,MA,Newton,2002,3.9,1859,45283,47142
4996,Newton,Middlesex County,MA,Newton,2003,4.1,1912,44923,46835
4997,Newton,Middlesex County,MA,Newton,2004,3.5,1621,44738,46359
4998,Newton,Middlesex County,MA,Newton,2005,3.4,1559,44861,46420
4999,Newton,Middlesex County,MA,Newton,2006,3.3,1497,44221,45718
5000,Newton,Middlesex County,MA,Newton,2007,3,1366,44712,46078
5001,Newton,Middlesex County,MA,Newton,2008,3.6,1653,44751,46404
5002,Newton,Middlesex County,MA,Newton,2009,5.6,2563,43547,46110
5003,Newton,Middlesex County,MA,Newton,2010,5.5,2593,44490,47083
5004,Newton,Middlesex County,MA,Newton,2011,4.6,2199,45100,47299
5005,Newton,Middlesex County,MA,Newton,2012,4.2,2023,45594,47617
5006,Norfolk,Norfolk County,MA,Norfolk,1990,5.3,224,3977,4201
5007,Norfolk,Norfolk County,MA,Norfolk,1991,6.6,283,3994,4277
5008,Norfolk,Norfolk County,MA,Norfolk,1992,7.3,320,4061,4381
5009,Norfolk,Norfolk County,MA,Norfolk,1993,5,220,4200,4420
5010,Norfolk,Norfolk County,MA,Norfolk,1994,4.8,221,4348,4569
5011,Norfolk,Norfolk County,MA,Norfolk,1995,4.3,194,4348,4542
5012,Norfolk,Norfolk County,MA,Norfolk,1996,3.3,150,4452,4602
5013,Norfolk,Norfolk County,MA,Norfolk,1997,3.1,145,4589,4734
5014,Norfolk,Norfolk County,MA,Norfolk,1998,2.4,118,4777,4895
5015,Norfolk,Norfolk County,MA,Norfolk,1999,2.3,115,4835,4950
5016,Norfolk,Norfolk County,MA,Norfolk,2000,2.6,121,4584,4705
5017,Norfolk,Norfolk County,MA,Norfolk,2001,3,141,4535,4676
5018,Norfolk,Norfolk County,MA,Norfolk,2002,5,232,4441,4673
5019,Norfolk,Norfolk County,MA,Norfolk,2003,5.2,243,4402,4645
5020,Norfolk,Norfolk County,MA,Norfolk,2004,5.1,239,4419,4658
5021,Norfolk,Norfolk County,MA,Norfolk,2005,4.2,198,4464,4662
5022,Norfolk,Norfolk County,MA,Norfolk,2006,4.4,210,4570,4780
5023,Norfolk,Norfolk County,MA,Norfolk,2007,4,195,4642,4837
5024,Norfolk,Norfolk County,MA,Norfolk,2008,4.8,235,4697,4932
5025,Norfolk,Norfolk County,MA,Norfolk,2009,7.7,379,4541,4920
5026,Norfolk,Norfolk County,MA,Norfolk,2010,7.7,385,4627,5012
5027,Norfolk,Norfolk County,MA,Norfolk,2011,6.5,324,4674,4998
5028,Norfolk,Norfolk County,MA,Norfolk,2012,5.8,289,4725,5014
5052,North Adams,Berkshire County,MA,North Adams,1990,11.7,978,7356,8334
5053,North Adams,Berkshire County,MA,North Adams,1991,14.8,1223,7044,8267
5054,North Adams,Berkshire County,MA,North Adams,1992,13.9,1088,6766,7854
5055,North Adams,Berkshire County,MA,North Adams,1993,9.9,775,7033,7808
5056,North Adams,Berkshire County,MA,North Adams,1994,8.5,656,7046,7702
5057,North Adams,Berkshire County,MA,North Adams,1995,7.3,546,6938,7484
5058,North Adams,Berkshire County,MA,North Adams,1996,6.4,477,7021,7498
5059,North Adams,Berkshire County,MA,North Adams,1997,5.6,419,7054,7473
5060,North Adams,Berkshire County,MA,North Adams,1998,4.4,327,7154,7481
5061,North Adams,Berkshire County,MA,North Adams,1999,4.1,306,7183,7489
5062,North Adams,Berkshire County,MA,North Adams,2000,3.5,249,6955,7204
5063,North Adams,Berkshire County,MA,North Adams,2001,4.3,314,6968,7282
5064,North Adams,Berkshire County,MA,North Adams,2002,5.8,428,6916,7344
5065,North Adams,Berkshire County,MA,North Adams,2003,6.4,464,6806,7270
5066,North Adams,Berkshire County,MA,North Adams,2004,6.1,441,6733,7174
5067,North Adams,Berkshire County,MA,North Adams,2005,5.5,391,6715,7106
5068,North Adams,Berkshire County,MA,North Adams,2006,5.6,401,6733,7134
5069,North Adams,Berkshire County,MA,North Adams,2007,5.9,424,6717,7141
5070,North Adams,Berkshire County,MA,North Adams,2008,6.7,485,6771,7256
5071,North Adams,Berkshire County,MA,North Adams,2009,9.3,688,6680,7368
5072,North Adams,Berkshire County,MA,North Adams,2010,10.2,742,6513,7255
5073,North Adams,Berkshire County,MA,North Adams,2011,9.4,678,6505,7183
5074,North Adams,Berkshire County,MA,North Adams,2012,8.2,570,6419,6989
5075,North Andover,Essex County,MA,North Andover,1990,4.9,583,11283,11866
5076,North Andover,Essex County,MA,North Andover,1991,7,847,11259,12106
5077,North Andover,Essex County,MA,North Andover,1992,7.2,896,11511,12407
5078,North Andover,Essex County,MA,North Andover,1993,6,751,11822,12573
5079,North Andover,Essex County,MA,North Andover,1994,5.3,682,12181,12863
5080,North Andover,Essex County,MA,North Andover,1995,4.7,588,11941,12529
5081,North Andover,Essex County,MA,North Andover,1996,3.9,504,12540,13044
5082,North Andover,Essex County,MA,North Andover,1997,3.9,521,12818,13339
5083,North Andover,Essex County,MA,North Andover,1998,2.8,406,14194,14600
5084,North Andover,Essex County,MA,North Andover,1999,2.9,432,14520,14952
5085,North Andover,Essex County,MA,North Andover,2000,2.3,309,13397,13706
5086,North Andover,Essex County,MA,North Andover,2001,3.3,461,13354,13815
5087,North Andover,Essex County,MA,North Andover,2002,5.1,700,13024,13724
5088,North Andover,Essex County,MA,North Andover,2003,5.3,707,12735,13442
5089,North Andover,Essex County,MA,North Andover,2004,4.5,592,12625,13217
5090,North Andover,Essex County,MA,North Andover,2005,4.2,562,12682,13244
5091,North Andover,Essex County,MA,North Andover,2006,4.1,547,12818,13365
5092,North Andover,Essex County,MA,North Andover,2007,3.9,523,13045,13568
5093,North Andover,Essex County,MA,North Andover,2008,4.6,622,12800,13422
5094,North Andover,Essex County,MA,North Andover,2009,7.6,1033,12485,13518
5095,North Andover,Essex County,MA,North Andover,2010,7.2,1016,13071,14087
5096,North Andover,Essex County,MA,North Andover,2011,5.9,832,13237,14069
5097,North Andover,Essex County,MA,North Andover,2012,5.7,808,13411,14219
5098,North Attleborough,Bristol County,MA,North Attleborough,1990,5.9,863,13870,14733
5099,North Attleborough,Bristol County,MA,North Attleborough,1991,9.1,1340,13385,14725
5100,North Attleborough,Bristol County,MA,North Attleborough,1992,9.3,1401,13619,15020
5101,North Attleborough,Bristol County,MA,North Attleborough,1993,6.6,1000,14120,15120
5102,North Attleborough,Bristol County,MA,North Attleborough,1994,5.7,884,14504,15388
5103,North Attleborough,Bristol County,MA,North Attleborough,1995,5.4,811,14097,14908
5104,North Attleborough,Bristol County,MA,North Attleborough,1996,4.5,678,14244,14922
5105,North Attleborough,Bristol County,MA,North Attleborough,1997,4.4,667,14587,15254
5106,North Attleborough,Bristol County,MA,North Attleborough,1998,3.2,486,14762,15248
5107,North Attleborough,Bristol County,MA,North Attleborough,1999,2.9,451,14948,15399
5108,North Attleborough,Bristol County,MA,North Attleborough,2000,2.9,458,15419,15877
5109,North Attleborough,Bristol County,MA,North Attleborough,2001,3.9,625,15358,15983
5110,North Attleborough,Bristol County,MA,North Attleborough,2002,5.1,837,15579,16416
5111,North Attleborough,Bristol County,MA,North Attleborough,2003,5.2,859,15765,16624
5112,North Attleborough,Bristol County,MA,North Attleborough,2004,4.8,802,15840,16642
5113,North Attleborough,Bristol County,MA,North Attleborough,2005,4.3,722,15927,16649
5114,North Attleborough,Bristol County,MA,North Attleborough,2006,4.3,720,15986,16706
5115,North Attleborough,Bristol County,MA,North Attleborough,2007,4.2,706,16005,16711
5116,North Attleborough,Bristol County,MA,North Attleborough,2008,5.7,956,15702,16658
5117,North Attleborough,Bristol County,MA,North Attleborough,2009,9.8,1635,14984,16619
5118,North Attleborough,Bristol County,MA,North Attleborough,2010,9.2,1555,15415,16970
5119,North Attleborough,Bristol County,MA,North Attleborough,2011,8.4,1426,15527,16953
5120,North Attleborough,Bristol County,MA,North Attleborough,2012,7.7,1292,15552,16844
5121,North Brookfield,Worcester County,MA,North Brookfield,1990,6.2,156,2345,2501
5122,North Brookfield,Worcester County,MA,North Brookfield,1991,8.7,220,2313,2533
5123,North Brookfield,Worcester County,MA,North Brookfield,1992,9,228,2305,2533
5124,North Brookfield,Worcester County,MA,North Brookfield,1993,6.8,173,2362,2535
5125,North Brookfield,Worcester County,MA,North Brookfield,1994,4.5,111,2372,2483
5126,North Brookfield,Worcester County,MA,North Brookfield,1995,4.1,101,2372,2473
5127,North Brookfield,Worcester County,MA,North Brookfield,1996,3.8,96,2405,2501
5128,North Brookfield,Worcester County,MA,North Brookfield,1997,3.2,82,2459,2541
5129,North Brookfield,Worcester County,MA,North Brookfield,1998,2.9,75,2504,2579
5130,North Brookfield,Worcester County,MA,North Brookfield,1999,3,77,2492,2569
5131,North Brookfield,Worcester County,MA,North Brookfield,2000,2.6,64,2396,2460
5132,North Brookfield,Worcester County,MA,North Brookfield,2001,3.5,88,2402,2490
5133,North Brookfield,Worcester County,MA,North Brookfield,2002,4.4,111,2390,2501
5134,North Brookfield,Worcester County,MA,North Brookfield,2003,5.4,136,2384,2520
5135,North Brookfield,Worcester County,MA,North Brookfield,2004,5.7,144,2375,2519
5136,North Brookfield,Worcester County,MA,North Brookfield,2005,4.7,118,2367,2485
5137,North Brookfield,Worcester County,MA,North Brookfield,2006,5.1,134,2477,2611
5138,North Brookfield,Worcester County,MA,North Brookfield,2007,4.7,124,2490,2614
5139,North Brookfield,Worcester County,MA,North Brookfield,2008,6.1,158,2439,2597
5140,North Brookfield,Worcester County,MA,North Brookfield,2009,8.7,225,2373,2598
5141,North Brookfield,Worcester County,MA,North Brookfield,2010,8.7,211,2203,2414
5142,North Brookfield,Worcester County,MA,North Brookfield,2011,7.8,188,2222,2410
5143,North Brookfield,Worcester County,MA,North Brookfield,2012,7.5,180,2221,2401
5144,North Reading,Middlesex County,MA,North Reading,1990,5.7,403,6607,7010
5145,North Reading,Middlesex County,MA,North Reading,1991,7.6,527,6443,6970
5146,North Reading,Middlesex County,MA,North Reading,1992,7.8,546,6478,7024
5147,North Reading,Middlesex County,MA,North Reading,1993,5.8,410,6694,7104
5148,North Reading,Middlesex County,MA,North Reading,1994,4.9,360,6918,7278
5149,North Reading,Middlesex County,MA,North Reading,1995,4.5,327,6900,7227
5150,North Reading,Middlesex County,MA,North Reading,1996,3.4,248,7138,7386
5151,North Reading,Middlesex County,MA,North Reading,1997,2.8,212,7389,7601
5152,North Reading,Middlesex County,MA,North Reading,1998,2.5,193,7537,7730
5153,North Reading,Middlesex County,MA,North Reading,1999,2.5,198,7679,7877
5154,North Reading,Middlesex County,MA,North Reading,2000,2.1,169,7723,7892
5155,North Reading,Middlesex County,MA,North Reading,2001,3,236,7727,7963
5156,North Reading,Middlesex County,MA,North Reading,2002,4.5,358,7593,7951
5157,North Reading,Middlesex County,MA,North Reading,2003,5,397,7499,7896
5158,North Reading,Middlesex County,MA,North Reading,2004,4.3,337,7501,7838
5159,North Reading,Middlesex County,MA,North Reading,2005,3.9,309,7563,7872
5160,North Reading,Middlesex County,MA,North Reading,2006,4.2,292,6720,7012
5161,North Reading,Middlesex County,MA,North Reading,2007,3.8,260,6630,6890
5162,North Reading,Middlesex County,MA,North Reading,2008,4.5,365,7758,8123
5163,North Reading,Middlesex County,MA,North Reading,2009,7.3,587,7491,8078
5164,North Reading,Middlesex County,MA,North Reading,2010,7.1,596,7821,8417
5165,North Reading,Middlesex County,MA,North Reading,2011,5.9,502,7937,8439
5166,North Reading,Middlesex County,MA,North Reading,2012,5.5,467,8025,8492
5167,Northampton,Hampshire County,MA,Northampton,1990,5,825,15580,16405
5168,Northampton,Hampshire County,MA,Northampton,1991,6.9,1113,15025,16138
5169,Northampton,Hampshire County,MA,Northampton,1992,7.1,1142,14848,15990
5170,Northampton,Hampshire County,MA,Northampton,1993,5.4,842,14834,15676
5171,Northampton,Hampshire County,MA,Northampton,1994,4.7,739,14904,15643
5172,Northampton,Hampshire County,MA,Northampton,1995,3.9,602,14964,15566
5173,Northampton,Hampshire County,MA,Northampton,1996,3.3,523,15167,15690
5174,Northampton,Hampshire County,MA,Northampton,1997,2.7,423,15532,15955
5175,Northampton,Hampshire County,MA,Northampton,1998,2.6,407,15421,15828
5176,Northampton,Hampshire County,MA,Northampton,1999,2.3,372,15480,15852
5177,Northampton,Hampshire County,MA,Northampton,2000,2.1,353,16734,17087
5178,Northampton,Hampshire County,MA,Northampton,2001,2.5,427,16663,17090
5179,Northampton,Hampshire County,MA,Northampton,2002,3.2,557,16613,17170
5180,Northampton,Hampshire County,MA,Northampton,2003,3.9,666,16442,17108
5181,Northampton,Hampshire County,MA,Northampton,2004,3.8,650,16356,17006
5182,Northampton,Hampshire County,MA,Northampton,2005,3.6,603,16322,16925
5183,Northampton,Hampshire County,MA,Northampton,2006,3.7,625,16363,16988
5184,Northampton,Hampshire County,MA,Northampton,2007,3.5,594,16305,16899
5185,Northampton,Hampshire County,MA,Northampton,2008,4,668,16141,16809
5186,Northampton,Hampshire County,MA,Northampton,2009,5.9,967,15486,16453
5187,Northampton,Hampshire County,MA,Northampton,2010,5.8,957,15537,16494
5188,Northampton,Hampshire County,MA,Northampton,2011,5.3,866,15346,16212
5189,Northampton,Hampshire County,MA,Northampton,2012,5,814,15356,16170
5190,Northborough,Worcester County,MA,Northborough,1990,4.7,323,6615,6938
5191,Northborough,Worcester County,MA,Northborough,1991,7.1,489,6432,6921
5192,Northborough,Worcester County,MA,Northborough,1992,6.7,473,6542,7015
5193,Northborough,Worcester County,MA,Northborough,1993,5.7,410,6831,7241
5194,Northborough,Worcester County,MA,Northborough,1994,4.7,348,7064,7412
5195,Northborough,Worcester County,MA,Northborough,1995,4,287,6946,7233
5196,Northborough,Worcester County,MA,Northborough,1996,3.1,226,7169,7395
5197,Northborough,Worcester County,MA,Northborough,1997,2.9,224,7448,7672
5198,Northborough,Worcester County,MA,Northborough,1998,2.3,179,7651,7830
5199,Northborough,Worcester County,MA,Northborough,1999,2.6,208,7747,7955
5200,Northborough,Worcester County,MA,Northborough,2000,2,161,7732,7893
5201,Northborough,Worcester County,MA,Northborough,2001,3.1,249,7728,7977
5202,Northborough,Worcester County,MA,Northborough,2002,4.9,394,7668,8062
5203,Northborough,Worcester County,MA,Northborough,2003,5,401,7618,8019
5204,Northborough,Worcester County,MA,Northborough,2004,4.3,340,7622,7962
5205,Northborough,Worcester County,MA,Northborough,2005,3.6,290,7787,8077
5206,Northborough,Worcester County,MA,Northborough,2006,3.5,283,7784,8067
5207,Northborough,Worcester County,MA,Northborough,2007,3.6,291,7813,8104
5208,Northborough,Worcester County,MA,Northborough,2008,4.1,330,7691,8021
5209,Northborough,Worcester County,MA,Northborough,2009,7.1,575,7525,8100
5210,Northborough,Worcester County,MA,Northborough,2010,6.8,525,7189,7714
5211,Northborough,Worcester County,MA,Northborough,2011,6.2,479,7253,7732
5212,Northborough,Worcester County,MA,Northborough,2012,5.6,431,7250,7681
5213,Northbridge,Worcester County,MA,Northbridge,1990,7.2,496,6360,6856
5214,Northbridge,Worcester County,MA,Northbridge,1991,10.3,689,6018,6707
5215,Northbridge,Worcester County,MA,Northbridge,1992,9.4,620,5954,6574
5216,Northbridge,Worcester County,MA,Northbridge,1993,8.1,543,6122,6665
5217,Northbridge,Worcester County,MA,Northbridge,1994,5.5,367,6266,6633
5218,Northbridge,Worcester County,MA,Northbridge,1995,5.2,355,6416,6771
5219,Northbridge,Worcester County,MA,Northbridge,1996,4.8,330,6568,6898
5220,Northbridge,Worcester County,MA,Northbridge,1997,4.1,292,6788,7080
5221,Northbridge,Worcester County,MA,Northbridge,1998,3.6,260,7022,7282
5222,Northbridge,Worcester County,MA,Northbridge,1999,3.1,228,7041,7269
5223,Northbridge,Worcester County,MA,Northbridge,2000,2.8,191,6669,6860
5224,Northbridge,Worcester County,MA,Northbridge,2001,3.9,272,6679,6951
5225,Northbridge,Worcester County,MA,Northbridge,2002,6.4,453,6680,7133
5226,Northbridge,Worcester County,MA,Northbridge,2003,6.7,484,6710,7194
5227,Northbridge,Worcester County,MA,Northbridge,2004,6,429,6772,7201
5228,Northbridge,Worcester County,MA,Northbridge,2005,5.1,373,6913,7286
5229,Northbridge,Worcester County,MA,Northbridge,2006,5,376,7088,7464
5230,Northbridge,Worcester County,MA,Northbridge,2007,5.5,418,7126,7544
5231,Northbridge,Worcester County,MA,Northbridge,2008,6.4,481,7009,7490
5232,Northbridge,Worcester County,MA,Northbridge,2009,9.3,704,6828,7532
5233,Northbridge,Worcester County,MA,Northbridge,2010,9.1,731,7312,8043
5234,Northbridge,Worcester County,MA,Northbridge,2011,8.1,650,7377,8027
5235,Northbridge,Worcester County,MA,Northbridge,2012,7.8,626,7374,8000
5236,Northfield,Franklin County,MA,Northfield,1990,5.5,87,1497,1584
5237,Northfield,Franklin County,MA,Northfield,1991,5.8,95,1531,1626
5238,Northfield,Franklin County,MA,Northfield,1992,6.5,104,1501,1605
5239,Northfield,Franklin County,MA,Northfield,1993,3.9,62,1529,1591
5240,Northfield,Franklin County,MA,Northfield,1994,3.4,57,1631,1688
5241,Northfield,Franklin County,MA,Northfield,1995,3.3,52,1533,1585
5242,Northfield,Franklin County,MA,Northfield,1996,3.4,54,1553,1607
5243,Northfield,Franklin County,MA,Northfield,1997,2.9,48,1600,1648
5244,Northfield,Franklin County,MA,Northfield,1998,2.7,46,1645,1691
5245,Northfield,Franklin County,MA,Northfield,1999,2.1,36,1690,1726
5246,Northfield,Franklin County,MA,Northfield,2000,2.1,36,1687,1723
5247,Northfield,Franklin County,MA,Northfield,2001,2.5,43,1704,1747
5248,Northfield,Franklin County,MA,Northfield,2002,3.3,59,1754,1813
5249,Northfield,Franklin County,MA,Northfield,2003,4.2,78,1786,1864
5250,Northfield,Franklin County,MA,Northfield,2004,3.7,69,1787,1856
5251,Northfield,Franklin County,MA,Northfield,2005,3.7,69,1816,1885
5252,Northfield,Franklin County,MA,Northfield,2006,3.5,68,1853,1921
5253,Northfield,Franklin County,MA,Northfield,2007,3.4,59,1677,1736
5254,Northfield,Franklin County,MA,Northfield,2008,4.3,75,1673,1748
5255,Northfield,Franklin County,MA,Northfield,2009,6.5,113,1629,1742
5256,Northfield,Franklin County,MA,Northfield,2010,6.6,117,1659,1776
5257,Northfield,Franklin County,MA,Northfield,2011,5.2,92,1661,1753
5258,Northfield,Franklin County,MA,Northfield,2012,4.4,76,1666,1742
5259,Norton,Bristol County,MA,Norton,1990,7.1,588,7742,8330
5260,Norton,Bristol County,MA,Norton,1991,8.3,697,7741,8438
5261,Norton,Bristol County,MA,Norton,1992,8.1,699,7878,8577
5262,Norton,Bristol County,MA,Norton,1993,6.2,536,8068,8604
5263,Norton,Bristol County,MA,Norton,1994,5.8,511,8356,8867
5264,Norton,Bristol County,MA,Norton,1995,4.8,415,8276,8691
5265,Norton,Bristol County,MA,Norton,1996,4.5,398,8512,8910
5266,Norton,Bristol County,MA,Norton,1997,4,365,8814,9179
5267,Norton,Bristol County,MA,Norton,1998,3,278,9024,9302
5268,Norton,Bristol County,MA,Norton,1999,3,289,9225,9514
5269,Norton,Bristol County,MA,Norton,2000,2.5,244,9412,9656
5270,Norton,Bristol County,MA,Norton,2001,3.4,336,9468,9804
5271,Norton,Bristol County,MA,Norton,2002,5,501,9516,10017
5272,Norton,Bristol County,MA,Norton,2003,5.3,541,9665,10206
5273,Norton,Bristol County,MA,Norton,2004,5.1,516,9679,10195
5274,Norton,Bristol County,MA,Norton,2005,5,521,9858,10379
5275,Norton,Bristol County,MA,Norton,2006,5,529,10018,10547
5276,Norton,Bristol County,MA,Norton,2007,4.8,504,10095,10599
5277,Norton,Bristol County,MA,Norton,2008,5.7,604,10062,10666
5278,Norton,Bristol County,MA,Norton,2009,8.6,915,9742,10657
5279,Norton,Bristol County,MA,Norton,2010,8.9,938,9562,10500
5280,Norton,Bristol County,MA,Norton,2011,7.3,763,9660,10423
5281,Norton,Bristol County,MA,Norton,2012,7,725,9631,10356
5282,Norwell,Plymouth County,MA,Norwell,1990,5,260,4918,5178
5283,Norwell,Plymouth County,MA,Norwell,1991,6.3,323,4782,5105
5284,Norwell,Plymouth County,MA,Norwell,1992,6.7,347,4835,5182
5285,Norwell,Plymouth County,MA,Norwell,1993,4.6,236,4905,5141
5286,Norwell,Plymouth County,MA,Norwell,1994,3.7,191,4978,5169
5287,Norwell,Plymouth County,MA,Norwell,1995,3.8,197,5010,5207
5288,Norwell,Plymouth County,MA,Norwell,1996,3.2,168,5141,5309
5289,Norwell,Plymouth County,MA,Norwell,1997,2.5,135,5326,5461
5290,Norwell,Plymouth County,MA,Norwell,1998,2.1,119,5493,5612
5291,Norwell,Plymouth County,MA,Norwell,1999,1.9,111,5606,5717
5292,Norwell,Plymouth County,MA,Norwell,2000,1.8,95,5054,5149
5293,Norwell,Plymouth County,MA,Norwell,2001,2.7,141,5129,5270
5294,Norwell,Plymouth County,MA,Norwell,2002,3.7,197,5107,5304
5295,Norwell,Plymouth County,MA,Norwell,2003,4.2,223,5102,5325
5296,Norwell,Plymouth County,MA,Norwell,2004,3.7,196,5150,5346
5297,Norwell,Plymouth County,MA,Norwell,2005,3.7,201,5208,5409
5298,Norwell,Plymouth County,MA,Norwell,2006,3.7,197,5080,5277
5299,Norwell,Plymouth County,MA,Norwell,2007,3.7,194,5111,5305
5300,Norwell,Plymouth County,MA,Norwell,2008,4.3,232,5106,5338
5301,Norwell,Plymouth County,MA,Norwell,2009,6.7,356,4941,5297
5302,Norwell,Plymouth County,MA,Norwell,2010,6,324,5097,5421
5303,Norwell,Plymouth County,MA,Norwell,2011,5.8,316,5146,5462
5304,Norwell,Plymouth County,MA,Norwell,2012,4.4,242,5202,5444
5305,Norwood,Norfolk County,MA,Norwood,1990,5.9,971,15464,16435
5306,Norwood,Norfolk County,MA,Norwood,1991,7.8,1283,15104,16387
5307,Norwood,Norfolk County,MA,Norwood,1992,8,1294,14888,16182
5308,Norwood,Norfolk County,MA,Norwood,1993,6.3,1002,14971,15973
5309,Norwood,Norfolk County,MA,Norwood,1994,5.4,869,15152,16021
5310,Norwood,Norfolk County,MA,Norwood,1995,4.8,784,15448,16232
5311,Norwood,Norfolk County,MA,Norwood,1996,3.5,565,15708,16273
5312,Norwood,Norfolk County,MA,Norwood,1997,3.3,548,16046,16594
5313,Norwood,Norfolk County,MA,Norwood,1998,2.6,431,16221,16652
5314,Norwood,Norfolk County,MA,Norwood,1999,2.6,431,16290,16721
5315,Norwood,Norfolk County,MA,Norwood,2000,2.3,372,15583,15955
5316,Norwood,Norfolk County,MA,Norwood,2001,3,481,15520,16001
5317,Norwood,Norfolk County,MA,Norwood,2002,4.7,759,15334,16093
5318,Norwood,Norfolk County,MA,Norwood,2003,5,790,15067,15857
5319,Norwood,Norfolk County,MA,Norwood,2004,4.6,720,14989,15709
5320,Norwood,Norfolk County,MA,Norwood,2005,4.2,655,15105,15760
5321,Norwood,Norfolk County,MA,Norwood,2006,4.1,627,14840,15467
5322,Norwood,Norfolk County,MA,Norwood,2007,3.9,609,14956,15565
5323,Norwood,Norfolk County,MA,Norwood,2008,4.8,746,14927,15673
5324,Norwood,Norfolk County,MA,Norwood,2009,7.3,1126,14396,15522
5325,Norwood,Norfolk County,MA,Norwood,2010,7.2,1135,14695,15830
5326,Norwood,Norfolk County,MA,Norwood,2011,6.2,978,14861,15839
5327,Norwood,Norfolk County,MA,Norwood,2012,5.6,893,15024,15917
5328,Oak Bluffs,Dukes County,MA,Oak Bluffs,1990,4.7,83,1674,1757
5329,Oak Bluffs,Dukes County,MA,Oak Bluffs,1991,6.1,111,1695,1806
5330,Oak Bluffs,Dukes County,MA,Oak Bluffs,1992,6.8,121,1646,1767
5331,Oak Bluffs,Dukes County,MA,Oak Bluffs,1993,7.1,129,1680,1809
5332,Oak Bluffs,Dukes County,MA,Oak Bluffs,1994,5.5,105,1821,1926
5333,Oak Bluffs,Dukes County,MA,Oak Bluffs,1995,5.1,102,1886,1988
5334,Oak Bluffs,Dukes County,MA,Oak Bluffs,1996,4.5,93,1965,2058
5335,Oak Bluffs,Dukes County,MA,Oak Bluffs,1997,4.7,100,2014,2114
5336,Oak Bluffs,Dukes County,MA,Oak Bluffs,1998,3.5,74,2041,2115
5337,Oak Bluffs,Dukes County,MA,Oak Bluffs,1999,3.1,66,2070,2136
5338,Oak Bluffs,Dukes County,MA,Oak Bluffs,2000,2.5,60,2336,2396
5339,Oak Bluffs,Dukes County,MA,Oak Bluffs,2001,2.5,61,2347,2408
5340,Oak Bluffs,Dukes County,MA,Oak Bluffs,2002,3.2,81,2430,2511
5341,Oak Bluffs,Dukes County,MA,Oak Bluffs,2003,4.3,113,2507,2620
5342,Oak Bluffs,Dukes County,MA,Oak Bluffs,2004,4.2,109,2512,2621
5343,Oak Bluffs,Dukes County,MA,Oak Bluffs,2005,3.7,95,2464,2559
5344,Oak Bluffs,Dukes County,MA,Oak Bluffs,2006,3.9,100,2481,2581
5345,Oak Bluffs,Dukes County,MA,Oak Bluffs,2007,3.5,90,2493,2583
5346,Oak Bluffs,Dukes County,MA,Oak Bluffs,2008,4.2,108,2490,2598
5347,Oak Bluffs,Dukes County,MA,Oak Bluffs,2009,6.8,184,2535,2719
5348,Oak Bluffs,Dukes County,MA,Oak Bluffs,2010,6.9,210,2814,3024
5349,Oak Bluffs,Dukes County,MA,Oak Bluffs,2011,7.2,221,2835,3056
5350,Oak Bluffs,Dukes County,MA,Oak Bluffs,2012,6.7,205,2863,3068
5351,Oakham,Worcester County,MA,Oakham,1990,6,46,727,773
5352,Oakham,Worcester County,MA,Oakham,1991,11.4,95,735,830
5353,Oakham,Worcester County,MA,Oakham,1992,8.7,70,737,807
5354,Oakham,Worcester County,MA,Oakham,1993,8,68,777,845
5355,Oakham,Worcester County,MA,Oakham,1994,5.7,48,787,835
5356,Oakham,Worcester County,MA,Oakham,1995,5.2,43,781,824
5357,Oakham,Worcester County,MA,Oakham,1996,4.8,40,798,838
5358,Oakham,Worcester County,MA,Oakham,1997,4.2,36,822,858
5359,Oakham,Worcester County,MA,Oakham,1998,4.2,37,845,882
5360,Oakham,Worcester County,MA,Oakham,1999,3.4,30,848,878
5361,Oakham,Worcester County,MA,Oakham,2000,2.4,23,923,946
5362,Oakham,Worcester County,MA,Oakham,2001,3.5,34,937,971
5363,Oakham,Worcester County,MA,Oakham,2002,4.7,47,948,995
5364,Oakham,Worcester County,MA,Oakham,2003,6.2,64,972,1036
5365,Oakham,Worcester County,MA,Oakham,2004,6.5,69,997,1066
5366,Oakham,Worcester County,MA,Oakham,2005,5.2,55,1004,1059
5367,Oakham,Worcester County,MA,Oakham,2006,4.9,52,1016,1068
5368,Oakham,Worcester County,MA,Oakham,2007,4.6,49,1022,1071
5369,Oakham,Worcester County,MA,Oakham,2008,5.1,54,1008,1062
5370,Oakham,Worcester County,MA,Oakham,2009,8.7,94,982,1076
5371,Oakham,Worcester County,MA,Oakham,2010,9.5,101,964,1065
5372,Oakham,Worcester County,MA,Oakham,2011,7.5,79,972,1051
5373,Oakham,Worcester County,MA,Oakham,2012,6.6,69,972,1041
5374,Orange,Franklin County,MA,Orange,1990,9.3,332,3223,3555
5375,Orange,Franklin County,MA,Orange,1991,13.6,478,3042,3520
5376,Orange,Franklin County,MA,Orange,1992,12.7,449,3088,3537
5377,Orange,Franklin County,MA,Orange,1993,10.1,351,3124,3475
5378,Orange,Franklin County,MA,Orange,1994,8.1,273,3110,3383
5379,Orange,Franklin County,MA,Orange,1995,6.9,228,3069,3297
5380,Orange,Franklin County,MA,Orange,1996,6,194,3052,3246
5381,Orange,Franklin County,MA,Orange,1997,6.5,213,3088,3301
5382,Orange,Franklin County,MA,Orange,1998,5.3,173,3110,3283
5383,Orange,Franklin County,MA,Orange,1999,4.5,144,3088,3232
5384,Orange,Franklin County,MA,Orange,2000,2.9,112,3710,3822
5385,Orange,Franklin County,MA,Orange,2001,4,151,3623,3774
5386,Orange,Franklin County,MA,Orange,2002,5.1,195,3627,3822
5387,Orange,Franklin County,MA,Orange,2003,6,227,3565,3792
5388,Orange,Franklin County,MA,Orange,2004,5.8,215,3503,3718
5389,Orange,Franklin County,MA,Orange,2005,5.4,200,3513,3713
5390,Orange,Franklin County,MA,Orange,2006,5,186,3528,3714
5391,Orange,Franklin County,MA,Orange,2007,5.2,193,3537,3730
5392,Orange,Franklin County,MA,Orange,2008,6.8,256,3527,3783
5393,Orange,Franklin County,MA,Orange,2009,10.7,404,3375,3779
5394,Orange,Franklin County,MA,Orange,2010,10.8,411,3409,3820
5395,Orange,Franklin County,MA,Orange,2011,9.2,344,3402,3746
5396,Orange,Franklin County,MA,Orange,2012,9,339,3413,3752
5397,Orleans,Barnstable County,MA,Orleans,1990,5.1,146,2703,2849
5398,Orleans,Barnstable County,MA,Orleans,1991,10.3,294,2568,2862
5399,Orleans,Barnstable County,MA,Orleans,1992,8.5,235,2525,2760
5400,Orleans,Barnstable County,MA,Orleans,1993,8.4,236,2565,2801
5401,Orleans,Barnstable County,MA,Orleans,1994,7.9,226,2623,2849
5402,Orleans,Barnstable County,MA,Orleans,1995,5.7,169,2788,2957
5403,Orleans,Barnstable County,MA,Orleans,1996,5.4,162,2855,3017
5404,Orleans,Barnstable County,MA,Orleans,1997,5.5,169,2895,3064
5405,Orleans,Barnstable County,MA,Orleans,1998,4.4,137,2942,3079
5406,Orleans,Barnstable County,MA,Orleans,1999,3.5,110,3052,3162
5407,Orleans,Barnstable County,MA,Orleans,2000,3.6,103,2775,2878
5408,Orleans,Barnstable County,MA,Orleans,2001,4.1,119,2799,2918
5409,Orleans,Barnstable County,MA,Orleans,2002,4.6,138,2845,2983
5410,Orleans,Barnstable County,MA,Orleans,2003,5.3,164,2902,3066
5411,Orleans,Barnstable County,MA,Orleans,2004,4.8,148,2931,3079
5412,Orleans,Barnstable County,MA,Orleans,2005,4.5,137,2940,3077
5413,Orleans,Barnstable County,MA,Orleans,2006,5,154,2941,3095
5414,Orleans,Barnstable County,MA,Orleans,2007,4.5,137,2920,3057
5415,Orleans,Barnstable County,MA,Orleans,2008,5.2,160,2895,3055
5416,Orleans,Barnstable County,MA,Orleans,2009,7.4,223,2808,3031
5417,Orleans,Barnstable County,MA,Orleans,2010,8.3,244,2681,2925
5418,Orleans,Barnstable County,MA,Orleans,2011,8.1,237,2677,2914
5419,Orleans,Barnstable County,MA,Orleans,2012,6.6,193,2722,2915
5420,Otis,Berkshire County,MA,Otis,1990,7.8,46,546,592
5421,Otis,Berkshire County,MA,Otis,1991,9,54,544,598
5422,Otis,Berkshire County,MA,Otis,1992,9.3,58,567,625
5423,Otis,Berkshire County,MA,Otis,1993,9.3,59,575,634
5424,Otis,Berkshire County,MA,Otis,1994,6.8,44,600,644
5425,Otis,Berkshire County,MA,Otis,1995,6.5,41,588,629
5426,Otis,Berkshire County,MA,Otis,1996,5.8,37,600,637
5427,Otis,Berkshire County,MA,Otis,1997,4.5,29,614,643
5428,Otis,Berkshire County,MA,Otis,1998,3.6,23,609,632
5429,Otis,Berkshire County,MA,Otis,1999,3.8,24,607,631
5430,Otis,Berkshire County,MA,Otis,2000,3.3,25,743,768
5431,Otis,Berkshire County,MA,Otis,2001,2.8,22,768,790
5432,Otis,Berkshire County,MA,Otis,2002,4.2,35,796,831
5433,Otis,Berkshire County,MA,Otis,2003,4.9,41,801,842
5434,Otis,Berkshire County,MA,Otis,2004,5.2,44,802,846
5435,Otis,Berkshire County,MA,Otis,2005,3.6,31,823,854
5436,Otis,Berkshire County,MA,Otis,2006,4.5,39,829,868
5437,Otis,Berkshire County,MA,Otis,2007,4.3,37,820,857
5438,Otis,Berkshire County,MA,Otis,2008,4.7,41,823,864
5439,Otis,Berkshire County,MA,Otis,2009,7.1,61,800,861
5440,Otis,Berkshire County,MA,Otis,2010,6.7,67,931,998
5441,Otis,Berkshire County,MA,Otis,2011,5.7,57,936,993
5442,Otis,Berkshire County,MA,Otis,2012,5.7,56,929,985
5443,Oxford,Worcester County,MA,Oxford,1990,7.4,495,6221,6716
5444,Oxford,Worcester County,MA,Oxford,1991,10.5,711,6061,6772
5445,Oxford,Worcester County,MA,Oxford,1992,9.7,668,6198,6866
5446,Oxford,Worcester County,MA,Oxford,1993,7.1,486,6371,6857
5447,Oxford,Worcester County,MA,Oxford,1994,5.9,409,6529,6938
5448,Oxford,Worcester County,MA,Oxford,1995,5.8,392,6339,6731
5449,Oxford,Worcester County,MA,Oxford,1996,4.6,315,6469,6784
5450,Oxford,Worcester County,MA,Oxford,1997,4.1,285,6678,6963
5451,Oxford,Worcester County,MA,Oxford,1998,3.8,267,6836,7103
5452,Oxford,Worcester County,MA,Oxford,1999,3.1,221,6839,7060
5453,Oxford,Worcester County,MA,Oxford,2000,2.7,205,7377,7582
5454,Oxford,Worcester County,MA,Oxford,2001,3.3,255,7413,7668
5455,Oxford,Worcester County,MA,Oxford,2002,5.1,394,7375,7769
5456,Oxford,Worcester County,MA,Oxford,2003,5.8,450,7336,7786
5457,Oxford,Worcester County,MA,Oxford,2004,5.2,401,7311,7712
5458,Oxford,Worcester County,MA,Oxford,2005,4.9,378,7279,7657
5459,Oxford,Worcester County,MA,Oxford,2006,4.8,370,7332,7702
5460,Oxford,Worcester County,MA,Oxford,2007,4.5,347,7349,7696
5461,Oxford,Worcester County,MA,Oxford,2008,5.7,435,7198,7633
5462,Oxford,Worcester County,MA,Oxford,2009,8.9,685,6992,7677
5463,Oxford,Worcester County,MA,Oxford,2010,8.6,657,6964,7621
5464,Oxford,Worcester County,MA,Oxford,2011,7.6,574,7026,7600
5465,Oxford,Worcester County,MA,Oxford,2012,6.9,522,7024,7546
5466,Palmer,Hampden County,MA,Palmer,1990,6.6,409,5785,6194
5467,Palmer,Hampden County,MA,Palmer,1991,9.5,590,5591,6181
5468,Palmer,Hampden County,MA,Palmer,1992,8.9,555,5665,6220
5469,Palmer,Hampden County,MA,Palmer,1993,9.3,580,5627,6207
5470,Palmer,Hampden County,MA,Palmer,1994,8.9,554,5647,6201
5471,Palmer,Hampden County,MA,Palmer,1995,6.4,378,5561,5939
5472,Palmer,Hampden County,MA,Palmer,1996,5.4,320,5623,5943
5473,Palmer,Hampden County,MA,Palmer,1997,5.1,308,5747,6055
5474,Palmer,Hampden County,MA,Palmer,1998,4.8,294,5769,6063
5475,Palmer,Hampden County,MA,Palmer,1999,4.1,249,5784,6033
5476,Palmer,Hampden County,MA,Palmer,2000,3.1,209,6548,6757
5477,Palmer,Hampden County,MA,Palmer,2001,4,277,6594,6871
5478,Palmer,Hampden County,MA,Palmer,2002,5.5,381,6598,6979
5479,Palmer,Hampden County,MA,Palmer,2003,6.3,443,6574,7017
5480,Palmer,Hampden County,MA,Palmer,2004,6.4,452,6616,7068
5481,Palmer,Hampden County,MA,Palmer,2005,5.2,366,6654,7020
5482,Palmer,Hampden County,MA,Palmer,2006,5.7,402,6699,7101
5483,Palmer,Hampden County,MA,Palmer,2007,5.3,373,6678,7051
5484,Palmer,Hampden County,MA,Palmer,2008,6,424,6662,7086
5485,Palmer,Hampden County,MA,Palmer,2009,8.8,624,6442,7066
5486,Palmer,Hampden County,MA,Palmer,2010,9.9,659,5984,6643
5487,Palmer,Hampden County,MA,Palmer,2011,8.6,556,5925,6481
5488,Palmer,Hampden County,MA,Palmer,2012,8.1,522,5928,6450
5489,Paxton,Worcester County,MA,Paxton,1990,3.2,71,2130,2201
5490,Paxton,Worcester County,MA,Paxton,1991,6.1,134,2072,2206
5491,Paxton,Worcester County,MA,Paxton,1992,6.2,139,2119,2258
5492,Paxton,Worcester County,MA,Paxton,1993,3.6,80,2173,2253
5493,Paxton,Worcester County,MA,Paxton,1994,3.3,76,2202,2278
5494,Paxton,Worcester County,MA,Paxton,1995,3.1,69,2140,2209
5495,Paxton,Worcester County,MA,Paxton,1996,2.9,65,2181,2246
5496,Paxton,Worcester County,MA,Paxton,1997,2.2,51,2239,2290
5497,Paxton,Worcester County,MA,Paxton,1998,2.1,52,2385,2437
5498,Paxton,Worcester County,MA,Paxton,1999,1.8,45,2393,2438
5499,Paxton,Worcester County,MA,Paxton,2000,2.1,50,2290,2340
5500,Paxton,Worcester County,MA,Paxton,2001,2.8,66,2297,2363
5501,Paxton,Worcester County,MA,Paxton,2002,3.5,82,2281,2363
5502,Paxton,Worcester County,MA,Paxton,2003,4.2,99,2282,2381
5503,Paxton,Worcester County,MA,Paxton,2004,3.5,82,2284,2366
5504,Paxton,Worcester County,MA,Paxton,2005,4,94,2285,2379
5505,Paxton,Worcester County,MA,Paxton,2006,4,98,2369,2467
5506,Paxton,Worcester County,MA,Paxton,2007,3.8,94,2397,2491
5507,Paxton,Worcester County,MA,Paxton,2008,4.4,109,2382,2491
5508,Paxton,Worcester County,MA,Paxton,2009,7.1,177,2311,2488
5509,Paxton,Worcester County,MA,Paxton,2010,7.6,191,2307,2498
5510,Paxton,Worcester County,MA,Paxton,2011,6.2,153,2326,2479
5511,Paxton,Worcester County,MA,Paxton,2012,5.4,134,2325,2459
5512,Peabody,Essex County,MA,Peabody,1990,6.2,1643,24859,26502
5513,Peabody,Essex County,MA,Peabody,1991,8.8,2340,24159,26499
5514,Peabody,Essex County,MA,Peabody,1992,8.5,2241,24075,26316
5515,Peabody,Essex County,MA,Peabody,1993,6.7,1746,24373,26119
5516,Peabody,Essex County,MA,Peabody,1994,5.7,1506,24732,26238
5517,Peabody,Essex County,MA,Peabody,1995,4.9,1297,25032,26329
5518,Peabody,Essex County,MA,Peabody,1996,3.9,1034,25578,26612
5519,Peabody,Essex County,MA,Peabody,1997,3.5,946,26392,27338
5520,Peabody,Essex County,MA,Peabody,1998,3.1,871,26875,27746
5521,Peabody,Essex County,MA,Peabody,1999,2.9,814,27145,27959
5522,Peabody,Essex County,MA,Peabody,2000,2.5,635,25235,25870
5523,Peabody,Essex County,MA,Peabody,2001,3.5,917,25525,26442
5524,Peabody,Essex County,MA,Peabody,2002,4.9,1318,25493,26811
5525,Peabody,Essex County,MA,Peabody,2003,5.4,1451,25237,26688
5526,Peabody,Essex County,MA,Peabody,2004,5.1,1354,25407,26761
5527,Peabody,Essex County,MA,Peabody,2005,4.7,1291,25891,27182
5528,Peabody,Essex County,MA,Peabody,2006,4.8,1334,26458,27792
5529,Peabody,Essex County,MA,Peabody,2007,4.4,1203,26406,27609
5530,Peabody,Essex County,MA,Peabody,2008,5,1399,26384,27783
5531,Peabody,Essex County,MA,Peabody,2009,7.8,2189,25793,27982
5532,Peabody,Essex County,MA,Peabody,2010,7.9,2182,25610,27792
5533,Peabody,Essex County,MA,Peabody,2011,6.5,1799,25907,27706
5534,Peabody,Essex County,MA,Peabody,2012,6.4,1774,26106,27880
5535,Pelham,Hampshire County,MA,Pelham,1990,2.7,23,815,838
5536,Pelham,Hampshire County,MA,Pelham,1991,4.2,34,769,803
5537,Pelham,Hampshire County,MA,Pelham,1992,4.8,37,740,777
5538,Pelham,Hampshire County,MA,Pelham,1993,3,23,739,762
5539,Pelham,Hampshire County,MA,Pelham,1994,2.6,21,779,800
5540,Pelham,Hampshire County,MA,Pelham,1995,2.3,20,845,865
5541,Pelham,Hampshire County,MA,Pelham,1996,2.4,21,847,868
5542,Pelham,Hampshire County,MA,Pelham,1997,1.6,14,867,881
5543,Pelham,Hampshire County,MA,Pelham,1998,2.2,20,884,904
5544,Pelham,Hampshire County,MA,Pelham,1999,2.3,21,902,923
5545,Pelham,Hampshire County,MA,Pelham,2000,2.3,18,782,800
5546,Pelham,Hampshire County,MA,Pelham,2001,2.8,23,801,824
5547,Pelham,Hampshire County,MA,Pelham,2002,3.5,29,800,829
5548,Pelham,Hampshire County,MA,Pelham,2003,3.7,31,814,845
5549,Pelham,Hampshire County,MA,Pelham,2004,3.6,30,815,845
5550,Pelham,Hampshire County,MA,Pelham,2005,3.7,31,814,845
5551,Pelham,Hampshire County,MA,Pelham,2006,3.3,28,817,845
5552,Pelham,Hampshire County,MA,Pelham,2007,3.2,27,822,849
5553,Pelham,Hampshire County,MA,Pelham,2008,2.6,21,782,803
5554,Pelham,Hampshire County,MA,Pelham,2009,3.2,25,761,786
5555,Pelham,Hampshire County,MA,Pelham,2010,3.8,28,705,733
5556,Pelham,Hampshire County,MA,Pelham,2011,4.8,36,708,744
5557,Pelham,Hampshire County,MA,Pelham,2012,4.8,36,714,750
5558,Pembroke,Plymouth County,MA,Pembroke,1990,6.6,543,7700,8243
5559,Pembroke,Plymouth County,MA,Pembroke,1991,9.1,756,7560,8316
5560,Pembroke,Plymouth County,MA,Pembroke,1992,9.7,828,7717,8545
5561,Pembroke,Plymouth County,MA,Pembroke,1993,7.9,680,7963,8643
5562,Pembroke,Plymouth County,MA,Pembroke,1994,5.9,520,8287,8807
5563,Pembroke,Plymouth County,MA,Pembroke,1995,5.4,471,8250,8721
5564,Pembroke,Plymouth County,MA,Pembroke,1996,5,445,8499,8944
5565,Pembroke,Plymouth County,MA,Pembroke,1997,4,374,8869,9243
5566,Pembroke,Plymouth County,MA,Pembroke,1998,3.2,297,9128,9425
5567,Pembroke,Plymouth County,MA,Pembroke,1999,3.1,299,9317,9616
5568,Pembroke,Plymouth County,MA,Pembroke,2000,2.4,229,9235,9464
5569,Pembroke,Plymouth County,MA,Pembroke,2001,3.1,302,9325,9627
5570,Pembroke,Plymouth County,MA,Pembroke,2002,4.4,425,9309,9734
5571,Pembroke,Plymouth County,MA,Pembroke,2003,5.3,515,9260,9775
5572,Pembroke,Plymouth County,MA,Pembroke,2004,4.8,463,9269,9732
5573,Pembroke,Plymouth County,MA,Pembroke,2005,4.4,437,9568,10005
5574,Pembroke,Plymouth County,MA,Pembroke,2006,4.4,446,9673,10119
5575,Pembroke,Plymouth County,MA,Pembroke,2007,4.3,441,9743,10184
5576,Pembroke,Plymouth County,MA,Pembroke,2008,5.3,552,9797,10349
5577,Pembroke,Plymouth County,MA,Pembroke,2009,8.1,834,9510,10344
5578,Pembroke,Plymouth County,MA,Pembroke,2010,8.5,854,9135,9989
5579,Pembroke,Plymouth County,MA,Pembroke,2011,7.5,747,9224,9971
5580,Pembroke,Plymouth County,MA,Pembroke,2012,6.6,659,9325,9984
5581,Pepperell,Middlesex County,MA,Pepperell,1990,6.3,364,5427,5791
5582,Pepperell,Middlesex County,MA,Pepperell,1991,8.6,496,5243,5739
5583,Pepperell,Middlesex County,MA,Pepperell,1992,7.9,454,5284,5738
5584,Pepperell,Middlesex County,MA,Pepperell,1993,6.9,395,5358,5753
5585,Pepperell,Middlesex County,MA,Pepperell,1994,5.8,337,5503,5840
5586,Pepperell,Middlesex County,MA,Pepperell,1995,5.1,287,5334,5621
5587,Pepperell,Middlesex County,MA,Pepperell,1996,4.1,236,5573,5809
5588,Pepperell,Middlesex County,MA,Pepperell,1997,3.2,194,5862,6056
5589,Pepperell,Middlesex County,MA,Pepperell,1998,3.1,194,6084,6278
5590,Pepperell,Middlesex County,MA,Pepperell,1999,2.9,191,6304,6495
5591,Pepperell,Middlesex County,MA,Pepperell,2000,2.3,146,6101,6247
5592,Pepperell,Middlesex County,MA,Pepperell,2001,3.5,219,6117,6336
5593,Pepperell,Middlesex County,MA,Pepperell,2002,5.9,373,5971,6344
5594,Pepperell,Middlesex County,MA,Pepperell,2003,5.7,370,6069,6439
5595,Pepperell,Middlesex County,MA,Pepperell,2004,4.8,308,6139,6447
5596,Pepperell,Middlesex County,MA,Pepperell,2005,4.1,268,6204,6472
5597,Pepperell,Middlesex County,MA,Pepperell,2006,4.1,262,6206,6468
5598,Pepperell,Middlesex County,MA,Pepperell,2007,3.8,244,6212,6456
5599,Pepperell,Middlesex County,MA,Pepperell,2008,4.3,277,6172,6449
5600,Pepperell,Middlesex County,MA,Pepperell,2009,7.3,471,5966,6437
5601,Pepperell,Middlesex County,MA,Pepperell,2010,7.4,485,6058,6543
5602,Pepperell,Middlesex County,MA,Pepperell,2011,6.4,414,6077,6491
5603,Pepperell,Middlesex County,MA,Pepperell,2012,5.7,370,6130,6500
5604,Peru,Berkshire County,MA,Peru,1990,5,20,378,398
5605,Peru,Berkshire County,MA,Peru,1991,9.5,38,360,398
5606,Peru,Berkshire County,MA,Peru,1992,8.1,36,407,443
5607,Peru,Berkshire County,MA,Peru,1993,5.2,23,417,440
5608,Peru,Berkshire County,MA,Peru,1994,4.7,23,467,490
5609,Peru,Berkshire County,MA,Peru,1995,4.7,21,428,449
5610,Peru,Berkshire County,MA,Peru,1996,4.4,19,415,434
5611,Peru,Berkshire County,MA,Peru,1997,4.3,19,421,440
5612,Peru,Berkshire County,MA,Peru,1998,4.3,20,440,460
5613,Peru,Berkshire County,MA,Peru,1999,3.6,18,479,497
5614,Peru,Berkshire County,MA,Peru,2000,2.4,11,445,456
5615,Peru,Berkshire County,MA,Peru,2001,2.4,11,444,455
5616,Peru,Berkshire County,MA,Peru,2002,4.1,19,449,468
5617,Peru,Berkshire County,MA,Peru,2003,4.5,21,450,471
5618,Peru,Berkshire County,MA,Peru,2004,5,24,456,480
5619,Peru,Berkshire County,MA,Peru,2005,4.5,22,472,494
5620,Peru,Berkshire County,MA,Peru,2006,3.6,18,487,505
5621,Peru,Berkshire County,MA,Peru,2007,4.9,25,484,509
5622,Peru,Berkshire County,MA,Peru,2008,3,15,477,492
5623,Peru,Berkshire County,MA,Peru,2009,4.1,20,462,482
5624,Peru,Berkshire County,MA,Peru,2010,5,24,456,480
5625,Peru,Berkshire County,MA,Peru,2011,3.6,17,460,477
5626,Peru,Berkshire County,MA,Peru,2012,3.6,17,458,475
5627,Petersham,Worcester County,MA,Petersham,1990,4,23,556,579
5628,Petersham,Worcester County,MA,Petersham,1991,8.3,47,520,567
5629,Petersham,Worcester County,MA,Petersham,1992,8.6,49,521,570
5630,Petersham,Worcester County,MA,Petersham,1993,6.5,37,531,568
5631,Petersham,Worcester County,MA,Petersham,1994,6,35,548,583
5632,Petersham,Worcester County,MA,Petersham,1995,5.3,30,533,563
5633,Petersham,Worcester County,MA,Petersham,1996,3.5,19,529,548
5634,Petersham,Worcester County,MA,Petersham,1997,4.9,28,542,570
5635,Petersham,Worcester County,MA,Petersham,1998,3.1,17,535,552
5636,Petersham,Worcester County,MA,Petersham,1999,3.6,20,537,557
5637,Petersham,Worcester County,MA,Petersham,2000,2.5,16,615,631
5638,Petersham,Worcester County,MA,Petersham,2001,2.7,17,617,634
5639,Petersham,Worcester County,MA,Petersham,2002,4.2,27,615,642
5640,Petersham,Worcester County,MA,Petersham,2003,4.6,30,627,657
5641,Petersham,Worcester County,MA,Petersham,2004,4.2,28,635,663
5642,Petersham,Worcester County,MA,Petersham,2005,4.3,29,643,672
5643,Petersham,Worcester County,MA,Petersham,2006,3.8,26,653,679
5644,Petersham,Worcester County,MA,Petersham,2007,3.9,27,657,684
5645,Petersham,Worcester County,MA,Petersham,2008,4.6,31,650,681
5646,Petersham,Worcester County,MA,Petersham,2009,7.6,52,635,687
5647,Petersham,Worcester County,MA,Petersham,2010,8.8,57,591,648
5648,Petersham,Worcester County,MA,Petersham,2011,6.6,42,596,638
5649,Petersham,Worcester County,MA,Petersham,2012,5.8,37,596,633
5650,Phillipston,Worcester County,MA,Phillipston,1990,6.3,48,712,760
5651,Phillipston,Worcester County,MA,Phillipston,1991,9.4,67,647,714
5652,Phillipston,Worcester County,MA,Phillipston,1992,10.6,78,661,739
5653,Phillipston,Worcester County,MA,Phillipston,1993,7.8,60,710,770
5654,Phillipston,Worcester County,MA,Phillipston,1994,11.5,96,741,837
5655,Phillipston,Worcester County,MA,Phillipston,1995,8.2,64,714,778
5656,Phillipston,Worcester County,MA,Phillipston,1996,7.7,59,711,770
5657,Phillipston,Worcester County,MA,Phillipston,1997,6.4,50,726,776
5658,Phillipston,Worcester County,MA,Phillipston,1998,6.2,42,636,678
5659,Phillipston,Worcester County,MA,Phillipston,1999,7.2,49,635,684
5660,Phillipston,Worcester County,MA,Phillipston,2000,3.2,29,877,906
5661,Phillipston,Worcester County,MA,Phillipston,2001,4.2,38,866,904
5662,Phillipston,Worcester County,MA,Phillipston,2002,6.5,60,858,918
5663,Phillipston,Worcester County,MA,Phillipston,2003,5.5,51,871,922
5664,Phillipston,Worcester County,MA,Phillipston,2004,6.2,58,885,943
5665,Phillipston,Worcester County,MA,Phillipston,2005,6.5,62,889,951
5666,Phillipston,Worcester County,MA,Phillipston,2006,5.4,52,909,961
5667,Phillipston,Worcester County,MA,Phillipston,2007,4.7,45,917,962
5668,Phillipston,Worcester County,MA,Phillipston,2008,6.2,60,904,964
5669,Phillipston,Worcester County,MA,Phillipston,2009,10.2,97,854,951
5670,Phillipston,Worcester County,MA,Phillipston,2010,10,91,821,912
5671,Phillipston,Worcester County,MA,Phillipston,2011,8.5,76,820,896
5672,Phillipston,Worcester County,MA,Phillipston,2012,9.2,83,820,903
5673,Pittsfield,Berkshire County,MA,Pittsfield,1990,7,1666,22141,23807
5674,Pittsfield,Berkshire County,MA,Pittsfield,1991,11.8,2793,20960,23753
5675,Pittsfield,Berkshire County,MA,Pittsfield,1992,11.8,2725,20401,23126
5676,Pittsfield,Berkshire County,MA,Pittsfield,1993,9.5,2127,20306,22433
5677,Pittsfield,Berkshire County,MA,Pittsfield,1994,9,1962,19912,21874
5678,Pittsfield,Berkshire County,MA,Pittsfield,1995,7.1,1543,20085,21628
5679,Pittsfield,Berkshire County,MA,Pittsfield,1996,5.6,1217,20335,21552
5680,Pittsfield,Berkshire County,MA,Pittsfield,1997,5.5,1189,20385,21574
5681,Pittsfield,Berkshire County,MA,Pittsfield,1998,4.4,952,20472,21424
5682,Pittsfield,Berkshire County,MA,Pittsfield,1999,4.4,945,20523,21468
5683,Pittsfield,Berkshire County,MA,Pittsfield,2000,3.2,740,22147,22887
5684,Pittsfield,Berkshire County,MA,Pittsfield,2001,3.8,882,22050,22932
5685,Pittsfield,Berkshire County,MA,Pittsfield,2002,4.8,1133,22270,23403
5686,Pittsfield,Berkshire County,MA,Pittsfield,2003,5.3,1240,22007,23247
5687,Pittsfield,Berkshire County,MA,Pittsfield,2004,5,1142,21906,23048
5688,Pittsfield,Berkshire County,MA,Pittsfield,2005,4.5,1052,22075,23127
5689,Pittsfield,Berkshire County,MA,Pittsfield,2006,4.5,1049,22374,23423
5690,Pittsfield,Berkshire County,MA,Pittsfield,2007,4.5,1042,22144,23186
5691,Pittsfield,Berkshire County,MA,Pittsfield,2008,5.4,1248,21847,23095
5692,Pittsfield,Berkshire County,MA,Pittsfield,2009,8.2,1889,21135,23024
5693,Pittsfield,Berkshire County,MA,Pittsfield,2010,8.6,2011,21483,23494
5694,Pittsfield,Berkshire County,MA,Pittsfield,2011,7.9,1849,21683,23532
5695,Pittsfield,Berkshire County,MA,Pittsfield,2012,7.5,1749,21585,23334
5696,Plainfield,Hampshire County,MA,Plainfield,1990,7.3,22,280,302
5697,Plainfield,Hampshire County,MA,Plainfield,1991,12.2,37,267,304
5698,Plainfield,Hampshire County,MA,Plainfield,1992,11.8,39,291,330
5699,Plainfield,Hampshire County,MA,Plainfield,1993,7.7,24,289,313
5700,Plainfield,Hampshire County,MA,Plainfield,1994,6.9,24,324,348
5701,Plainfield,Hampshire County,MA,Plainfield,1995,5.2,19,347,366
5702,Plainfield,Hampshire County,MA,Plainfield,1996,5.8,21,339,360
5703,Plainfield,Hampshire County,MA,Plainfield,1997,6.6,24,342,366
5704,Plainfield,Hampshire County,MA,Plainfield,1998,4.5,17,360,377
5705,Plainfield,Hampshire County,MA,Plainfield,1999,3.7,15,392,407
5706,Plainfield,Hampshire County,MA,Plainfield,2000,3.3,10,289,299
5707,Plainfield,Hampshire County,MA,Plainfield,2001,4.3,13,291,304
5708,Plainfield,Hampshire County,MA,Plainfield,2002,5.5,17,291,308
5709,Plainfield,Hampshire County,MA,Plainfield,2003,6.5,20,289,309
5710,Plainfield,Hampshire County,MA,Plainfield,2004,5.8,18,290,308
5711,Plainfield,Hampshire County,MA,Plainfield,2005,4.9,15,289,304
5712,Plainfield,Hampshire County,MA,Plainfield,2006,5.2,16,292,308
5713,Plainfield,Hampshire County,MA,Plainfield,2007,4.9,15,292,307
5714,Plainfield,Hampshire County,MA,Plainfield,2008,6.3,19,285,304
5715,Plainfield,Hampshire County,MA,Plainfield,2009,8.4,25,272,297
5716,Plainfield,Hampshire County,MA,Plainfield,2010,8.3,27,299,326
5717,Plainfield,Hampshire County,MA,Plainfield,2011,7.2,23,296,319
5718,Plainfield,Hampshire County,MA,Plainfield,2012,6,19,296,315
5719,Plainville,Norfolk County,MA,Plainville,1990,4.8,189,3776,3965
5720,Plainville,Norfolk County,MA,Plainville,1991,9.3,377,3694,4071
5721,Plainville,Norfolk County,MA,Plainville,1992,8.9,357,3668,4025
5722,Plainville,Norfolk County,MA,Plainville,1993,6,245,3820,4065
5723,Plainville,Norfolk County,MA,Plainville,1994,5.5,235,4004,4239
5724,Plainville,Norfolk County,MA,Plainville,1995,5,203,3889,4092
5725,Plainville,Norfolk County,MA,Plainville,1996,3.7,155,3985,4140
5726,Plainville,Norfolk County,MA,Plainville,1997,3.6,153,4104,4257
5727,Plainville,Norfolk County,MA,Plainville,1998,2.7,117,4228,4345
5728,Plainville,Norfolk County,MA,Plainville,1999,2.7,120,4312,4432
5729,Plainville,Norfolk County,MA,Plainville,2000,2.9,130,4418,4548
5730,Plainville,Norfolk County,MA,Plainville,2001,3.7,172,4418,4590
5731,Plainville,Norfolk County,MA,Plainville,2002,5.3,251,4464,4715
5732,Plainville,Norfolk County,MA,Plainville,2003,5,238,4516,4754
5733,Plainville,Norfolk County,MA,Plainville,2004,5,235,4512,4747
5734,Plainville,Norfolk County,MA,Plainville,2005,4.5,219,4596,4815
5735,Plainville,Norfolk County,MA,Plainville,2006,4.8,239,4695,4934
5736,Plainville,Norfolk County,MA,Plainville,2007,4.2,214,4823,5037
5737,Plainville,Norfolk County,MA,Plainville,2008,5.5,275,4690,4965
5738,Plainville,Norfolk County,MA,Plainville,2009,9.9,497,4527,5024
5739,Plainville,Norfolk County,MA,Plainville,2010,10.1,502,4489,4991
5740,Plainville,Norfolk County,MA,Plainville,2011,8.4,419,4550,4969
5741,Plainville,Norfolk County,MA,Plainville,2012,8.3,414,4557,4971
5742,Plymouth,Plymouth County,MA,Plymouth,1990,7.3,1730,21973,23703
5743,Plymouth,Plymouth County,MA,Plymouth,1991,9.4,2251,21636,23887
5744,Plymouth,Plymouth County,MA,Plymouth,1992,9.7,2343,21712,24055
5745,Plymouth,Plymouth County,MA,Plymouth,1993,8.5,2082,22291,24373
5746,Plymouth,Plymouth County,MA,Plymouth,1994,6.9,1716,22990,24706
5747,Plymouth,Plymouth County,MA,Plymouth,1995,6.2,1511,22710,24221
5748,Plymouth,Plymouth County,MA,Plymouth,1996,5.7,1398,23273,24671
5749,Plymouth,Plymouth County,MA,Plymouth,1997,5,1280,24105,25385
5750,Plymouth,Plymouth County,MA,Plymouth,1998,4,1040,24839,25879
5751,Plymouth,Plymouth County,MA,Plymouth,1999,3.4,900,25458,26358
5752,Plymouth,Plymouth County,MA,Plymouth,2000,2.9,798,26811,27609
5753,Plymouth,Plymouth County,MA,Plymouth,2001,3.4,969,27153,28122
5754,Plymouth,Plymouth County,MA,Plymouth,2002,4.9,1397,27073,28470
5755,Plymouth,Plymouth County,MA,Plymouth,2003,5.6,1607,26949,28556
5756,Plymouth,Plymouth County,MA,Plymouth,2004,5.3,1504,27141,28645
5757,Plymouth,Plymouth County,MA,Plymouth,2005,4.9,1436,27590,29026
5758,Plymouth,Plymouth County,MA,Plymouth,2006,5.1,1485,27782,29267
5759,Plymouth,Plymouth County,MA,Plymouth,2007,5.1,1500,27993,29493
5760,Plymouth,Plymouth County,MA,Plymouth,2008,6,1778,27987,29765
5761,Plymouth,Plymouth County,MA,Plymouth,2009,8.9,2658,27248,29906
5762,Plymouth,Plymouth County,MA,Plymouth,2010,9,2730,27475,30205
5763,Plymouth,Plymouth County,MA,Plymouth,2011,7.7,2310,27739,30049
5764,Plymouth,Plymouth County,MA,Plymouth,2012,6.8,2037,28043,30080
5788,Plympton,Plymouth County,MA,Plympton,1990,7,96,1271,1367
5789,Plympton,Plymouth County,MA,Plympton,1991,9.3,130,1268,1398
5790,Plympton,Plymouth County,MA,Plympton,1992,10.5,144,1231,1375
5791,Plympton,Plymouth County,MA,Plympton,1993,9.3,135,1314,1449
5792,Plympton,Plymouth County,MA,Plympton,1994,7.1,108,1406,1514
5793,Plympton,Plymouth County,MA,Plympton,1995,6.1,92,1406,1498
5794,Plympton,Plymouth County,MA,Plympton,1996,5.6,85,1423,1508
5795,Plympton,Plymouth County,MA,Plympton,1997,3.7,57,1472,1529
5796,Plympton,Plymouth County,MA,Plympton,1998,3.4,53,1500,1553
5797,Plympton,Plymouth County,MA,Plympton,1999,3.2,51,1531,1582
5798,Plympton,Plymouth County,MA,Plympton,2000,2.7,42,1521,1563
5799,Plympton,Plymouth County,MA,Plympton,2001,3,47,1520,1567
5800,Plympton,Plymouth County,MA,Plympton,2002,3.9,62,1512,1574
5801,Plympton,Plymouth County,MA,Plympton,2003,5.8,91,1490,1581
5802,Plympton,Plymouth County,MA,Plympton,2004,5.4,85,1500,1585
5803,Plympton,Plymouth County,MA,Plympton,2005,4.8,76,1520,1596
5804,Plympton,Plymouth County,MA,Plympton,2006,5.1,82,1530,1612
5805,Plympton,Plymouth County,MA,Plympton,2007,5,82,1556,1638
5806,Plympton,Plymouth County,MA,Plympton,2008,5.9,97,1552,1649
5807,Plympton,Plymouth County,MA,Plympton,2009,8.1,133,1507,1640
5808,Plympton,Plymouth County,MA,Plympton,2010,8.2,136,1516,1652
5809,Plympton,Plymouth County,MA,Plympton,2011,7.3,121,1532,1653
5810,Plympton,Plymouth County,MA,Plympton,2012,6.8,112,1545,1657
5811,Princeton,Worcester County,MA,Princeton,1990,4,74,1790,1864
5812,Princeton,Worcester County,MA,Princeton,1991,5.9,110,1741,1851
5813,Princeton,Worcester County,MA,Princeton,1992,5.3,99,1759,1858
5814,Princeton,Worcester County,MA,Princeton,1993,5.2,100,1835,1935
5815,Princeton,Worcester County,MA,Princeton,1994,4.3,86,1911,1997
5816,Princeton,Worcester County,MA,Princeton,1995,4.7,90,1837,1927
5817,Princeton,Worcester County,MA,Princeton,1996,2.8,55,1879,1934
5818,Princeton,Worcester County,MA,Princeton,1997,2.4,48,1939,1987
5819,Princeton,Worcester County,MA,Princeton,1998,2.1,43,1989,2032
5820,Princeton,Worcester County,MA,Princeton,1999,2.5,51,1993,2044
5821,Princeton,Worcester County,MA,Princeton,2000,2.1,41,1869,1910
5822,Princeton,Worcester County,MA,Princeton,2001,2.7,53,1879,1932
5823,Princeton,Worcester County,MA,Princeton,2002,4.4,87,1879,1966
5824,Princeton,Worcester County,MA,Princeton,2003,4.9,96,1882,1978
5825,Princeton,Worcester County,MA,Princeton,2004,4.7,92,1878,1970
5826,Princeton,Worcester County,MA,Princeton,2005,4.5,88,1885,1973
5827,Princeton,Worcester County,MA,Princeton,2006,3.8,75,1896,1971
5828,Princeton,Worcester County,MA,Princeton,2007,3.5,68,1895,1963
5829,Princeton,Worcester County,MA,Princeton,2008,4.7,92,1852,1944
5830,Princeton,Worcester County,MA,Princeton,2009,6.6,128,1801,1929
5831,Princeton,Worcester County,MA,Princeton,2010,6.6,123,1748,1871
5832,Princeton,Worcester County,MA,Princeton,2011,5.7,107,1763,1870
5833,Princeton,Worcester County,MA,Princeton,2012,5.5,103,1762,1865
5834,Provincetown,Barnstable County,MA,Provincetown,1990,22.1,712,2516,3228
5835,Provincetown,Barnstable County,MA,Provincetown,1991,25.8,864,2489,3353
5836,Provincetown,Barnstable County,MA,Provincetown,1992,28.7,1004,2492,3496
5837,Provincetown,Barnstable County,MA,Provincetown,1993,30.1,1100,2560,3660
5838,Provincetown,Barnstable County,MA,Provincetown,1994,29,1047,2562,3609
5839,Provincetown,Barnstable County,MA,Provincetown,1995,26,940,2670,3610
5840,Provincetown,Barnstable County,MA,Provincetown,1996,23.4,816,2667,3483
5841,Provincetown,Barnstable County,MA,Provincetown,1997,23.4,811,2660,3471
5842,Provincetown,Barnstable County,MA,Provincetown,1998,20.7,705,2702,3407
5843,Provincetown,Barnstable County,MA,Provincetown,1999,18.7,632,2751,3383
5844,Provincetown,Barnstable County,MA,Provincetown,2000,17.4,369,1756,2125
5845,Provincetown,Barnstable County,MA,Provincetown,2001,16.8,357,1774,2131
5846,Provincetown,Barnstable County,MA,Provincetown,2002,17.9,392,1794,2186
5847,Provincetown,Barnstable County,MA,Provincetown,2003,18.8,420,1818,2238
5848,Provincetown,Barnstable County,MA,Provincetown,2004,18.4,412,1825,2237
5849,Provincetown,Barnstable County,MA,Provincetown,2005,18,401,1824,2225
5850,Provincetown,Barnstable County,MA,Provincetown,2006,17.7,394,1834,2228
5851,Provincetown,Barnstable County,MA,Provincetown,2007,15.7,340,1832,2172
5852,Provincetown,Barnstable County,MA,Provincetown,2008,16.3,354,1822,2176
5853,Provincetown,Barnstable County,MA,Provincetown,2009,20.3,458,1793,2251
5854,Provincetown,Barnstable County,MA,Provincetown,2010,23.8,490,1566,2056
5855,Provincetown,Barnstable County,MA,Provincetown,2011,24.9,518,1563,2081
5856,Provincetown,Barnstable County,MA,Provincetown,2012,23.4,485,1589,2074
5857,Quincy,Norfolk County,MA,Quincy,1990,5.9,2899,46343,49242
5858,Quincy,Norfolk County,MA,Quincy,1991,8.7,4258,44640,48898
5859,Quincy,Norfolk County,MA,Quincy,1992,8.7,4231,44318,48549
5860,Quincy,Norfolk County,MA,Quincy,1993,7.2,3478,44636,48114
5861,Quincy,Norfolk County,MA,Quincy,1994,5.9,2836,44913,47749
5862,Quincy,Norfolk County,MA,Quincy,1995,5.6,2738,46116,48854
5863,Quincy,Norfolk County,MA,Quincy,1996,4.5,2220,46910,49130
5864,Quincy,Norfolk County,MA,Quincy,1997,4,1980,48041,50021
5865,Quincy,Norfolk County,MA,Quincy,1998,3.1,1579,48706,50285
5866,Quincy,Norfolk County,MA,Quincy,1999,3,1495,49068,50563
5867,Quincy,Norfolk County,MA,Quincy,2000,2.7,1377,49550,50927
5868,Quincy,Norfolk County,MA,Quincy,2001,3.5,1816,49688,51504
5869,Quincy,Norfolk County,MA,Quincy,2002,5.2,2662,48904,51566
5870,Quincy,Norfolk County,MA,Quincy,2003,6,3054,48181,51235
5871,Quincy,Norfolk County,MA,Quincy,2004,5.2,2689,48657,51346
5872,Quincy,Norfolk County,MA,Quincy,2005,4.7,2409,49345,51754
5873,Quincy,Norfolk County,MA,Quincy,2006,4.6,2366,48596,50962
5874,Quincy,Norfolk County,MA,Quincy,2007,4.4,2227,48903,51130
5875,Quincy,Norfolk County,MA,Quincy,2008,5.3,2752,48871,51623
5876,Quincy,Norfolk County,MA,Quincy,2009,8.1,4200,47494,51694
5877,Quincy,Norfolk County,MA,Quincy,2010,8.1,4296,48866,53162
5878,Quincy,Norfolk County,MA,Quincy,2011,6.9,3680,49414,53094
5879,Quincy,Norfolk County,MA,Quincy,2012,6.1,3226,49955,53181
5880,Randolph,Norfolk County,MA,Randolph,1990,6.1,1026,15894,16920
5881,Randolph,Norfolk County,MA,Randolph,1991,8.8,1498,15483,16981
5882,Randolph,Norfolk County,MA,Randolph,1992,8.8,1490,15400,16890
5883,Randolph,Norfolk County,MA,Randolph,1993,7.1,1190,15485,16675
5884,Randolph,Norfolk County,MA,Randolph,1994,6.5,1074,15574,16648
5885,Randolph,Norfolk County,MA,Randolph,1995,5.6,946,15934,16880
5886,Randolph,Norfolk County,MA,Randolph,1996,4.8,820,16210,17030
5887,Randolph,Norfolk County,MA,Randolph,1997,4.1,701,16580,17281
5888,Randolph,Norfolk County,MA,Randolph,1998,3.5,607,16794,17401
5889,Randolph,Norfolk County,MA,Randolph,1999,3.2,566,16879,17445
5890,Randolph,Norfolk County,MA,Randolph,2000,2.7,466,16662,17128
5891,Randolph,Norfolk County,MA,Randolph,2001,3.8,653,16592,17245
5892,Randolph,Norfolk County,MA,Randolph,2002,5.8,995,16286,17281
5893,Randolph,Norfolk County,MA,Randolph,2003,6.4,1087,16000,17087
5894,Randolph,Norfolk County,MA,Randolph,2004,5.6,953,15936,16889
5895,Randolph,Norfolk County,MA,Randolph,2005,5.2,872,15953,16825
5896,Randolph,Norfolk County,MA,Randolph,2006,5.4,896,15655,16551
5897,Randolph,Norfolk County,MA,Randolph,2007,4.9,809,15743,16552
5898,Randolph,Norfolk County,MA,Randolph,2008,5.8,973,15711,16684
5899,Randolph,Norfolk County,MA,Randolph,2009,8.5,1439,15500,16939
5900,Randolph,Norfolk County,MA,Randolph,2010,8.8,1564,16286,17850
5901,Randolph,Norfolk County,MA,Randolph,2011,7.7,1367,16470,17837
5902,Randolph,Norfolk County,MA,Randolph,2012,7,1246,16650,17896
5903,Raynham,Bristol County,MA,Raynham,1990,6.8,371,5100,5471
5904,Raynham,Bristol County,MA,Raynham,1991,10,544,4904,5448
5905,Raynham,Bristol County,MA,Raynham,1992,10.3,561,4869,5430
5906,Raynham,Bristol County,MA,Raynham,1993,7.8,437,5152,5589
5907,Raynham,Bristol County,MA,Raynham,1994,7.1,420,5480,5900
5908,Raynham,Bristol County,MA,Raynham,1995,6.4,376,5487,5863
5909,Raynham,Bristol County,MA,Raynham,1996,5.4,319,5562,5881
5910,Raynham,Bristol County,MA,Raynham,1997,4.7,283,5756,6039
5911,Raynham,Bristol County,MA,Raynham,1998,3.4,202,5822,6024
5912,Raynham,Bristol County,MA,Raynham,1999,3.4,207,5957,6164
5913,Raynham,Bristol County,MA,Raynham,2000,2.2,150,6592,6742
5914,Raynham,Bristol County,MA,Raynham,2001,3.2,217,6664,6881
5915,Raynham,Bristol County,MA,Raynham,2002,4.5,321,6754,7075
5916,Raynham,Bristol County,MA,Raynham,2003,5,362,6854,7216
5917,Raynham,Bristol County,MA,Raynham,2004,4.8,365,7237,7602
5918,Raynham,Bristol County,MA,Raynham,2005,4.2,329,7462,7791
5919,Raynham,Bristol County,MA,Raynham,2006,4.2,333,7648,7981
5920,Raynham,Bristol County,MA,Raynham,2007,4.1,333,7701,8034
5921,Raynham,Bristol County,MA,Raynham,2008,5.1,412,7648,8060
5922,Raynham,Bristol County,MA,Raynham,2009,7.8,624,7354,7978
5923,Raynham,Bristol County,MA,Raynham,2010,7.9,619,7228,7847
5924,Raynham,Bristol County,MA,Raynham,2011,7.2,569,7304,7873
5925,Raynham,Bristol County,MA,Raynham,2012,6.1,477,7282,7759
5926,Reading,Middlesex County,MA,Reading,1990,4.9,635,12258,12893
5927,Reading,Middlesex County,MA,Reading,1991,7,897,11856,12753
5928,Reading,Middlesex County,MA,Reading,1992,7.1,904,11803,12707
5929,Reading,Middlesex County,MA,Reading,1993,5.1,641,11962,12603
5930,Reading,Middlesex County,MA,Reading,1994,4.4,565,12156,12721
5931,Reading,Middlesex County,MA,Reading,1995,3.7,473,12266,12739
5932,Reading,Middlesex County,MA,Reading,1996,3.2,418,12532,12950
5933,Reading,Middlesex County,MA,Reading,1997,2.9,382,12970,13352
5934,Reading,Middlesex County,MA,Reading,1998,2.3,308,13226,13534
5935,Reading,Middlesex County,MA,Reading,1999,2.3,309,13317,13626
5936,Reading,Middlesex County,MA,Reading,2000,2,268,12909,13177
5937,Reading,Middlesex County,MA,Reading,2001,3,393,12840,13233
5938,Reading,Middlesex County,MA,Reading,2002,4.5,597,12567,13164
5939,Reading,Middlesex County,MA,Reading,2003,5.1,666,12327,12993
5940,Reading,Middlesex County,MA,Reading,2004,4.2,537,12247,12784
5941,Reading,Middlesex County,MA,Reading,2005,3.7,478,12272,12750
5942,Reading,Middlesex County,MA,Reading,2006,3.7,461,12119,12580
5943,Reading,Middlesex County,MA,Reading,2007,3.4,425,12209,12634
5944,Reading,Middlesex County,MA,Reading,2008,4.1,518,12202,12720
5945,Reading,Middlesex County,MA,Reading,2009,6.9,878,11884,12762
5946,Reading,Middlesex County,MA,Reading,2010,6.1,820,12699,13519
5947,Reading,Middlesex County,MA,Reading,2011,5.4,738,12884,13622
5948,Reading,Middlesex County,MA,Reading,2012,4.8,652,13025,13677
5949,Rehoboth,Bristol County,MA,Rehoboth,1990,6.1,297,4609,4906
5950,Rehoboth,Bristol County,MA,Rehoboth,1991,10.4,516,4464,4980
5951,Rehoboth,Bristol County,MA,Rehoboth,1992,11.1,572,4575,5147
5952,Rehoboth,Bristol County,MA,Rehoboth,1993,9,469,4725,5194
5953,Rehoboth,Bristol County,MA,Rehoboth,1994,8.2,437,4882,5319
5954,Rehoboth,Bristol County,MA,Rehoboth,1995,6.8,364,4950,5314
5955,Rehoboth,Bristol County,MA,Rehoboth,1996,6,321,5011,5332
5956,Rehoboth,Bristol County,MA,Rehoboth,1997,4.9,268,5154,5422
5957,Rehoboth,Bristol County,MA,Rehoboth,1998,3.7,205,5302,5507
5958,Rehoboth,Bristol County,MA,Rehoboth,1999,3.2,181,5414,5595
5959,Rehoboth,Bristol County,MA,Rehoboth,2000,3.3,197,5850,6047
5960,Rehoboth,Bristol County,MA,Rehoboth,2001,3.9,238,5939,6177
5961,Rehoboth,Bristol County,MA,Rehoboth,2002,4.8,308,6055,6363
5962,Rehoboth,Bristol County,MA,Rehoboth,2003,4.9,321,6208,6529
5963,Rehoboth,Bristol County,MA,Rehoboth,2004,4.7,310,6307,6617
5964,Rehoboth,Bristol County,MA,Rehoboth,2005,4.5,305,6420,6725
5965,Rehoboth,Bristol County,MA,Rehoboth,2006,4.8,333,6555,6888
5966,Rehoboth,Bristol County,MA,Rehoboth,2007,4.3,300,6635,6935
5967,Rehoboth,Bristol County,MA,Rehoboth,2008,5.8,404,6530,6934
5968,Rehoboth,Bristol County,MA,Rehoboth,2009,9.4,645,6247,6892
5969,Rehoboth,Bristol County,MA,Rehoboth,2010,9.4,648,6279,6927
5970,Rehoboth,Bristol County,MA,Rehoboth,2011,8.6,592,6324,6916
5971,Rehoboth,Bristol County,MA,Rehoboth,2012,7.9,547,6334,6881
5972,Revere,Suffolk County,MA,Revere,1990,7.5,1649,20331,21980
5973,Revere,Suffolk County,MA,Revere,1991,10.6,2346,19788,22134
5974,Revere,Suffolk County,MA,Revere,1992,10.8,2370,19516,21886
5975,Revere,Suffolk County,MA,Revere,1993,8.6,1847,19532,21379
5976,Revere,Suffolk County,MA,Revere,1994,7.6,1601,19470,21071
5977,Revere,Suffolk County,MA,Revere,1995,7.1,1500,19684,21184
5978,Revere,Suffolk County,MA,Revere,1996,5.4,1138,19942,21080
5979,Revere,Suffolk County,MA,Revere,1997,5.1,1098,20330,21428
5980,Revere,Suffolk County,MA,Revere,1998,4.1,874,20606,21480
5981,Revere,Suffolk County,MA,Revere,1999,4.3,926,20792,21718
5982,Revere,Suffolk County,MA,Revere,2000,3.3,749,21873,22622
5983,Revere,Suffolk County,MA,Revere,2001,4.1,945,21874,22819
5984,Revere,Suffolk County,MA,Revere,2002,6.3,1433,21377,22810
5985,Revere,Suffolk County,MA,Revere,2003,7.6,1703,20782,22485
5986,Revere,Suffolk County,MA,Revere,2004,6.5,1418,20534,21952
5987,Revere,Suffolk County,MA,Revere,2005,6,1324,20616,21940
5988,Revere,Suffolk County,MA,Revere,2006,5.7,1348,22245,23593
5989,Revere,Suffolk County,MA,Revere,2007,5.1,1238,22871,24109
5990,Revere,Suffolk County,MA,Revere,2008,6.2,1499,22744,24243
5991,Revere,Suffolk County,MA,Revere,2009,9.1,2222,22201,24423
5992,Revere,Suffolk County,MA,Revere,2010,9.2,2286,22562,24848
5993,Revere,Suffolk County,MA,Revere,2011,8.1,2035,22966,25001
5994,Revere,Suffolk County,MA,Revere,2012,7.5,1884,23218,25102
5995,Richmond,Berkshire County,MA,Richmond,1990,3.1,28,861,889
5996,Richmond,Berkshire County,MA,Richmond,1991,5,44,835,879
5997,Richmond,Berkshire County,MA,Richmond,1992,7.3,65,826,891
5998,Richmond,Berkshire County,MA,Richmond,1993,5,43,812,855
5999,Richmond,Berkshire County,MA,Richmond,1994,3.7,31,815,846
6000,Richmond,Berkshire County,MA,Richmond,1995,4,33,793,826
6001,Richmond,Berkshire County,MA,Richmond,1996,2.8,23,803,826
6002,Richmond,Berkshire County,MA,Richmond,1997,3,25,813,838
6003,Richmond,Berkshire County,MA,Richmond,1998,2.7,23,820,843
6004,Richmond,Berkshire County,MA,Richmond,1999,2.2,19,828,847
6005,Richmond,Berkshire County,MA,Richmond,2000,1.6,15,917,932
6006,Richmond,Berkshire County,MA,Richmond,2001,1.9,18,921,939
6007,Richmond,Berkshire County,MA,Richmond,2002,2.4,23,940,963
6008,Richmond,Berkshire County,MA,Richmond,2003,3.5,34,941,975
6009,Richmond,Berkshire County,MA,Richmond,2004,3.3,32,951,983
6010,Richmond,Berkshire County,MA,Richmond,2005,3.3,33,961,994
6011,Richmond,Berkshire County,MA,Richmond,2006,2.6,26,973,999
6012,Richmond,Berkshire County,MA,Richmond,2007,3,30,967,997
6013,Richmond,Berkshire County,MA,Richmond,2008,3,29,949,978
6014,Richmond,Berkshire County,MA,Richmond,2009,4.9,48,922,970
6015,Richmond,Berkshire County,MA,Richmond,2010,4.6,40,835,875
6016,Richmond,Berkshire County,MA,Richmond,2011,4.4,39,842,881
6017,Richmond,Berkshire County,MA,Richmond,2012,3.2,28,838,866
6018,Rochester,Plymouth County,MA,Rochester,1990,6.4,138,2003,2141
6019,Rochester,Plymouth County,MA,Rochester,1991,9.3,200,1961,2161
6020,Rochester,Plymouth County,MA,Rochester,1992,8.9,194,1993,2187
6021,Rochester,Plymouth County,MA,Rochester,1993,7.1,162,2132,2294
6022,Rochester,Plymouth County,MA,Rochester,1994,6.6,158,2236,2394
6023,Rochester,Plymouth County,MA,Rochester,1995,6.9,160,2170,2330
6024,Rochester,Plymouth County,MA,Rochester,1996,5.5,128,2182,2310
6025,Rochester,Plymouth County,MA,Rochester,1997,5.1,121,2269,2390
6026,Rochester,Plymouth County,MA,Rochester,1998,3.6,87,2340,2427
6027,Rochester,Plymouth County,MA,Rochester,1999,3.3,83,2414,2497
6028,Rochester,Plymouth County,MA,Rochester,2000,2.5,67,2561,2628
6029,Rochester,Plymouth County,MA,Rochester,2001,3.1,83,2626,2709
6030,Rochester,Plymouth County,MA,Rochester,2002,4.4,125,2694,2819
6031,Rochester,Plymouth County,MA,Rochester,2003,4.8,135,2705,2840
6032,Rochester,Plymouth County,MA,Rochester,2004,4.5,130,2788,2918
6033,Rochester,Plymouth County,MA,Rochester,2005,4.1,125,2892,3017
6034,Rochester,Plymouth County,MA,Rochester,2006,3.6,113,2996,3109
6035,Rochester,Plymouth County,MA,Rochester,2007,4.1,124,2900,3024
6036,Rochester,Plymouth County,MA,Rochester,2008,4.8,143,2851,2994
6037,Rochester,Plymouth County,MA,Rochester,2009,7.4,222,2782,3004
6038,Rochester,Plymouth County,MA,Rochester,2010,7.9,233,2714,2947
6039,Rochester,Plymouth County,MA,Rochester,2011,7.3,217,2755,2972
6040,Rochester,Plymouth County,MA,Rochester,2012,6.5,194,2787,2981
6041,Rockland,Plymouth County,MA,Rockland,1990,7.6,675,8160,8835
6042,Rockland,Plymouth County,MA,Rockland,1991,10.4,912,7868,8780
6043,Rockland,Plymouth County,MA,Rockland,1992,9.7,854,7921,8775
6044,Rockland,Plymouth County,MA,Rockland,1993,7.9,694,8054,8748
6045,Rockland,Plymouth County,MA,Rockland,1994,6.5,570,8249,8819
6046,Rockland,Plymouth County,MA,Rockland,1995,6,544,8477,9021
6047,Rockland,Plymouth County,MA,Rockland,1996,5,455,8736,9191
6048,Rockland,Plymouth County,MA,Rockland,1997,4.1,383,9067,9450
6049,Rockland,Plymouth County,MA,Rockland,1998,3.4,326,9283,9609
6050,Rockland,Plymouth County,MA,Rockland,1999,3.5,339,9482,9821
6051,Rockland,Plymouth County,MA,Rockland,2000,2.9,286,9680,9966
6052,Rockland,Plymouth County,MA,Rockland,2001,3.2,322,9698,10020
6053,Rockland,Plymouth County,MA,Rockland,2002,4.8,480,9610,10090
6054,Rockland,Plymouth County,MA,Rockland,2003,5.4,544,9448,9992
6055,Rockland,Plymouth County,MA,Rockland,2004,5.5,543,9402,9945
6056,Rockland,Plymouth County,MA,Rockland,2005,4.9,494,9491,9985
6057,Rockland,Plymouth County,MA,Rockland,2006,5,496,9347,9843
6058,Rockland,Plymouth County,MA,Rockland,2007,5.1,507,9431,9938
6059,Rockland,Plymouth County,MA,Rockland,2008,5.6,558,9455,10013
6060,Rockland,Plymouth County,MA,Rockland,2009,8.6,867,9182,10049
6061,Rockland,Plymouth County,MA,Rockland,2010,9.1,899,9012,9911
6062,Rockland,Plymouth County,MA,Rockland,2011,7.2,710,9099,9809
6063,Rockland,Plymouth County,MA,Rockland,2012,6.6,654,9199,9853
6064,Rockport,Essex County,MA,Rockport,1990,6.9,281,3778,4059
6065,Rockport,Essex County,MA,Rockport,1991,9.1,367,3672,4039
6066,Rockport,Essex County,MA,Rockport,1992,10,408,3688,4096
6067,Rockport,Essex County,MA,Rockport,1993,8.3,345,3796,4141
6068,Rockport,Essex County,MA,Rockport,1994,6.6,275,3876,4151
6069,Rockport,Essex County,MA,Rockport,1995,5.9,236,3760,3996
6070,Rockport,Essex County,MA,Rockport,1996,5.1,207,3839,4046
6071,Rockport,Essex County,MA,Rockport,1997,4.4,180,3935,4115
6072,Rockport,Essex County,MA,Rockport,1998,3.9,165,4016,4181
6073,Rockport,Essex County,MA,Rockport,1999,3.3,137,4059,4196
6074,Rockport,Essex County,MA,Rockport,2000,2.9,124,4094,4218
6075,Rockport,Essex County,MA,Rockport,2001,4.1,175,4096,4271
6076,Rockport,Essex County,MA,Rockport,2002,5.1,219,4036,4255
6077,Rockport,Essex County,MA,Rockport,2003,5.9,247,3973,4220
6078,Rockport,Essex County,MA,Rockport,2004,5.3,223,3953,4176
6079,Rockport,Essex County,MA,Rockport,2005,4.7,195,3976,4171
6080,Rockport,Essex County,MA,Rockport,2006,4.7,190,3850,4040
6081,Rockport,Essex County,MA,Rockport,2007,4.3,172,3870,4042
6082,Rockport,Essex County,MA,Rockport,2008,5.3,218,3870,4088
6083,Rockport,Essex County,MA,Rockport,2009,7.7,313,3750,4063
6084,Rockport,Essex County,MA,Rockport,2010,8.4,317,3448,3765
6085,Rockport,Essex County,MA,Rockport,2011,7.6,287,3490,3777
6086,Rockport,Essex County,MA,Rockport,2012,6.2,235,3529,3764
6087,Rowe,Franklin County,MA,Rowe,1990,10.6,18,152,170
6088,Rowe,Franklin County,MA,Rowe,1991,7.5,12,149,161
6089,Rowe,Franklin County,MA,Rowe,1992,10.7,18,150,168
6090,Rowe,Franklin County,MA,Rowe,1993,12.1,21,152,173
6091,Rowe,Franklin County,MA,Rowe,1994,10.7,19,159,178
6092,Rowe,Franklin County,MA,Rowe,1995,7.2,12,155,167
6093,Rowe,Franklin County,MA,Rowe,1996,6.6,11,155,166
6094,Rowe,Franklin County,MA,Rowe,1997,4.8,8,158,166
6095,Rowe,Franklin County,MA,Rowe,1998,5.9,10,160,170
6096,Rowe,Franklin County,MA,Rowe,1999,4.1,7,163,170
6097,Rowe,Franklin County,MA,Rowe,2000,4.2,8,182,190
6098,Rowe,Franklin County,MA,Rowe,2001,3.2,6,180,186
6099,Rowe,Franklin County,MA,Rowe,2002,4.7,9,182,191
6100,Rowe,Franklin County,MA,Rowe,2003,6.7,13,182,195
6101,Rowe,Franklin County,MA,Rowe,2004,5.3,10,178,188
6102,Rowe,Franklin County,MA,Rowe,2005,5.8,11,178,189
6103,Rowe,Franklin County,MA,Rowe,2006,5.2,10,181,191
6104,Rowe,Franklin County,MA,Rowe,2007,5.9,11,177,188
6105,Rowe,Franklin County,MA,Rowe,2008,4.4,8,175,183
6106,Rowe,Franklin County,MA,Rowe,2009,8.6,16,169,185
6107,Rowe,Franklin County,MA,Rowe,2010,7.6,16,194,210
6108,Rowe,Franklin County,MA,Rowe,2011,6.7,14,195,209
6109,Rowe,Franklin County,MA,Rowe,2012,5.3,11,196,207
6110,Rowley,Essex County,MA,Rowley,1990,7.1,190,2480,2670
6111,Rowley,Essex County,MA,Rowley,1991,7.1,191,2488,2679
6112,Rowley,Essex County,MA,Rowley,1992,6.9,190,2574,2764
6113,Rowley,Essex County,MA,Rowley,1993,4.4,125,2705,2830
6114,Rowley,Essex County,MA,Rowley,1994,4.2,122,2801,2923
6115,Rowley,Essex County,MA,Rowley,1995,3.7,108,2816,2924
6116,Rowley,Essex County,MA,Rowley,1996,3.5,105,2892,2997
6117,Rowley,Essex County,MA,Rowley,1997,3.3,103,2990,3093
6118,Rowley,Essex County,MA,Rowley,1998,2.4,76,3075,3151
6119,Rowley,Essex County,MA,Rowley,1999,2.1,67,3173,3240
6120,Rowley,Essex County,MA,Rowley,2000,1.8,59,3139,3198
6121,Rowley,Essex County,MA,Rowley,2001,2.8,90,3152,3242
6122,Rowley,Essex County,MA,Rowley,2002,4.7,154,3113,3267
6123,Rowley,Essex County,MA,Rowley,2003,4.9,160,3085,3245
6124,Rowley,Essex County,MA,Rowley,2004,4.3,140,3134,3274
6125,Rowley,Essex County,MA,Rowley,2005,4.3,145,3239,3384
6126,Rowley,Essex County,MA,Rowley,2006,4.1,134,3128,3262
6127,Rowley,Essex County,MA,Rowley,2007,3.8,123,3148,3271
6128,Rowley,Essex County,MA,Rowley,2008,4.5,150,3150,3300
6129,Rowley,Essex County,MA,Rowley,2009,7.3,244,3080,3324
6130,Rowley,Essex County,MA,Rowley,2010,7.3,249,3143,3392
6131,Rowley,Essex County,MA,Rowley,2011,6.8,232,3182,3414
6132,Rowley,Essex County,MA,Rowley,2012,5.5,187,3217,3404
6133,Royalston,Worcester County,MA,Royalston,1990,5.1,27,507,534
6134,Royalston,Worcester County,MA,Royalston,1991,10.1,57,506,563
6135,Royalston,Worcester County,MA,Royalston,1992,5.9,31,495,526
6136,Royalston,Worcester County,MA,Royalston,1993,7.9,43,498,541
6137,Royalston,Worcester County,MA,Royalston,1994,7.8,42,494,536
6138,Royalston,Worcester County,MA,Royalston,1995,5.5,29,496,525
6139,Royalston,Worcester County,MA,Royalston,1996,5.2,27,491,518
6140,Royalston,Worcester County,MA,Royalston,1997,4.4,23,503,526
6141,Royalston,Worcester County,MA,Royalston,1998,4.5,22,470,492
6142,Royalston,Worcester County,MA,Royalston,1999,4.3,21,473,494
6143,Royalston,Worcester County,MA,Royalston,2000,2.5,16,614,630
6144,Royalston,Worcester County,MA,Royalston,2001,4.2,27,611,638
6145,Royalston,Worcester County,MA,Royalston,2002,6.5,43,616,659
6146,Royalston,Worcester County,MA,Royalston,2003,7,46,615,661
6147,Royalston,Worcester County,MA,Royalston,2004,6.4,43,626,669
6148,Royalston,Worcester County,MA,Royalston,2005,6,40,625,665
6149,Royalston,Worcester County,MA,Royalston,2006,6.1,41,636,677
6150,Royalston,Worcester County,MA,Royalston,2007,5.5,37,638,675
6151,Royalston,Worcester County,MA,Royalston,2008,7.2,49,628,677
6152,Royalston,Worcester County,MA,Royalston,2009,9.9,64,583,647
6153,Royalston,Worcester County,MA,Royalston,2010,10.4,64,554,618
6154,Royalston,Worcester County,MA,Royalston,2011,10.2,63,554,617
6155,Royalston,Worcester County,MA,Royalston,2012,8.4,51,553,604
6156,Russell,Hampden County,MA,Russell,1990,4.7,41,830,871
6157,Russell,Hampden County,MA,Russell,1991,8.4,73,800,873
6158,Russell,Hampden County,MA,Russell,1992,8.1,73,823,896
6159,Russell,Hampden County,MA,Russell,1993,7.3,65,827,892
6160,Russell,Hampden County,MA,Russell,1994,7.8,71,839,910
6161,Russell,Hampden County,MA,Russell,1995,7.3,64,814,878
6162,Russell,Hampden County,MA,Russell,1996,4.5,39,824,863
6163,Russell,Hampden County,MA,Russell,1997,3.3,29,848,877
6164,Russell,Hampden County,MA,Russell,1998,2.7,24,855,879
6165,Russell,Hampden County,MA,Russell,1999,4.1,37,859,896
6166,Russell,Hampden County,MA,Russell,2000,2.8,26,905,931
6167,Russell,Hampden County,MA,Russell,2001,4,38,909,947
6168,Russell,Hampden County,MA,Russell,2002,5.2,50,912,962
6169,Russell,Hampden County,MA,Russell,2003,5.4,52,911,963
6170,Russell,Hampden County,MA,Russell,2004,4.9,47,918,965
6171,Russell,Hampden County,MA,Russell,2005,5,49,929,978
6172,Russell,Hampden County,MA,Russell,2006,5.5,55,942,997
6173,Russell,Hampden County,MA,Russell,2007,5.1,50,940,990
6174,Russell,Hampden County,MA,Russell,2008,5.7,56,926,982
6175,Russell,Hampden County,MA,Russell,2009,8,79,909,988
6176,Russell,Hampden County,MA,Russell,2010,8.6,86,915,1001
6177,Russell,Hampden County,MA,Russell,2011,7.2,70,905,975
6178,Russell,Hampden County,MA,Russell,2012,6.7,65,906,971
6179,Rutland,Worcester County,MA,Rutland,1990,4.7,131,2647,2778
6180,Rutland,Worcester County,MA,Rutland,1991,8.5,244,2610,2854
6181,Rutland,Worcester County,MA,Rutland,1992,8.7,253,2639,2892
6182,Rutland,Worcester County,MA,Rutland,1993,6.3,187,2786,2973
6183,Rutland,Worcester County,MA,Rutland,1994,4.6,139,2903,3042
6184,Rutland,Worcester County,MA,Rutland,1995,4.5,129,2726,2855
6185,Rutland,Worcester County,MA,Rutland,1996,3.8,111,2794,2905
6186,Rutland,Worcester County,MA,Rutland,1997,3.1,94,2916,3010
6187,Rutland,Worcester County,MA,Rutland,1998,3.1,96,3028,3124
6188,Rutland,Worcester County,MA,Rutland,1999,2.7,85,3098,3183
6189,Rutland,Worcester County,MA,Rutland,2000,2.5,90,3514,3604
6190,Rutland,Worcester County,MA,Rutland,2001,3,110,3577,3687
6191,Rutland,Worcester County,MA,Rutland,2002,4.7,181,3658,3839
6192,Rutland,Worcester County,MA,Rutland,2003,5.1,200,3745,3945
6193,Rutland,Worcester County,MA,Rutland,2004,4.7,188,3847,4035
6194,Rutland,Worcester County,MA,Rutland,2005,4,163,3942,4105
6195,Rutland,Worcester County,MA,Rutland,2006,3.7,156,4055,4211
6196,Rutland,Worcester County,MA,Rutland,2007,4.1,182,4205,4387
6197,Rutland,Worcester County,MA,Rutland,2008,4.5,197,4171,4368
6198,Rutland,Worcester County,MA,Rutland,2009,7.7,342,4087,4429
6199,Rutland,Worcester County,MA,Rutland,2010,7.4,321,4040,4361
6200,Rutland,Worcester County,MA,Rutland,2011,6.7,291,4077,4368
6201,Rutland,Worcester County,MA,Rutland,2012,6.5,285,4076,4361
6202,Salem,Essex County,MA,Salem,1990,6.1,1295,19877,21172
6203,Salem,Essex County,MA,Salem,1991,8.7,1820,19163,20983
6204,Salem,Essex County,MA,Salem,1992,9.9,2062,18858,20920
6205,Salem,Essex County,MA,Salem,1993,7.1,1443,18981,20424
6206,Salem,Essex County,MA,Salem,1994,5.7,1170,19180,20350
6207,Salem,Essex County,MA,Salem,1995,5.3,1107,19597,20704
6208,Salem,Essex County,MA,Salem,1996,4.6,956,19952,20908
6209,Salem,Essex County,MA,Salem,1997,4.1,872,20507,21379
6210,Salem,Essex County,MA,Salem,1998,3.6,771,20843,21614
6211,Salem,Essex County,MA,Salem,1999,3.4,747,20992,21739
6212,Salem,Essex County,MA,Salem,2000,2.5,588,22477,23065
6213,Salem,Essex County,MA,Salem,2001,3.6,860,22726,23586
6214,Salem,Essex County,MA,Salem,2002,5.2,1270,23007,24277
6215,Salem,Essex County,MA,Salem,2003,5.9,1431,22716,24147
6216,Salem,Essex County,MA,Salem,2004,5.5,1307,22432,23739
6217,Salem,Essex County,MA,Salem,2005,4.9,1144,22389,23533
6218,Salem,Essex County,MA,Salem,2006,4.7,1115,22435,23550
6219,Salem,Essex County,MA,Salem,2007,4.5,1048,22289,23337
6220,Salem,Essex County,MA,Salem,2008,5.3,1251,22502,23753
6221,Salem,Essex County,MA,Salem,2009,8.1,1940,21889,23829
6222,Salem,Essex County,MA,Salem,2010,8.1,1931,21920,23851
6223,Salem,Essex County,MA,Salem,2011,7.1,1702,22168,23870
6224,Salem,Essex County,MA,Salem,2012,6.6,1575,22339,23914
6225,Salisbury,Essex County,MA,Salisbury,1990,7.6,286,3472,3758
6226,Salisbury,Essex County,MA,Salisbury,1991,10.4,392,3387,3779
6227,Salisbury,Essex County,MA,Salisbury,1992,9.2,342,3378,3720
6228,Salisbury,Essex County,MA,Salisbury,1993,9.2,348,3431,3779
6229,Salisbury,Essex County,MA,Salisbury,1994,7.2,272,3481,3753
6230,Salisbury,Essex County,MA,Salisbury,1995,6.3,236,3508,3744
6231,Salisbury,Essex County,MA,Salisbury,1996,5,190,3599,3789
6232,Salisbury,Essex County,MA,Salisbury,1997,4.5,173,3714,3887
6233,Salisbury,Essex County,MA,Salisbury,1998,4.4,176,3797,3973
6234,Salisbury,Essex County,MA,Salisbury,1999,4.3,173,3850,4023
6235,Salisbury,Essex County,MA,Salisbury,2000,3,132,4212,4344
6236,Salisbury,Essex County,MA,Salisbury,2001,4.5,196,4192,4388
6237,Salisbury,Essex County,MA,Salisbury,2002,6.4,277,4076,4353
6238,Salisbury,Essex County,MA,Salisbury,2003,6.6,284,4001,4285
6239,Salisbury,Essex County,MA,Salisbury,2004,6.3,269,4021,4290
6240,Salisbury,Essex County,MA,Salisbury,2005,5.7,250,4117,4367
6241,Salisbury,Essex County,MA,Salisbury,2006,5.5,244,4232,4476
6242,Salisbury,Essex County,MA,Salisbury,2007,4.6,206,4280,4486
6243,Salisbury,Essex County,MA,Salisbury,2008,6,264,4165,4429
6244,Salisbury,Essex County,MA,Salisbury,2009,8.6,388,4128,4516
6245,Salisbury,Essex County,MA,Salisbury,2010,10.1,456,4064,4520
6246,Salisbury,Essex County,MA,Salisbury,2011,8,357,4116,4473
6247,Salisbury,Essex County,MA,Salisbury,2012,6.8,305,4170,4475
6248,Sandisfield,Berkshire County,MA,Sandisfield,1990,5.7,16,264,280
6249,Sandisfield,Berkshire County,MA,Sandisfield,1991,10.2,30,265,295
6250,Sandisfield,Berkshire County,MA,Sandisfield,1992,10.5,32,274,306
6251,Sandisfield,Berkshire County,MA,Sandisfield,1993,12.3,40,284,324
6252,Sandisfield,Berkshire County,MA,Sandisfield,1994,10.4,35,301,336
6253,Sandisfield,Berkshire County,MA,Sandisfield,1995,7.8,24,283,307
6254,Sandisfield,Berkshire County,MA,Sandisfield,1996,6.8,21,289,310
6255,Sandisfield,Berkshire County,MA,Sandisfield,1997,6.6,21,295,316
6256,Sandisfield,Berkshire County,MA,Sandisfield,1998,3,9,294,303
6257,Sandisfield,Berkshire County,MA,Sandisfield,1999,4.2,13,293,306
6258,Sandisfield,Berkshire County,MA,Sandisfield,2000,2.5,11,436,447
6259,Sandisfield,Berkshire County,MA,Sandisfield,2001,3.2,15,451,466
6260,Sandisfield,Berkshire County,MA,Sandisfield,2002,4.7,23,465,488
6261,Sandisfield,Berkshire County,MA,Sandisfield,2003,5.1,25,465,490
6262,Sandisfield,Berkshire County,MA,Sandisfield,2004,5.5,27,464,491
6263,Sandisfield,Berkshire County,MA,Sandisfield,2005,3.8,19,476,495
6264,Sandisfield,Berkshire County,MA,Sandisfield,2006,4,20,485,505
6265,Sandisfield,Berkshire County,MA,Sandisfield,2007,3,15,477,492
6266,Sandisfield,Berkshire County,MA,Sandisfield,2008,4.5,23,485,508
6267,Sandisfield,Berkshire County,MA,Sandisfield,2009,7.1,36,471,507
6268,Sandisfield,Berkshire County,MA,Sandisfield,2010,7.6,42,512,554
6269,Sandisfield,Berkshire County,MA,Sandisfield,2011,6.5,36,516,552
6270,Sandisfield,Berkshire County,MA,Sandisfield,2012,5.5,30,512,542
6271,Sandwich,Barnstable County,MA,Sandwich,1990,4.7,391,7970,8361
6272,Sandwich,Barnstable County,MA,Sandwich,1991,8,684,7873,8557
6273,Sandwich,Barnstable County,MA,Sandwich,1992,8.3,722,7988,8710
6274,Sandwich,Barnstable County,MA,Sandwich,1993,7.1,635,8350,8985
6275,Sandwich,Barnstable County,MA,Sandwich,1994,6,553,8708,9261
6276,Sandwich,Barnstable County,MA,Sandwich,1995,5.5,509,8769,9278
6277,Sandwich,Barnstable County,MA,Sandwich,1996,4.2,394,9068,9462
6278,Sandwich,Barnstable County,MA,Sandwich,1997,4.2,407,9258,9665
6279,Sandwich,Barnstable County,MA,Sandwich,1998,3.2,316,9506,9822
6280,Sandwich,Barnstable County,MA,Sandwich,1999,2.8,289,9963,10252
6281,Sandwich,Barnstable County,MA,Sandwich,2000,2.4,260,10503,10763
6282,Sandwich,Barnstable County,MA,Sandwich,2001,3,329,10648,10977
6283,Sandwich,Barnstable County,MA,Sandwich,2002,3.8,427,10870,11297
6284,Sandwich,Barnstable County,MA,Sandwich,2003,4.3,496,11133,11629
6285,Sandwich,Barnstable County,MA,Sandwich,2004,4.2,492,11219,11711
6286,Sandwich,Barnstable County,MA,Sandwich,2005,3.8,441,11231,11672
6287,Sandwich,Barnstable County,MA,Sandwich,2006,4.1,485,11220,11705
6288,Sandwich,Barnstable County,MA,Sandwich,2007,4,462,11146,11608
6289,Sandwich,Barnstable County,MA,Sandwich,2008,5,585,11063,11648
6290,Sandwich,Barnstable County,MA,Sandwich,2009,7.5,867,10664,11531
6291,Sandwich,Barnstable County,MA,Sandwich,2010,7.3,887,11203,12090
6292,Sandwich,Barnstable County,MA,Sandwich,2011,6.7,798,11185,11983
6293,Sandwich,Barnstable County,MA,Sandwich,2012,6.1,739,11373,12112
6294,Saugus,Essex County,MA,Saugus,1990,5.8,832,13445,14277
6295,Saugus,Essex County,MA,Saugus,1991,8.6,1222,13008,14230
6296,Saugus,Essex County,MA,Saugus,1992,9.4,1335,12894,14229
6297,Saugus,Essex County,MA,Saugus,1993,6.4,893,13085,13978
6298,Saugus,Essex County,MA,Saugus,1994,5.9,831,13354,14185
6299,Saugus,Essex County,MA,Saugus,1995,5,718,13564,14282
6300,Saugus,Essex County,MA,Saugus,1996,4.1,589,13849,14438
6301,Saugus,Essex County,MA,Saugus,1997,3.7,550,14239,14789
6302,Saugus,Essex County,MA,Saugus,1998,3,457,14604,15061
6303,Saugus,Essex County,MA,Saugus,1999,3.2,492,14764,15256
6304,Saugus,Essex County,MA,Saugus,2000,2.6,371,13925,14296
6305,Saugus,Essex County,MA,Saugus,2001,3.3,476,13965,14441
6306,Saugus,Essex County,MA,Saugus,2002,5,721,13786,14507
6307,Saugus,Essex County,MA,Saugus,2003,6.1,881,13610,14491
6308,Saugus,Essex County,MA,Saugus,2004,5.7,830,13722,14552
6309,Saugus,Essex County,MA,Saugus,2005,5,736,13957,14693
6310,Saugus,Essex County,MA,Saugus,2006,5.1,735,13697,14432
6311,Saugus,Essex County,MA,Saugus,2007,4.6,676,13917,14593
6312,Saugus,Essex County,MA,Saugus,2008,5.3,788,14082,14870
6313,Saugus,Essex County,MA,Saugus,2009,8.3,1259,13826,15085
6314,Saugus,Essex County,MA,Saugus,2010,8.3,1205,13375,14580
6315,Saugus,Essex County,MA,Saugus,2011,7,1024,13537,14561
6316,Saugus,Essex County,MA,Saugus,2012,6.4,928,13685,14613
6317,Savoy,Berkshire County,MA,Savoy,1990,19.3,81,339,420
6318,Savoy,Berkshire County,MA,Savoy,1991,18.9,78,335,413
6319,Savoy,Berkshire County,MA,Savoy,1992,14,56,343,399
6320,Savoy,Berkshire County,MA,Savoy,1993,11,48,389,437
6321,Savoy,Berkshire County,MA,Savoy,1994,8.3,36,399,435
6322,Savoy,Berkshire County,MA,Savoy,1995,7.7,30,359,389
6323,Savoy,Berkshire County,MA,Savoy,1996,6.1,24,369,393
6324,Savoy,Berkshire County,MA,Savoy,1997,6.7,27,377,404
6325,Savoy,Berkshire County,MA,Savoy,1998,6.1,25,384,409
6326,Savoy,Berkshire County,MA,Savoy,1999,5.8,24,391,415
6327,Savoy,Berkshire County,MA,Savoy,2000,4.1,16,373,389
6328,Savoy,Berkshire County,MA,Savoy,2001,4.8,19,374,393
6329,Savoy,Berkshire County,MA,Savoy,2002,6.1,25,383,408
6330,Savoy,Berkshire County,MA,Savoy,2003,7.7,32,384,416
6331,Savoy,Berkshire County,MA,Savoy,2004,5.6,23,388,411
6332,Savoy,Berkshire County,MA,Savoy,2005,5.7,24,397,421
6333,Savoy,Berkshire County,MA,Savoy,2006,4.9,21,408,429
6334,Savoy,Berkshire County,MA,Savoy,2007,4.9,21,404,425
6335,Savoy,Berkshire County,MA,Savoy,2008,5.9,25,402,427
6336,Savoy,Berkshire County,MA,Savoy,2009,9.1,39,390,429
6337,Savoy,Berkshire County,MA,Savoy,2010,10.6,43,361,404
6338,Savoy,Berkshire County,MA,Savoy,2011,8.5,34,364,398
6339,Savoy,Berkshire County,MA,Savoy,2012,9.7,39,363,402
6340,Scituate,Plymouth County,MA,Scituate,1990,4.4,404,8697,9101
6341,Scituate,Plymouth County,MA,Scituate,1991,6.5,581,8412,8993
6342,Scituate,Plymouth County,MA,Scituate,1992,6.9,620,8358,8978
6343,Scituate,Plymouth County,MA,Scituate,1993,5.6,508,8577,9085
6344,Scituate,Plymouth County,MA,Scituate,1994,4.5,410,8744,9154
6345,Scituate,Plymouth County,MA,Scituate,1995,3.9,359,8756,9115
6346,Scituate,Plymouth County,MA,Scituate,1996,3.5,322,8984,9306
6347,Scituate,Plymouth County,MA,Scituate,1997,3.1,293,9279,9572
6348,Scituate,Plymouth County,MA,Scituate,1998,2.6,255,9462,9717
6349,Scituate,Plymouth County,MA,Scituate,1999,2.3,223,9608,9831
6350,Scituate,Plymouth County,MA,Scituate,2000,2.2,208,9311,9519
6351,Scituate,Plymouth County,MA,Scituate,2001,2.9,278,9318,9596
6352,Scituate,Plymouth County,MA,Scituate,2002,4.1,397,9231,9628
6353,Scituate,Plymouth County,MA,Scituate,2003,4.3,410,9127,9537
6354,Scituate,Plymouth County,MA,Scituate,2004,4.2,400,9117,9517
6355,Scituate,Plymouth County,MA,Scituate,2005,3.9,373,9176,9549
6356,Scituate,Plymouth County,MA,Scituate,2006,3.8,362,9083,9445
6357,Scituate,Plymouth County,MA,Scituate,2007,3.8,363,9168,9531
6358,Scituate,Plymouth County,MA,Scituate,2008,4.3,412,9128,9540
6359,Scituate,Plymouth County,MA,Scituate,2009,6.8,648,8840,9488
6360,Scituate,Plymouth County,MA,Scituate,2010,6.9,661,8893,9554
6361,Scituate,Plymouth County,MA,Scituate,2011,5.7,542,8981,9523
6362,Scituate,Plymouth County,MA,Scituate,2012,5.3,512,9080,9592
6363,Seekonk,Bristol County,MA,Seekonk,1990,6.3,463,6891,7354
6364,Seekonk,Bristol County,MA,Seekonk,1991,9.6,697,6590,7287
6365,Seekonk,Bristol County,MA,Seekonk,1992,10.5,781,6637,7418
6366,Seekonk,Bristol County,MA,Seekonk,1993,8.5,627,6780,7407
6367,Seekonk,Bristol County,MA,Seekonk,1994,8,603,6909,7512
6368,Seekonk,Bristol County,MA,Seekonk,1995,6.7,507,7019,7526
6369,Seekonk,Bristol County,MA,Seekonk,1996,5.9,439,7060,7499
6370,Seekonk,Bristol County,MA,Seekonk,1997,4.8,360,7200,7560
6371,Seekonk,Bristol County,MA,Seekonk,1998,3.8,293,7338,7631
6372,Seekonk,Bristol County,MA,Seekonk,1999,3.1,238,7389,7627
6373,Seekonk,Bristol County,MA,Seekonk,2000,3.3,245,7119,7364
6374,Seekonk,Bristol County,MA,Seekonk,2001,4.2,314,7080,7394
6375,Seekonk,Bristol County,MA,Seekonk,2002,5.1,386,7149,7535
6376,Seekonk,Bristol County,MA,Seekonk,2003,5.2,399,7214,7613
6377,Seekonk,Bristol County,MA,Seekonk,2004,5.2,395,7207,7602
6378,Seekonk,Bristol County,MA,Seekonk,2005,5,380,7225,7605
6379,Seekonk,Bristol County,MA,Seekonk,2006,5.2,399,7290,7689
6380,Seekonk,Bristol County,MA,Seekonk,2007,4.8,365,7280,7645
6381,Seekonk,Bristol County,MA,Seekonk,2008,6.3,479,7162,7641
6382,Seekonk,Bristol County,MA,Seekonk,2009,10.3,793,6925,7718
6383,Seekonk,Bristol County,MA,Seekonk,2010,10.3,786,6880,7666
6384,Seekonk,Bristol County,MA,Seekonk,2011,9.5,725,6931,7656
6385,Seekonk,Bristol County,MA,Seekonk,2012,8.5,646,6942,7588
6386,Sharon,Norfolk County,MA,Sharon,1990,4.4,385,8334,8719
6387,Sharon,Norfolk County,MA,Sharon,1991,5.9,508,8072,8580
6388,Sharon,Norfolk County,MA,Sharon,1992,5.8,499,8128,8627
6389,Sharon,Norfolk County,MA,Sharon,1993,4.9,433,8375,8808
6390,Sharon,Norfolk County,MA,Sharon,1994,4.5,406,8698,9104
6391,Sharon,Norfolk County,MA,Sharon,1995,3.6,331,8775,9106
6392,Sharon,Norfolk County,MA,Sharon,1996,3.2,302,9004,9306
6393,Sharon,Norfolk County,MA,Sharon,1997,2.6,252,9275,9527
6394,Sharon,Norfolk County,MA,Sharon,1998,1.9,187,9442,9629
6395,Sharon,Norfolk County,MA,Sharon,1999,2.2,213,9532,9745
6396,Sharon,Norfolk County,MA,Sharon,2000,2.2,207,9212,9419
6397,Sharon,Norfolk County,MA,Sharon,2001,2.9,279,9205,9484
6398,Sharon,Norfolk County,MA,Sharon,2002,4.4,417,9044,9461
6399,Sharon,Norfolk County,MA,Sharon,2003,4.1,376,8882,9258
6400,Sharon,Norfolk County,MA,Sharon,2004,3.8,347,8833,9180
6401,Sharon,Norfolk County,MA,Sharon,2005,3.4,315,8852,9167
6402,Sharon,Norfolk County,MA,Sharon,2006,3.5,315,8690,9005
6403,Sharon,Norfolk County,MA,Sharon,2007,3.5,316,8742,9058
6404,Sharon,Norfolk County,MA,Sharon,2008,4.2,394,8947,9341
6405,Sharon,Norfolk County,MA,Sharon,2009,6.5,617,8853,9470
6406,Sharon,Norfolk County,MA,Sharon,2010,6.1,573,8775,9348
6407,Sharon,Norfolk County,MA,Sharon,2011,5.5,513,8875,9388
6408,Sharon,Norfolk County,MA,Sharon,2012,4.9,463,8972,9435
6409,Sheffield,Berkshire County,MA,Sheffield,1990,4.8,75,1474,1549
6410,Sheffield,Berkshire County,MA,Sheffield,1991,6.9,108,1467,1575
6411,Sheffield,Berkshire County,MA,Sheffield,1992,8,128,1463,1591
6412,Sheffield,Berkshire County,MA,Sheffield,1993,6.9,115,1545,1660
6413,Sheffield,Berkshire County,MA,Sheffield,1994,5.3,89,1586,1675
6414,Sheffield,Berkshire County,MA,Sheffield,1995,4.6,77,1615,1692
6415,Sheffield,Berkshire County,MA,Sheffield,1996,3.6,62,1656,1718
6416,Sheffield,Berkshire County,MA,Sheffield,1997,3.4,60,1698,1758
6417,Sheffield,Berkshire County,MA,Sheffield,1998,2.4,42,1697,1739
6418,Sheffield,Berkshire County,MA,Sheffield,1999,2.2,39,1695,1734
6419,Sheffield,Berkshire County,MA,Sheffield,2000,2.2,42,1847,1889
6420,Sheffield,Berkshire County,MA,Sheffield,2001,2.2,43,1911,1954
6421,Sheffield,Berkshire County,MA,Sheffield,2002,2.9,58,1971,2029
6422,Sheffield,Berkshire County,MA,Sheffield,2003,3.7,76,1989,2065
6423,Sheffield,Berkshire County,MA,Sheffield,2004,3.2,65,1977,2042
6424,Sheffield,Berkshire County,MA,Sheffield,2005,3,62,2019,2081
6425,Sheffield,Berkshire County,MA,Sheffield,2006,3.7,78,2037,2115
6426,Sheffield,Berkshire County,MA,Sheffield,2007,3.7,76,1989,2065
6427,Sheffield,Berkshire County,MA,Sheffield,2008,3.7,76,1979,2055
6428,Sheffield,Berkshire County,MA,Sheffield,2009,6.7,138,1917,2055
6429,Sheffield,Berkshire County,MA,Sheffield,2010,6,122,1910,2032
6430,Sheffield,Berkshire County,MA,Sheffield,2011,5.4,110,1919,2029
6431,Sheffield,Berkshire County,MA,Sheffield,2012,5.2,105,1903,2008
6432,Shelburne,Franklin County,MA,Shelburne,1990,9.1,100,996,1096
6433,Shelburne,Franklin County,MA,Shelburne,1991,12.8,144,977,1121
6434,Shelburne,Franklin County,MA,Shelburne,1992,13.1,142,938,1080
6435,Shelburne,Franklin County,MA,Shelburne,1993,11.1,115,920,1035
6436,Shelburne,Franklin County,MA,Shelburne,1994,9.5,97,925,1022
6437,Shelburne,Franklin County,MA,Shelburne,1995,8.5,94,1009,1103
6438,Shelburne,Franklin County,MA,Shelburne,1996,7.5,82,1012,1094
6439,Shelburne,Franklin County,MA,Shelburne,1997,8.4,95,1035,1130
6440,Shelburne,Franklin County,MA,Shelburne,1998,5.1,57,1055,1112
6441,Shelburne,Franklin County,MA,Shelburne,1999,4.7,53,1072,1125
6442,Shelburne,Franklin County,MA,Shelburne,2000,4.1,45,1062,1107
6443,Shelburne,Franklin County,MA,Shelburne,2001,4.7,52,1061,1113
6444,Shelburne,Franklin County,MA,Shelburne,2002,6.1,70,1074,1144
6445,Shelburne,Franklin County,MA,Shelburne,2003,6,69,1072,1141
6446,Shelburne,Franklin County,MA,Shelburne,2004,5.9,66,1051,1117
6447,Shelburne,Franklin County,MA,Shelburne,2005,5.5,61,1045,1106
6448,Shelburne,Franklin County,MA,Shelburne,2006,6.4,72,1047,1119
6449,Shelburne,Franklin County,MA,Shelburne,2007,5.1,56,1035,1091
6450,Shelburne,Franklin County,MA,Shelburne,2008,6.9,76,1018,1094
6451,Shelburne,Franklin County,MA,Shelburne,2009,10.4,115,987,1102
6452,Shelburne,Franklin County,MA,Shelburne,2010,11.4,120,937,1057
6453,Shelburne,Franklin County,MA,Shelburne,2011,9.6,100,938,1038
6454,Shelburne,Franklin County,MA,Shelburne,2012,8.2,84,941,1025
6455,Sherborn,Middlesex County,MA,Sherborn,1990,2.7,58,2067,2125
6456,Sherborn,Middlesex County,MA,Sherborn,1991,4.3,91,2001,2092
6457,Sherborn,Middlesex County,MA,Sherborn,1992,3.5,73,2028,2101
6458,Sherborn,Middlesex County,MA,Sherborn,1993,3.3,70,2078,2148
6459,Sherborn,Middlesex County,MA,Sherborn,1994,2.6,57,2109,2166
6460,Sherborn,Middlesex County,MA,Sherborn,1995,2.6,55,2083,2138
6461,Sherborn,Middlesex County,MA,Sherborn,1996,2.2,49,2138,2187
6462,Sherborn,Middlesex County,MA,Sherborn,1997,1.9,42,2196,2238
6463,Sherborn,Middlesex County,MA,Sherborn,1998,1.5,34,2234,2268
6464,Sherborn,Middlesex County,MA,Sherborn,1999,1.5,34,2254,2288
6465,Sherborn,Middlesex County,MA,Sherborn,2000,1.9,38,1934,1972
6466,Sherborn,Middlesex County,MA,Sherborn,2001,2.9,57,1928,1985
6467,Sherborn,Middlesex County,MA,Sherborn,2002,4.1,80,1891,1971
6468,Sherborn,Middlesex County,MA,Sherborn,2003,4.5,89,1884,1973
6469,Sherborn,Middlesex County,MA,Sherborn,2004,3.9,76,1874,1950
6470,Sherborn,Middlesex County,MA,Sherborn,2005,3.6,70,1891,1961
6471,Sherborn,Middlesex County,MA,Sherborn,2006,3.3,63,1863,1926
6472,Sherborn,Middlesex County,MA,Sherborn,2007,3.1,60,1877,1937
6473,Sherborn,Middlesex County,MA,Sherborn,2008,3.5,68,1875,1943
6474,Sherborn,Middlesex County,MA,Sherborn,2009,6.1,119,1832,1951
6475,Sherborn,Middlesex County,MA,Sherborn,2010,6,114,1786,1900
6476,Sherborn,Middlesex County,MA,Sherborn,2011,4.6,88,1813,1901
6477,Sherborn,Middlesex County,MA,Sherborn,2012,4,77,1832,1909
6478,Shirley,Middlesex County,MA,Shirley,1990,6.2,183,2776,2959
6479,Shirley,Middlesex County,MA,Shirley,1991,8,236,2702,2938
6480,Shirley,Middlesex County,MA,Shirley,1992,6.8,226,3084,3310
6481,Shirley,Middlesex County,MA,Shirley,1993,5.8,191,3128,3319
6482,Shirley,Middlesex County,MA,Shirley,1994,5.1,172,3168,3340
6483,Shirley,Middlesex County,MA,Shirley,1995,4.5,157,3321,3478
6484,Shirley,Middlesex County,MA,Shirley,1996,3.8,133,3397,3530
6485,Shirley,Middlesex County,MA,Shirley,1997,2.9,106,3510,3616
6486,Shirley,Middlesex County,MA,Shirley,1998,2.7,96,3429,3525
6487,Shirley,Middlesex County,MA,Shirley,1999,2.9,104,3510,3614
6488,Shirley,Middlesex County,MA,Shirley,2000,2.3,83,3517,3600
6489,Shirley,Middlesex County,MA,Shirley,2001,3.7,136,3545,3681
6490,Shirley,Middlesex County,MA,Shirley,2002,5.4,193,3399,3592
6491,Shirley,Middlesex County,MA,Shirley,2003,5.9,210,3365,3575
6492,Shirley,Middlesex County,MA,Shirley,2004,4.7,167,3368,3535
6493,Shirley,Middlesex County,MA,Shirley,2005,4.6,166,3415,3581
6494,Shirley,Middlesex County,MA,Shirley,2006,5,179,3431,3610
6495,Shirley,Middlesex County,MA,Shirley,2007,4.8,177,3526,3703
6496,Shirley,Middlesex County,MA,Shirley,2008,5.3,202,3575,3777
6497,Shirley,Middlesex County,MA,Shirley,2009,8.1,306,3473,3779
6498,Shirley,Middlesex County,MA,Shirley,2010,8.3,285,3134,3419
6499,Shirley,Middlesex County,MA,Shirley,2011,7.1,244,3175,3419
6500,Shirley,Middlesex County,MA,Shirley,2012,7.1,247,3210,3457
6501,Shrewsbury,Worcester County,MA,Shrewsbury,1990,5.3,704,12653,13357
6502,Shrewsbury,Worcester County,MA,Shrewsbury,1991,7.6,1002,12257,13259
6503,Shrewsbury,Worcester County,MA,Shrewsbury,1992,7.5,1016,12491,13507
6504,Shrewsbury,Worcester County,MA,Shrewsbury,1993,5.9,818,13134,13952
6505,Shrewsbury,Worcester County,MA,Shrewsbury,1994,4.8,686,13654,14340
6506,Shrewsbury,Worcester County,MA,Shrewsbury,1995,4,582,13810,14392
6507,Shrewsbury,Worcester County,MA,Shrewsbury,1996,3.2,463,14159,14622
6508,Shrewsbury,Worcester County,MA,Shrewsbury,1997,2.8,428,14686,15114
6509,Shrewsbury,Worcester County,MA,Shrewsbury,1998,2.4,371,15156,15527
6510,Shrewsbury,Worcester County,MA,Shrewsbury,1999,2.6,416,15369,15785
6511,Shrewsbury,Worcester County,MA,Shrewsbury,2000,2.2,378,16439,16817
6512,Shrewsbury,Worcester County,MA,Shrewsbury,2001,3.2,542,16598,17140
6513,Shrewsbury,Worcester County,MA,Shrewsbury,2002,4.5,781,16564,17345
6514,Shrewsbury,Worcester County,MA,Shrewsbury,2003,4.9,860,16576,17436
6515,Shrewsbury,Worcester County,MA,Shrewsbury,2004,4.4,757,16576,17333
6516,Shrewsbury,Worcester County,MA,Shrewsbury,2005,3.9,677,16533,17210
6517,Shrewsbury,Worcester County,MA,Shrewsbury,2006,3.8,666,16936,17602
6518,Shrewsbury,Worcester County,MA,Shrewsbury,2007,3.7,655,16950,17605
6519,Shrewsbury,Worcester County,MA,Shrewsbury,2008,4.4,773,16617,17390
6520,Shrewsbury,Worcester County,MA,Shrewsbury,2009,7,1217,16150,17367
6521,Shrewsbury,Worcester County,MA,Shrewsbury,2010,7,1286,16987,18273
6522,Shrewsbury,Worcester County,MA,Shrewsbury,2011,6,1093,17138,18231
6523,Shrewsbury,Worcester County,MA,Shrewsbury,2012,5.6,1022,17132,18154
6524,Shutesbury,Franklin County,MA,Shutesbury,1990,2.7,24,876,900
6525,Shutesbury,Franklin County,MA,Shutesbury,1991,5.7,55,904,959
6526,Shutesbury,Franklin County,MA,Shutesbury,1992,5.7,54,888,942
6527,Shutesbury,Franklin County,MA,Shutesbury,1993,3.6,34,918,952
6528,Shutesbury,Franklin County,MA,Shutesbury,1994,3.2,31,934,965
6529,Shutesbury,Franklin County,MA,Shutesbury,1995,2.7,26,951,977
6530,Shutesbury,Franklin County,MA,Shutesbury,1996,3.2,32,961,993
6531,Shutesbury,Franklin County,MA,Shutesbury,1997,3.1,32,984,1016
6532,Shutesbury,Franklin County,MA,Shutesbury,1998,1.7,17,998,1015
6533,Shutesbury,Franklin County,MA,Shutesbury,1999,1.8,19,1020,1039
6534,Shutesbury,Franklin County,MA,Shutesbury,2000,2,21,1043,1064
6535,Shutesbury,Franklin County,MA,Shutesbury,2001,2.1,23,1072,1095
6536,Shutesbury,Franklin County,MA,Shutesbury,2002,2.8,31,1074,1105
6537,Shutesbury,Franklin County,MA,Shutesbury,2003,3.5,39,1087,1126
6538,Shutesbury,Franklin County,MA,Shutesbury,2004,3.3,38,1100,1138
6539,Shutesbury,Franklin County,MA,Shutesbury,2005,3,34,1102,1136
6540,Shutesbury,Franklin County,MA,Shutesbury,2006,3.2,37,1117,1154
6541,Shutesbury,Franklin County,MA,Shutesbury,2007,3,34,1113,1147
6542,Shutesbury,Franklin County,MA,Shutesbury,2008,3.9,44,1082,1126
6543,Shutesbury,Franklin County,MA,Shutesbury,2009,5.2,57,1045,1102
6544,Shutesbury,Franklin County,MA,Shutesbury,2010,5.9,62,981,1043
6545,Shutesbury,Franklin County,MA,Shutesbury,2011,4.8,50,991,1041
6546,Shutesbury,Franklin County,MA,Shutesbury,2012,4.6,48,1000,1048
6547,Somerset,Bristol County,MA,Somerset,1990,7.8,753,8944,9697
6548,Somerset,Bristol County,MA,Somerset,1991,10.7,1033,8584,9617
6549,Somerset,Bristol County,MA,Somerset,1992,10.7,1023,8574,9597
6550,Somerset,Bristol County,MA,Somerset,1993,10.3,1002,8707,9709
6551,Somerset,Bristol County,MA,Somerset,1994,8.1,773,8796,9569
6552,Somerset,Bristol County,MA,Somerset,1995,6.9,671,9027,9698
6553,Somerset,Bristol County,MA,Somerset,1996,6.8,664,9059,9723
6554,Somerset,Bristol County,MA,Somerset,1997,5.5,539,9205,9744
6555,Somerset,Bristol County,MA,Somerset,1998,4,383,9258,9641
6556,Somerset,Bristol County,MA,Somerset,1999,3.7,360,9382,9742
6557,Somerset,Bristol County,MA,Somerset,2000,3.5,340,9310,9650
6558,Somerset,Bristol County,MA,Somerset,2001,4.4,425,9286,9711
6559,Somerset,Bristol County,MA,Somerset,2002,5.5,544,9384,9928
6560,Somerset,Bristol County,MA,Somerset,2003,5.5,546,9441,9987
6561,Somerset,Bristol County,MA,Somerset,2004,5.6,563,9441,10004
6562,Somerset,Bristol County,MA,Somerset,2005,5.6,556,9446,10002
6563,Somerset,Bristol County,MA,Somerset,2006,5.7,576,9473,10049
6564,Somerset,Bristol County,MA,Somerset,2007,5.5,547,9414,9961
6565,Somerset,Bristol County,MA,Somerset,2008,6.7,660,9165,9825
6566,Somerset,Bristol County,MA,Somerset,2009,10.2,1018,8975,9993
6567,Somerset,Bristol County,MA,Somerset,2010,10.6,1036,8763,9799
6568,Somerset,Bristol County,MA,Somerset,2011,9.5,924,8827,9751
6569,Somerset,Bristol County,MA,Somerset,2012,9.1,887,8841,9728
6570,Somerville,Middlesex County,MA,Somerville,1990,4.9,2232,43162,45394
6571,Somerville,Middlesex County,MA,Somerville,1991,7.2,3145,40505,43650
6572,Somerville,Middlesex County,MA,Somerville,1992,7.5,3163,38907,42070
6573,Somerville,Middlesex County,MA,Somerville,1993,6.4,2659,38663,41322
6574,Somerville,Middlesex County,MA,Somerville,1994,5.3,2158,38571,40729
6575,Somerville,Middlesex County,MA,Somerville,1995,4.1,1789,42034,43823
6576,Somerville,Middlesex County,MA,Somerville,1996,3.4,1482,42694,44176
6577,Somerville,Middlesex County,MA,Somerville,1997,2.9,1325,43666,44991
6578,Somerville,Middlesex County,MA,Somerville,1998,2.4,1086,44133,45219
6579,Somerville,Middlesex County,MA,Somerville,1999,2.3,1043,44240,45283
6580,Somerville,Middlesex County,MA,Somerville,2000,2,951,47505,48456
6581,Somerville,Middlesex County,MA,Somerville,2001,3,1471,47120,48591
6582,Somerville,Middlesex County,MA,Somerville,2002,4.5,2147,46025,48172
6583,Somerville,Middlesex County,MA,Somerville,2003,4.8,2295,45031,47326
6584,Somerville,Middlesex County,MA,Somerville,2004,4,1882,44673,46555
6585,Somerville,Middlesex County,MA,Somerville,2005,3.5,1627,44677,46304
6586,Somerville,Middlesex County,MA,Somerville,2006,3.5,1597,44679,46276
6587,Somerville,Middlesex County,MA,Somerville,2007,3.2,1471,44905,46376
6588,Somerville,Middlesex County,MA,Somerville,2008,3.9,1799,44697,46496
6589,Somerville,Middlesex County,MA,Somerville,2009,6.1,2846,43502,46348
6590,Somerville,Middlesex County,MA,Somerville,2010,6.1,2858,43730,46588
6591,Somerville,Middlesex County,MA,Somerville,2011,5.1,2391,44361,46752
6592,Somerville,Middlesex County,MA,Somerville,2012,4.5,2135,44847,46982
6593,South Hadley,Hampshire County,MA,South Hadley,1990,5.1,476,8886,9362
6594,South Hadley,Hampshire County,MA,South Hadley,1991,7.2,666,8570,9236
6595,South Hadley,Hampshire County,MA,South Hadley,1992,7.3,681,8588,9269
6596,South Hadley,Hampshire County,MA,South Hadley,1993,6.2,577,8705,9282
6597,South Hadley,Hampshire County,MA,South Hadley,1994,5.6,526,8790,9316
6598,South Hadley,Hampshire County,MA,South Hadley,1995,5.1,470,8758,9228
6599,South Hadley,Hampshire County,MA,South Hadley,1996,3.6,335,8963,9298
6600,South Hadley,Hampshire County,MA,South Hadley,1997,3.1,291,9196,9487
6601,South Hadley,Hampshire County,MA,South Hadley,1998,2.8,262,9245,9507
6602,South Hadley,Hampshire County,MA,South Hadley,1999,2.5,235,9329,9564
6603,South Hadley,Hampshire County,MA,South Hadley,2000,2.4,225,9337,9562
6604,South Hadley,Hampshire County,MA,South Hadley,2001,3,283,9307,9590
6605,South Hadley,Hampshire County,MA,South Hadley,2002,4,380,9230,9610
6606,South Hadley,Hampshire County,MA,South Hadley,2003,4.7,452,9175,9627
6607,South Hadley,Hampshire County,MA,South Hadley,2004,4.4,423,9132,9555
6608,South Hadley,Hampshire County,MA,South Hadley,2005,4.2,403,9115,9518
6609,South Hadley,Hampshire County,MA,South Hadley,2006,4.1,394,9161,9555
6610,South Hadley,Hampshire County,MA,South Hadley,2007,3.9,369,9143,9512
6611,South Hadley,Hampshire County,MA,South Hadley,2008,4.6,440,9216,9656
6612,South Hadley,Hampshire County,MA,South Hadley,2009,6.9,655,8830,9485
6613,South Hadley,Hampshire County,MA,South Hadley,2010,7.1,680,8957,9637
6614,South Hadley,Hampshire County,MA,South Hadley,2011,6.4,610,8848,9458
6615,South Hadley,Hampshire County,MA,South Hadley,2012,6.1,572,8853,9425
6616,Southampton,Hampshire County,MA,Southampton,1990,5,131,2488,2619
6617,Southampton,Hampshire County,MA,Southampton,1991,7.9,208,2426,2634
6618,Southampton,Hampshire County,MA,Southampton,1992,7.6,203,2471,2674
6619,Southampton,Hampshire County,MA,Southampton,1993,7.1,193,2507,2700
6620,Southampton,Hampshire County,MA,Southampton,1994,6.2,174,2622,2796
6621,Southampton,Hampshire County,MA,Southampton,1995,5.4,146,2569,2715
6622,Southampton,Hampshire County,MA,Southampton,1996,4,111,2644,2755
6623,Southampton,Hampshire County,MA,Southampton,1997,3.3,94,2730,2824
6624,Southampton,Hampshire County,MA,Southampton,1998,3.2,93,2847,2940
6625,Southampton,Hampshire County,MA,Southampton,1999,3.2,95,2901,2996
6626,Southampton,Hampshire County,MA,Southampton,2000,2.1,69,3151,3220
6627,Southampton,Hampshire County,MA,Southampton,2001,2.9,95,3185,3280
6628,Southampton,Hampshire County,MA,Southampton,2002,3.7,125,3216,3341
6629,Southampton,Hampshire County,MA,Southampton,2003,4.4,151,3246,3397
6630,Southampton,Hampshire County,MA,Southampton,2004,4.4,150,3295,3445
6631,Southampton,Hampshire County,MA,Southampton,2005,3.9,136,3352,3488
6632,Southampton,Hampshire County,MA,Southampton,2006,3.6,128,3428,3556
6633,Southampton,Hampshire County,MA,Southampton,2007,3.8,137,3453,3590
6634,Southampton,Hampshire County,MA,Southampton,2008,4.2,152,3428,3580
6635,Southampton,Hampshire County,MA,Southampton,2009,6.4,224,3267,3491
6636,Southampton,Hampshire County,MA,Southampton,2010,6.7,228,3182,3410
6637,Southampton,Hampshire County,MA,Southampton,2011,5.8,194,3142,3336
6638,Southampton,Hampshire County,MA,Southampton,2012,5.4,181,3144,3325
6639,Southborough,Worcester County,MA,Southborough,1990,4.8,184,3632,3816
6640,Southborough,Worcester County,MA,Southborough,1991,5.8,216,3520,3736
6641,Southborough,Worcester County,MA,Southborough,1992,6,226,3572,3798
6642,Southborough,Worcester County,MA,Southborough,1993,5.1,199,3675,3874
6643,Southborough,Worcester County,MA,Southborough,1994,4.2,171,3890,4061
6644,Southborough,Worcester County,MA,Southborough,1995,3.9,157,3917,4074
6645,Southborough,Worcester County,MA,Southborough,1996,3.1,129,4054,4183
6646,Southborough,Worcester County,MA,Southborough,1997,2.4,104,4256,4360
6647,Southborough,Worcester County,MA,Southborough,1998,2,92,4421,4513
6648,Southborough,Worcester County,MA,Southborough,1999,2,95,4597,4692
6649,Southborough,Worcester County,MA,Southborough,2000,2.1,96,4467,4563
6650,Southborough,Worcester County,MA,Southborough,2001,3.3,155,4554,4709
6651,Southborough,Worcester County,MA,Southborough,2002,4.9,236,4544,4780
6652,Southborough,Worcester County,MA,Southborough,2003,4.9,237,4569,4806
6653,Southborough,Worcester County,MA,Southborough,2004,3.8,185,4654,4839
6654,Southborough,Worcester County,MA,Southborough,2005,3.6,178,4731,4909
6655,Southborough,Worcester County,MA,Southborough,2006,3.6,175,4754,4929
6656,Southborough,Worcester County,MA,Southborough,2007,3.2,157,4779,4936
6657,Southborough,Worcester County,MA,Southborough,2008,3.6,183,4873,5056
6658,Southborough,Worcester County,MA,Southborough,2009,6,299,4710,5009
6659,Southborough,Worcester County,MA,Southborough,2010,6.4,322,4688,5010
6660,Southborough,Worcester County,MA,Southborough,2011,4.9,242,4700,4942
6661,Southborough,Worcester County,MA,Southborough,2012,4.8,241,4743,4984
6662,Southbridge,Worcester County,MA,Southbridge,1990,7.8,681,8076,8757
6663,Southbridge,Worcester County,MA,Southbridge,1991,11.8,1014,7600,8614
6664,Southbridge,Worcester County,MA,Southbridge,1992,12,984,7209,8193
6665,Southbridge,Worcester County,MA,Southbridge,1993,10.6,860,7282,8142
6666,Southbridge,Worcester County,MA,Southbridge,1994,7,552,7309,7861
6667,Southbridge,Worcester County,MA,Southbridge,1995,6.3,532,7909,8441
6668,Southbridge,Worcester County,MA,Southbridge,1996,5.4,455,7997,8452
6669,Southbridge,Worcester County,MA,Southbridge,1997,4.4,375,8166,8541
6670,Southbridge,Worcester County,MA,Southbridge,1998,4.3,368,8236,8604
6671,Southbridge,Worcester County,MA,Southbridge,1999,3.7,316,8169,8485
6672,Southbridge,Worcester County,MA,Southbridge,2000,3.3,269,7891,8160
6673,Southbridge,Worcester County,MA,Southbridge,2001,4.6,378,7866,8244
6674,Southbridge,Worcester County,MA,Southbridge,2002,6.5,542,7789,8331
6675,Southbridge,Worcester County,MA,Southbridge,2003,7.5,623,7723,8346
6676,Southbridge,Worcester County,MA,Southbridge,2004,6.9,568,7662,8230
6677,Southbridge,Worcester County,MA,Southbridge,2005,6.3,510,7602,8112
6678,Southbridge,Worcester County,MA,Southbridge,2006,6.5,540,7741,8281
6679,Southbridge,Worcester County,MA,Southbridge,2007,6.1,501,7730,8231
6680,Southbridge,Worcester County,MA,Southbridge,2008,7.7,628,7573,8201
6681,Southbridge,Worcester County,MA,Southbridge,2009,10.3,849,7359,8208
6682,Southbridge,Worcester County,MA,Southbridge,2010,12,964,7059,8023
6683,Southbridge,Worcester County,MA,Southbridge,2011,10.9,870,7121,7991
6684,Southbridge,Worcester County,MA,Southbridge,2012,10.2,808,7119,7927
6685,Southwick,Hampden County,MA,Southwick,1990,5.2,228,4152,4380
6686,Southwick,Hampden County,MA,Southwick,1991,8.4,374,4082,4456
6687,Southwick,Hampden County,MA,Southwick,1992,9.3,423,4147,4570
6688,Southwick,Hampden County,MA,Southwick,1993,9.1,421,4194,4615
6689,Southwick,Hampden County,MA,Southwick,1994,8.3,384,4262,4646
6690,Southwick,Hampden County,MA,Southwick,1995,7,310,4110,4420
6691,Southwick,Hampden County,MA,Southwick,1996,5.4,241,4259,4500
6692,Southwick,Hampden County,MA,Southwick,1997,4.3,201,4441,4642
6693,Southwick,Hampden County,MA,Southwick,1998,3.9,183,4533,4716
6694,Southwick,Hampden County,MA,Southwick,1999,3.2,151,4639,4790
6695,Southwick,Hampden County,MA,Southwick,2000,3,147,4704,4851
6696,Southwick,Hampden County,MA,Southwick,2001,3.7,182,4773,4955
6697,Southwick,Hampden County,MA,Southwick,2002,5.1,256,4809,5065
6698,Southwick,Hampden County,MA,Southwick,2003,5.2,268,4843,5111
6699,Southwick,Hampden County,MA,Southwick,2004,5,259,4902,5161
6700,Southwick,Hampden County,MA,Southwick,2005,4.7,248,4984,5232
6701,Southwick,Hampden County,MA,Southwick,2006,4.6,244,5046,5290
6702,Southwick,Hampden County,MA,Southwick,2007,4.4,228,4970,5198
6703,Southwick,Hampden County,MA,Southwick,2008,5.4,285,4999,5284
6704,Southwick,Hampden County,MA,Southwick,2009,8.5,448,4830,5278
6705,Southwick,Hampden County,MA,Southwick,2010,9.3,488,4748,5236
6706,Southwick,Hampden County,MA,Southwick,2011,7.9,401,4702,5103
6707,Southwick,Hampden County,MA,Southwick,2012,7,353,4705,5058
6708,Spencer,Worcester County,MA,Spencer,1990,6.5,395,5695,6090
6709,Spencer,Worcester County,MA,Spencer,1991,9.8,594,5490,6084
6710,Spencer,Worcester County,MA,Spencer,1992,9.5,586,5569,6155
6711,Spencer,Worcester County,MA,Spencer,1993,7.5,454,5604,6058
6712,Spencer,Worcester County,MA,Spencer,1994,5.7,342,5692,6034
6713,Spencer,Worcester County,MA,Spencer,1995,5.5,338,5810,6148
6714,Spencer,Worcester County,MA,Spencer,1996,5,315,5957,6272
6715,Spencer,Worcester County,MA,Spencer,1997,3.5,227,6194,6421
6716,Spencer,Worcester County,MA,Spencer,1998,3.3,214,6328,6542
6717,Spencer,Worcester County,MA,Spencer,1999,3,193,6296,6489
6718,Spencer,Worcester County,MA,Spencer,2000,2.6,170,6390,6560
6719,Spencer,Worcester County,MA,Spencer,2001,3.4,226,6398,6624
6720,Spencer,Worcester County,MA,Spencer,2002,5.1,341,6366,6707
6721,Spencer,Worcester County,MA,Spencer,2003,5.9,397,6338,6735
6722,Spencer,Worcester County,MA,Spencer,2004,5.7,380,6332,6712
6723,Spencer,Worcester County,MA,Spencer,2005,5.1,338,6353,6691
6724,Spencer,Worcester County,MA,Spencer,2006,5,333,6333,6666
6725,Spencer,Worcester County,MA,Spencer,2007,4.9,329,6325,6654
6726,Spencer,Worcester County,MA,Spencer,2008,6.1,399,6193,6592
6727,Spencer,Worcester County,MA,Spencer,2009,9.4,628,6022,6650
6728,Spencer,Worcester County,MA,Spencer,2010,10.2,671,5878,6549
6729,Spencer,Worcester County,MA,Spencer,2011,7.9,509,5931,6440
6730,Spencer,Worcester County,MA,Spencer,2012,7.4,476,5929,6405
6731,Springfield,Hampden County,MA,Springfield,1990,8,5588,64373,69961
6732,Springfield,Hampden County,MA,Springfield,1991,11.5,8018,61502,69520
6733,Springfield,Hampden County,MA,Springfield,1992,11.2,7678,60743,68421
6734,Springfield,Hampden County,MA,Springfield,1993,10.5,7035,59891,66926
6735,Springfield,Hampden County,MA,Springfield,1994,9.4,6152,59274,65426
6736,Springfield,Hampden County,MA,Springfield,1995,7.7,5046,60372,65418
6737,Springfield,Hampden County,MA,Springfield,1996,6.3,4072,60729,64801
6738,Springfield,Hampden County,MA,Springfield,1997,5.8,3814,61863,65677
6739,Springfield,Hampden County,MA,Springfield,1998,5.3,3476,61819,65295
6740,Springfield,Hampden County,MA,Springfield,1999,5.2,3401,61764,65165
6741,Springfield,Hampden County,MA,Springfield,2000,4.1,2698,62316,65014
6742,Springfield,Hampden County,MA,Springfield,2001,5.2,3418,62183,65601
6743,Springfield,Hampden County,MA,Springfield,2002,7.2,4803,61827,66630
6744,Springfield,Hampden County,MA,Springfield,2003,8.1,5409,61137,66546
6745,Springfield,Hampden County,MA,Springfield,2004,7.8,5180,61089,66269
6746,Springfield,Hampden County,MA,Springfield,2005,7.3,4812,61182,65994
6747,Springfield,Hampden County,MA,Springfield,2006,7.4,4936,61374,66310
6748,Springfield,Hampden County,MA,Springfield,2007,7,4623,61042,65665
6749,Springfield,Hampden County,MA,Springfield,2008,8,5293,60781,66074
6750,Springfield,Hampden County,MA,Springfield,2009,11.2,7563,59911,67474
6751,Springfield,Hampden County,MA,Springfield,2010,12.4,8368,59091,67459
6752,Springfield,Hampden County,MA,Springfield,2011,11.9,7883,58500,66383
6753,Springfield,Hampden County,MA,Springfield,2012,11,7200,58535,65735
6754,Sterling,Worcester County,MA,Sterling,1990,5.5,189,3264,3453
6755,Sterling,Worcester County,MA,Sterling,1991,8.1,282,3188,3470
6756,Sterling,Worcester County,MA,Sterling,1992,9.1,328,3279,3607
6757,Sterling,Worcester County,MA,Sterling,1993,7.2,266,3420,3686
6758,Sterling,Worcester County,MA,Sterling,1994,5.7,214,3531,3745
6759,Sterling,Worcester County,MA,Sterling,1995,5.1,181,3384,3565
6760,Sterling,Worcester County,MA,Sterling,1996,3.5,127,3477,3604
6761,Sterling,Worcester County,MA,Sterling,1997,3.5,131,3610,3741
6762,Sterling,Worcester County,MA,Sterling,1998,2.3,90,3742,3832
6763,Sterling,Worcester County,MA,Sterling,1999,3.2,127,3803,3930
6764,Sterling,Worcester County,MA,Sterling,2000,2.1,87,4123,4210
6765,Sterling,Worcester County,MA,Sterling,2001,3,127,4167,4294
6766,Sterling,Worcester County,MA,Sterling,2002,4.8,213,4186,4399
6767,Sterling,Worcester County,MA,Sterling,2003,5,223,4215,4438
6768,Sterling,Worcester County,MA,Sterling,2004,4.6,202,4232,4434
6769,Sterling,Worcester County,MA,Sterling,2005,4.4,194,4234,4428
6770,Sterling,Worcester County,MA,Sterling,2006,4.1,184,4257,4441
6771,Sterling,Worcester County,MA,Sterling,2007,4,179,4252,4431
6772,Sterling,Worcester County,MA,Sterling,2008,4.4,192,4162,4354
6773,Sterling,Worcester County,MA,Sterling,2009,7.2,315,4047,4362
6774,Sterling,Worcester County,MA,Sterling,2010,7.9,347,4073,4420
6775,Sterling,Worcester County,MA,Sterling,2011,6.4,279,4109,4388
6776,Sterling,Worcester County,MA,Sterling,2012,5.7,247,4107,4354
6777,Stockbridge,Berkshire County,MA,Stockbridge,1990,3.8,42,1052,1094
6778,Stockbridge,Berkshire County,MA,Stockbridge,1991,6.2,65,984,1049
6779,Stockbridge,Berkshire County,MA,Stockbridge,1992,7,74,979,1053
6780,Stockbridge,Berkshire County,MA,Stockbridge,1993,5.3,54,971,1025
6781,Stockbridge,Berkshire County,MA,Stockbridge,1994,5.9,60,951,1011
6782,Stockbridge,Berkshire County,MA,Stockbridge,1995,5.4,56,974,1030
6783,Stockbridge,Berkshire County,MA,Stockbridge,1996,4.2,43,987,1030
6784,Stockbridge,Berkshire County,MA,Stockbridge,1997,3.7,38,991,1029
6785,Stockbridge,Berkshire County,MA,Stockbridge,1998,3.3,34,988,1022
6786,Stockbridge,Berkshire County,MA,Stockbridge,1999,2.7,27,989,1016
6787,Stockbridge,Berkshire County,MA,Stockbridge,2000,1.9,25,1258,1283
6788,Stockbridge,Berkshire County,MA,Stockbridge,2001,2.3,30,1298,1328
6789,Stockbridge,Berkshire County,MA,Stockbridge,2002,3.3,46,1334,1380
6790,Stockbridge,Berkshire County,MA,Stockbridge,2003,3.6,50,1332,1382
6791,Stockbridge,Berkshire County,MA,Stockbridge,2004,3.9,54,1324,1378
6792,Stockbridge,Berkshire County,MA,Stockbridge,2005,3.3,46,1354,1400
6793,Stockbridge,Berkshire County,MA,Stockbridge,2006,3.3,47,1366,1413
6794,Stockbridge,Berkshire County,MA,Stockbridge,2007,3.2,44,1332,1376
6795,Stockbridge,Berkshire County,MA,Stockbridge,2008,3.8,52,1326,1378
6796,Stockbridge,Berkshire County,MA,Stockbridge,2009,5.1,68,1277,1345
6797,Stockbridge,Berkshire County,MA,Stockbridge,2010,5.3,64,1142,1206
6798,Stockbridge,Berkshire County,MA,Stockbridge,2011,5,61,1149,1210
6799,Stockbridge,Berkshire County,MA,Stockbridge,2012,4.2,50,1139,1189
6800,Stoneham,Middlesex County,MA,Stoneham,1990,5.6,679,11488,12167
6801,Stoneham,Middlesex County,MA,Stoneham,1991,7.4,881,11027,11908
6802,Stoneham,Middlesex County,MA,Stoneham,1992,7.6,898,10985,11883
6803,Stoneham,Middlesex County,MA,Stoneham,1993,5.8,681,10997,11678
6804,Stoneham,Middlesex County,MA,Stoneham,1994,5.1,607,11198,11805
6805,Stoneham,Middlesex County,MA,Stoneham,1995,5.1,613,11338,11951
6806,Stoneham,Middlesex County,MA,Stoneham,1996,4,479,11551,12030
6807,Stoneham,Middlesex County,MA,Stoneham,1997,3.4,421,11838,12259
6808,Stoneham,Middlesex County,MA,Stoneham,1998,2.9,361,12066,12427
6809,Stoneham,Middlesex County,MA,Stoneham,1999,2.9,358,12164,12522
6810,Stoneham,Middlesex County,MA,Stoneham,2000,2.3,281,12006,12287
6811,Stoneham,Middlesex County,MA,Stoneham,2001,3.3,405,11938,12343
6812,Stoneham,Middlesex County,MA,Stoneham,2002,4.9,596,11663,12259
6813,Stoneham,Middlesex County,MA,Stoneham,2003,5.2,626,11422,12048
6814,Stoneham,Middlesex County,MA,Stoneham,2004,4.9,580,11333,11913
6815,Stoneham,Middlesex County,MA,Stoneham,2005,4.5,531,11348,11879
6816,Stoneham,Middlesex County,MA,Stoneham,2006,4.4,507,11061,11568
6817,Stoneham,Middlesex County,MA,Stoneham,2007,4.2,491,11142,11633
6818,Stoneham,Middlesex County,MA,Stoneham,2008,4.8,562,11117,11679
6819,Stoneham,Middlesex County,MA,Stoneham,2009,7.4,870,10817,11687
6820,Stoneham,Middlesex County,MA,Stoneham,2010,7.1,840,10918,11758
6821,Stoneham,Middlesex County,MA,Stoneham,2011,6.4,761,11078,11839
6822,Stoneham,Middlesex County,MA,Stoneham,2012,5.6,665,11199,11864
6823,Stoughton,Norfolk County,MA,Stoughton,1990,5.9,904,14302,15206
6824,Stoughton,Norfolk County,MA,Stoughton,1991,8.3,1257,13910,15167
6825,Stoughton,Norfolk County,MA,Stoughton,1992,9.1,1377,13834,15211
6826,Stoughton,Norfolk County,MA,Stoughton,1993,7.4,1123,13970,15093
6827,Stoughton,Norfolk County,MA,Stoughton,1994,6.3,945,14155,15100
6828,Stoughton,Norfolk County,MA,Stoughton,1995,5.1,775,14472,15247
6829,Stoughton,Norfolk County,MA,Stoughton,1996,4.2,641,14759,15400
6830,Stoughton,Norfolk County,MA,Stoughton,1997,3.8,602,15128,15730
6831,Stoughton,Norfolk County,MA,Stoughton,1998,3,472,15337,15809
6832,Stoughton,Norfolk County,MA,Stoughton,1999,3.2,517,15523,16040
6833,Stoughton,Norfolk County,MA,Stoughton,2000,2.8,426,14966,15392
6834,Stoughton,Norfolk County,MA,Stoughton,2001,3.6,563,14918,15481
6835,Stoughton,Norfolk County,MA,Stoughton,2002,5.1,794,14630,15424
6836,Stoughton,Norfolk County,MA,Stoughton,2003,5.9,907,14360,15267
6837,Stoughton,Norfolk County,MA,Stoughton,2004,5.2,786,14279,15065
6838,Stoughton,Norfolk County,MA,Stoughton,2005,4.8,729,14314,15043
6839,Stoughton,Norfolk County,MA,Stoughton,2006,4.6,692,14230,14922
6840,Stoughton,Norfolk County,MA,Stoughton,2007,4.3,654,14402,15056
6841,Stoughton,Norfolk County,MA,Stoughton,2008,5.3,813,14406,15219
6842,Stoughton,Norfolk County,MA,Stoughton,2009,8,1202,13896,15098
6843,Stoughton,Norfolk County,MA,Stoughton,2010,8,1219,14004,15223
6844,Stoughton,Norfolk County,MA,Stoughton,2011,6.7,1023,14163,15186
6845,Stoughton,Norfolk County,MA,Stoughton,2012,6.3,964,14318,15282
6846,Stow,Middlesex County,MA,Stow,1990,3.7,114,3009,3123
6847,Stow,Middlesex County,MA,Stow,1991,5.8,177,2899,3076
6848,Stow,Middlesex County,MA,Stow,1992,6.3,197,2918,3115
6849,Stow,Middlesex County,MA,Stow,1993,5.6,176,2995,3171
6850,Stow,Middlesex County,MA,Stow,1994,4.6,149,3064,3213
6851,Stow,Middlesex County,MA,Stow,1995,4.1,136,3168,3304
6852,Stow,Middlesex County,MA,Stow,1996,2.6,88,3256,3344
6853,Stow,Middlesex County,MA,Stow,1997,2.2,74,3357,3431
6854,Stow,Middlesex County,MA,Stow,1998,2.2,78,3427,3505
6855,Stow,Middlesex County,MA,Stow,1999,2.2,77,3490,3567
6856,Stow,Middlesex County,MA,Stow,2000,2,65,3263,3328
6857,Stow,Middlesex County,MA,Stow,2001,3.2,108,3301,3409
6858,Stow,Middlesex County,MA,Stow,2002,4.9,168,3264,3432
6859,Stow,Middlesex County,MA,Stow,2003,5,172,3247,3419
6860,Stow,Middlesex County,MA,Stow,2004,4,136,3243,3379
6861,Stow,Middlesex County,MA,Stow,2005,3.6,123,3310,3433
6862,Stow,Middlesex County,MA,Stow,2006,3.7,125,3293,3418
6863,Stow,Middlesex County,MA,Stow,2007,3.3,115,3369,3484
6864,Stow,Middlesex County,MA,Stow,2008,4.2,150,3442,3592
6865,Stow,Middlesex County,MA,Stow,2009,6.1,222,3410,3632
6866,Stow,Middlesex County,MA,Stow,2010,5.5,198,3419,3617
6867,Stow,Middlesex County,MA,Stow,2011,4.8,175,3469,3644
6868,Stow,Middlesex County,MA,Stow,2012,4.5,167,3507,3674
6869,Sturbridge,Worcester County,MA,Sturbridge,1990,5.6,238,4001,4239
6870,Sturbridge,Worcester County,MA,Sturbridge,1991,8.4,357,3912,4269
6871,Sturbridge,Worcester County,MA,Sturbridge,1992,8.4,365,3992,4357
6872,Sturbridge,Worcester County,MA,Sturbridge,1993,6.4,279,4057,4336
6873,Sturbridge,Worcester County,MA,Sturbridge,1994,4.8,209,4117,4326
6874,Sturbridge,Worcester County,MA,Sturbridge,1995,4.4,184,4020,4204
6875,Sturbridge,Worcester County,MA,Sturbridge,1996,3.7,156,4092,4248
6876,Sturbridge,Worcester County,MA,Sturbridge,1997,3.6,156,4221,4377
6877,Sturbridge,Worcester County,MA,Sturbridge,1998,2.7,119,4311,4430
6878,Sturbridge,Worcester County,MA,Sturbridge,1999,2.5,111,4296,4407
6879,Sturbridge,Worcester County,MA,Sturbridge,2000,2.4,105,4351,4456
6880,Sturbridge,Worcester County,MA,Sturbridge,2001,2.9,133,4420,4553
6881,Sturbridge,Worcester County,MA,Sturbridge,2002,4.8,224,4447,4671
6882,Sturbridge,Worcester County,MA,Sturbridge,2003,5.6,268,4527,4795
6883,Sturbridge,Worcester County,MA,Sturbridge,2004,5.1,249,4636,4885
6884,Sturbridge,Worcester County,MA,Sturbridge,2005,4.3,214,4711,4925
6885,Sturbridge,Worcester County,MA,Sturbridge,2006,4.2,208,4703,4911
6886,Sturbridge,Worcester County,MA,Sturbridge,2007,4.5,221,4715,4936
6887,Sturbridge,Worcester County,MA,Sturbridge,2008,5.1,248,4620,4868
6888,Sturbridge,Worcester County,MA,Sturbridge,2009,7.9,385,4497,4882
6889,Sturbridge,Worcester County,MA,Sturbridge,2010,7.5,381,4717,5098
6890,Sturbridge,Worcester County,MA,Sturbridge,2011,7,357,4759,5116
6891,Sturbridge,Worcester County,MA,Sturbridge,2012,6.4,323,4757,5080
6892,Sudbury,Middlesex County,MA,Sudbury,1990,3.4,280,7916,8196
6893,Sudbury,Middlesex County,MA,Sudbury,1991,4.3,344,7729,8073
6894,Sudbury,Middlesex County,MA,Sudbury,1992,5,412,7808,8220
6895,Sudbury,Middlesex County,MA,Sudbury,1993,4.1,344,7997,8341
6896,Sudbury,Middlesex County,MA,Sudbury,1994,3.7,317,8250,8567
6897,Sudbury,Middlesex County,MA,Sudbury,1995,3.4,289,8123,8412
6898,Sudbury,Middlesex County,MA,Sudbury,1996,2.3,199,8379,8578
6899,Sudbury,Middlesex County,MA,Sudbury,1997,1.9,167,8680,8847
6900,Sudbury,Middlesex County,MA,Sudbury,1998,1.6,142,8917,9059
6901,Sudbury,Middlesex County,MA,Sudbury,1999,1.6,144,9146,9290
6902,Sudbury,Middlesex County,MA,Sudbury,2000,1.8,153,8305,8458
6903,Sudbury,Middlesex County,MA,Sudbury,2001,3,255,8366,8621
6904,Sudbury,Middlesex County,MA,Sudbury,2002,4.7,405,8260,8665
6905,Sudbury,Middlesex County,MA,Sudbury,2003,4.8,408,8136,8544
6906,Sudbury,Middlesex County,MA,Sudbury,2004,3.8,323,8122,8445
6907,Sudbury,Middlesex County,MA,Sudbury,2005,3.4,287,8162,8449
6908,Sudbury,Middlesex County,MA,Sudbury,2006,3.7,308,8054,8362
6909,Sudbury,Middlesex County,MA,Sudbury,2007,3.1,265,8160,8425
6910,Sudbury,Middlesex County,MA,Sudbury,2008,3.8,323,8208,8531
6911,Sudbury,Middlesex County,MA,Sudbury,2009,6,515,8061,8576
6912,Sudbury,Middlesex County,MA,Sudbury,2010,5.8,507,8180,8687
6913,Sudbury,Middlesex County,MA,Sudbury,2011,5,436,8301,8737
6914,Sudbury,Middlesex County,MA,Sudbury,2012,4.5,395,8392,8787
6938,Sunderland,Franklin County,MA,Sunderland,1990,4,83,1989,2072
6939,Sunderland,Franklin County,MA,Sunderland,1991,6,120,1884,2004
6940,Sunderland,Franklin County,MA,Sunderland,1992,6.1,123,1897,2020
6941,Sunderland,Franklin County,MA,Sunderland,1993,5.1,106,1981,2087
6942,Sunderland,Franklin County,MA,Sunderland,1994,4.6,98,2014,2112
6943,Sunderland,Franklin County,MA,Sunderland,1995,3.5,72,2000,2072
6944,Sunderland,Franklin County,MA,Sunderland,1996,2.5,53,2037,2090
6945,Sunderland,Franklin County,MA,Sunderland,1997,2.1,45,2080,2125
6946,Sunderland,Franklin County,MA,Sunderland,1998,2.1,45,2080,2125
6947,Sunderland,Franklin County,MA,Sunderland,1999,2.2,48,2109,2157
6948,Sunderland,Franklin County,MA,Sunderland,2000,1.8,41,2197,2238
6949,Sunderland,Franklin County,MA,Sunderland,2001,2.1,48,2252,2300
6950,Sunderland,Franklin County,MA,Sunderland,2002,2.9,68,2245,2313
6951,Sunderland,Franklin County,MA,Sunderland,2003,3.5,81,2265,2346
6952,Sunderland,Franklin County,MA,Sunderland,2004,3.1,74,2285,2359
6953,Sunderland,Franklin County,MA,Sunderland,2005,3.3,77,2288,2365
6954,Sunderland,Franklin County,MA,Sunderland,2006,3.4,80,2297,2377
6955,Sunderland,Franklin County,MA,Sunderland,2007,3.3,78,2275,2353
6956,Sunderland,Franklin County,MA,Sunderland,2008,3.5,80,2189,2269
6957,Sunderland,Franklin County,MA,Sunderland,2009,5,119,2243,2362
6958,Sunderland,Franklin County,MA,Sunderland,2010,5.8,126,2055,2181
6959,Sunderland,Franklin County,MA,Sunderland,2011,4.7,102,2077,2179
6960,Sunderland,Franklin County,MA,Sunderland,2012,4.2,92,2096,2188
6961,Sutton,Worcester County,MA,Sutton,1990,4.6,172,3533,3705
6962,Sutton,Worcester County,MA,Sutton,1991,7.7,291,3495,3786
6963,Sutton,Worcester County,MA,Sutton,1992,7.7,297,3558,3855
6964,Sutton,Worcester County,MA,Sutton,1993,5.5,218,3714,3932
6965,Sutton,Worcester County,MA,Sutton,1994,4.6,187,3872,4059
6966,Sutton,Worcester County,MA,Sutton,1995,4.4,170,3707,3877
6967,Sutton,Worcester County,MA,Sutton,1996,4,159,3798,3957
6968,Sutton,Worcester County,MA,Sutton,1997,3.8,154,3932,4086
6969,Sutton,Worcester County,MA,Sutton,1998,2.7,112,4004,4116
6970,Sutton,Worcester County,MA,Sutton,1999,2.9,122,4057,4179
6971,Sutton,Worcester County,MA,Sutton,2000,2.2,102,4478,4580
6972,Sutton,Worcester County,MA,Sutton,2001,3.3,155,4565,4720
6973,Sutton,Worcester County,MA,Sutton,2002,4.5,214,4592,4806
6974,Sutton,Worcester County,MA,Sutton,2003,5.1,248,4633,4881
6975,Sutton,Worcester County,MA,Sutton,2004,4.8,233,4625,4858
6976,Sutton,Worcester County,MA,Sutton,2005,4.4,213,4669,4882
6977,Sutton,Worcester County,MA,Sutton,2006,4,199,4728,4927
6978,Sutton,Worcester County,MA,Sutton,2007,4,196,4752,4948
6979,Sutton,Worcester County,MA,Sutton,2008,4.9,242,4668,4910
6980,Sutton,Worcester County,MA,Sutton,2009,7.6,374,4548,4922
6981,Sutton,Worcester County,MA,Sutton,2010,8,387,4456,4843
6982,Sutton,Worcester County,MA,Sutton,2011,7,337,4496,4833
6983,Sutton,Worcester County,MA,Sutton,2012,6.4,308,4495,4803
6984,Swampscott,Essex County,MA,Swampscott,1990,4.5,324,6947,7271
6985,Swampscott,Essex County,MA,Swampscott,1991,7,506,6736,7242
6986,Swampscott,Essex County,MA,Swampscott,1992,7.3,527,6687,7214
6987,Swampscott,Essex County,MA,Swampscott,1993,5.3,375,6717,7092
6988,Swampscott,Essex County,MA,Swampscott,1994,5,357,6851,7208
6989,Swampscott,Essex County,MA,Swampscott,1995,4.2,298,6863,7161
6990,Swampscott,Essex County,MA,Swampscott,1996,3.4,247,6997,7244
6991,Swampscott,Essex County,MA,Swampscott,1997,3.1,230,7176,7406
6992,Swampscott,Essex County,MA,Swampscott,1998,2.5,185,7258,7443
6993,Swampscott,Essex County,MA,Swampscott,1999,2.5,191,7347,7538
6994,Swampscott,Essex County,MA,Swampscott,2000,2.2,173,7739,7912
6995,Swampscott,Essex County,MA,Swampscott,2001,3,236,7746,7982
6996,Swampscott,Essex County,MA,Swampscott,2002,4.3,345,7638,7983
6997,Swampscott,Essex County,MA,Swampscott,2003,4.8,384,7552,7936
6998,Swampscott,Essex County,MA,Swampscott,2004,4.3,336,7476,7812
6999,Swampscott,Essex County,MA,Swampscott,2005,4,306,7415,7721
7000,Swampscott,Essex County,MA,Swampscott,2006,3.8,293,7423,7716
7001,Swampscott,Essex County,MA,Swampscott,2007,3.4,260,7377,7637
7002,Swampscott,Essex County,MA,Swampscott,2008,4.3,334,7360,7694
7003,Swampscott,Essex County,MA,Swampscott,2009,6.9,537,7205,7742
7004,Swampscott,Essex County,MA,Swampscott,2010,7.1,537,7074,7611
7005,Swampscott,Essex County,MA,Swampscott,2011,5.5,417,7157,7574
7006,Swampscott,Essex County,MA,Swampscott,2012,5.3,402,7212,7614
7007,Swansea,Bristol County,MA,Swansea,1990,7.2,635,8192,8827
7008,Swansea,Bristol County,MA,Swansea,1991,11.7,1042,7863,8905
7009,Swansea,Bristol County,MA,Swansea,1992,11.8,1051,7887,8938
7010,Swansea,Bristol County,MA,Swansea,1993,11.4,1034,8050,9084
7011,Swansea,Bristol County,MA,Swansea,1994,8.3,748,8228,8976
7012,Swansea,Bristol County,MA,Swansea,1995,7.5,675,8271,8946
7013,Swansea,Bristol County,MA,Swansea,1996,6.9,613,8320,8933
7014,Swansea,Bristol County,MA,Swansea,1997,6,542,8486,9028
7015,Swansea,Bristol County,MA,Swansea,1998,4,353,8554,8907
7016,Swansea,Bristol County,MA,Swansea,1999,3.7,333,8567,8900
7017,Swansea,Bristol County,MA,Swansea,2000,3.8,340,8703,9043
7018,Swansea,Bristol County,MA,Swansea,2001,4.4,399,8663,9062
7019,Swansea,Bristol County,MA,Swansea,2002,5.5,506,8731,9237
7020,Swansea,Bristol County,MA,Swansea,2003,5.7,532,8813,9345
7021,Swansea,Bristol County,MA,Swansea,2004,5.6,525,8838,9363
7022,Swansea,Bristol County,MA,Swansea,2005,5.3,493,8864,9357
7023,Swansea,Bristol County,MA,Swansea,2006,5.7,544,8942,9486
7024,Swansea,Bristol County,MA,Swansea,2007,5.6,534,8973,9507
7025,Swansea,Bristol County,MA,Swansea,2008,6.8,643,8794,9437
7026,Swansea,Bristol County,MA,Swansea,2009,10.9,1022,8393,9415
7027,Swansea,Bristol County,MA,Swansea,2010,11.1,1021,8208,9229
7028,Swansea,Bristol County,MA,Swansea,2011,10.2,944,8268,9212
7029,Swansea,Bristol County,MA,Swansea,2012,9.6,879,8281,9160
7030,Taunton,Bristol County,MA,Taunton,1990,8.3,2236,24546,26782
7031,Taunton,Bristol County,MA,Taunton,1991,10.6,2826,23826,26652
7032,Taunton,Bristol County,MA,Taunton,1992,10.7,2859,23872,26731
7033,Taunton,Bristol County,MA,Taunton,1993,8.8,2342,24262,26604
7034,Taunton,Bristol County,MA,Taunton,1994,7.5,2006,24805,26811
7035,Taunton,Bristol County,MA,Taunton,1995,6.7,1813,25127,26940
7036,Taunton,Bristol County,MA,Taunton,1996,5.8,1571,25611,27182
7037,Taunton,Bristol County,MA,Taunton,1997,5,1378,26347,27725
7038,Taunton,Bristol County,MA,Taunton,1998,3.8,1073,26921,27994
7039,Taunton,Bristol County,MA,Taunton,1999,3.5,997,27314,28311
7040,Taunton,Bristol County,MA,Taunton,2000,2.9,888,29297,30185
7041,Taunton,Bristol County,MA,Taunton,2001,3.9,1186,29295,30481
7042,Taunton,Bristol County,MA,Taunton,2002,5.3,1640,29178,30818
7043,Taunton,Bristol County,MA,Taunton,2003,5.9,1828,29012,30840
7044,Taunton,Bristol County,MA,Taunton,2004,5.5,1683,28756,30439
7045,Taunton,Bristol County,MA,Taunton,2005,5.1,1577,29068,30645
7046,Taunton,Bristol County,MA,Taunton,2006,5.4,1664,29336,31000
7047,Taunton,Bristol County,MA,Taunton,2007,5.1,1577,29436,31013
7048,Taunton,Bristol County,MA,Taunton,2008,6.2,1951,29355,31306
7049,Taunton,Bristol County,MA,Taunton,2009,9.5,2960,28291,31251
7050,Taunton,Bristol County,MA,Taunton,2010,9.5,2951,28207,31158
7051,Taunton,Bristol County,MA,Taunton,2011,8.5,2653,28500,31153
7052,Taunton,Bristol County,MA,Taunton,2012,7.7,2378,28415,30793
7053,Templeton,Worcester County,MA,Templeton,1990,8.5,281,3042,3323
7054,Templeton,Worcester County,MA,Templeton,1991,11.5,389,3002,3391
7055,Templeton,Worcester County,MA,Templeton,1992,10.7,370,3103,3473
7056,Templeton,Worcester County,MA,Templeton,1993,7.6,257,3116,3373
7057,Templeton,Worcester County,MA,Templeton,1994,7.1,239,3104,3343
7058,Templeton,Worcester County,MA,Templeton,1995,6.7,234,3274,3508
7059,Templeton,Worcester County,MA,Templeton,1996,6.2,217,3281,3498
7060,Templeton,Worcester County,MA,Templeton,1997,5.4,191,3368,3559
7061,Templeton,Worcester County,MA,Templeton,1998,4.4,155,3387,3542
7062,Templeton,Worcester County,MA,Templeton,1999,4.4,158,3397,3555
7063,Templeton,Worcester County,MA,Templeton,2000,3.6,125,3363,3488
7064,Templeton,Worcester County,MA,Templeton,2001,4.4,155,3367,3522
7065,Templeton,Worcester County,MA,Templeton,2002,6.4,231,3397,3628
7066,Templeton,Worcester County,MA,Templeton,2003,7.3,269,3404,3673
7067,Templeton,Worcester County,MA,Templeton,2004,6.7,246,3417,3663
7068,Templeton,Worcester County,MA,Templeton,2005,7,259,3457,3716
7069,Templeton,Worcester County,MA,Templeton,2006,6.6,253,3583,3836
7070,Templeton,Worcester County,MA,Templeton,2007,5.7,222,3639,3861
7071,Templeton,Worcester County,MA,Templeton,2008,6.9,266,3612,3878
7072,Templeton,Worcester County,MA,Templeton,2009,10.5,407,3463,3870
7073,Templeton,Worcester County,MA,Templeton,2010,10.4,412,3564,3976
7074,Templeton,Worcester County,MA,Templeton,2011,9.3,364,3561,3925
7075,Templeton,Worcester County,MA,Templeton,2012,9,353,3558,3911
7076,Tewksbury,Middlesex County,MA,Tewksbury,1990,6.1,1007,15615,16622
7077,Tewksbury,Middlesex County,MA,Tewksbury,1991,8.5,1420,15208,16628
7078,Tewksbury,Middlesex County,MA,Tewksbury,1992,8.7,1471,15415,16886
7079,Tewksbury,Middlesex County,MA,Tewksbury,1993,7.4,1244,15493,16737
7080,Tewksbury,Middlesex County,MA,Tewksbury,1994,5.9,985,15635,16620
7081,Tewksbury,Middlesex County,MA,Tewksbury,1995,5.1,838,15435,16273
7082,Tewksbury,Middlesex County,MA,Tewksbury,1996,4.1,679,16031,16710
7083,Tewksbury,Middlesex County,MA,Tewksbury,1997,3.5,611,16725,17336
7084,Tewksbury,Middlesex County,MA,Tewksbury,1998,2.9,505,17033,17538
7085,Tewksbury,Middlesex County,MA,Tewksbury,1999,3,552,17576,18128
7086,Tewksbury,Middlesex County,MA,Tewksbury,2000,2.4,398,16224,16622
7087,Tewksbury,Middlesex County,MA,Tewksbury,2001,3.4,576,16349,16925
7088,Tewksbury,Middlesex County,MA,Tewksbury,2002,5.3,897,16096,16993
7089,Tewksbury,Middlesex County,MA,Tewksbury,2003,6,1002,15818,16820
7090,Tewksbury,Middlesex County,MA,Tewksbury,2004,5,823,15683,16506
7091,Tewksbury,Middlesex County,MA,Tewksbury,2005,4.7,775,15748,16523
7092,Tewksbury,Middlesex County,MA,Tewksbury,2006,4.4,740,15936,16676
7093,Tewksbury,Middlesex County,MA,Tewksbury,2007,4.2,700,16031,16731
7094,Tewksbury,Middlesex County,MA,Tewksbury,2008,4.9,815,15953,16768
7095,Tewksbury,Middlesex County,MA,Tewksbury,2009,7.6,1323,16042,17365
7096,Tewksbury,Middlesex County,MA,Tewksbury,2010,7.8,1292,15298,16590
7097,Tewksbury,Middlesex County,MA,Tewksbury,2011,6.7,1119,15459,16578
7098,Tewksbury,Middlesex County,MA,Tewksbury,2012,6.2,1026,15629,16655
7099,Tisbury,Dukes County,MA,Tisbury,1990,6.4,125,1838,1963
7100,Tisbury,Dukes County,MA,Tisbury,1991,8.5,174,1872,2046
7101,Tisbury,Dukes County,MA,Tisbury,1992,10.7,207,1736,1943
7102,Tisbury,Dukes County,MA,Tisbury,1993,9.9,196,1774,1970
7103,Tisbury,Dukes County,MA,Tisbury,1994,9.4,198,1905,2103
7104,Tisbury,Dukes County,MA,Tisbury,1995,7,151,1997,2148
7105,Tisbury,Dukes County,MA,Tisbury,1996,6.9,153,2074,2227
7106,Tisbury,Dukes County,MA,Tisbury,1997,6.3,143,2116,2259
7107,Tisbury,Dukes County,MA,Tisbury,1998,5.7,130,2154,2284
7108,Tisbury,Dukes County,MA,Tisbury,1999,5.2,121,2190,2311
7109,Tisbury,Dukes County,MA,Tisbury,2000,3.6,91,2420,2511
7110,Tisbury,Dukes County,MA,Tisbury,2001,3.8,96,2424,2520
7111,Tisbury,Dukes County,MA,Tisbury,2002,5.2,137,2507,2644
7112,Tisbury,Dukes County,MA,Tisbury,2003,5,137,2589,2726
7113,Tisbury,Dukes County,MA,Tisbury,2004,5.1,138,2594,2732
7114,Tisbury,Dukes County,MA,Tisbury,2005,4.9,132,2545,2677
7115,Tisbury,Dukes County,MA,Tisbury,2006,4.5,122,2573,2695
7116,Tisbury,Dukes County,MA,Tisbury,2007,4.3,116,2609,2725
7117,Tisbury,Dukes County,MA,Tisbury,2008,4.9,135,2606,2741
7118,Tisbury,Dukes County,MA,Tisbury,2009,7.4,205,2575,2780
7119,Tisbury,Dukes County,MA,Tisbury,2010,9.4,261,2518,2779
7120,Tisbury,Dukes County,MA,Tisbury,2011,8.3,231,2538,2769
7121,Tisbury,Dukes County,MA,Tisbury,2012,8.7,244,2563,2807
7122,Tolland,Hampden County,MA,Tolland,1990,4.6,6,125,131
7123,Tolland,Hampden County,MA,Tolland,1991,6.3,8,120,128
7124,Tolland,Hampden County,MA,Tolland,1992,8.8,13,135,148
7125,Tolland,Hampden County,MA,Tolland,1993,9.1,14,140,154
7126,Tolland,Hampden County,MA,Tolland,1994,8.9,14,143,157
7127,Tolland,Hampden County,MA,Tolland,1995,10.7,18,151,169
7128,Tolland,Hampden County,MA,Tolland,1996,7.6,12,145,157
7129,Tolland,Hampden County,MA,Tolland,1997,5.2,8,147,155
7130,Tolland,Hampden County,MA,Tolland,1998,3.1,5,154,159
7131,Tolland,Hampden County,MA,Tolland,1999,2.3,4,167,171
7132,Tolland,Hampden County,MA,Tolland,2000,2.1,5,234,239
7133,Tolland,Hampden County,MA,Tolland,2001,1.7,4,236,240
7134,Tolland,Hampden County,MA,Tolland,2002,2.5,6,235,241
7135,Tolland,Hampden County,MA,Tolland,2003,2.5,6,235,241
7136,Tolland,Hampden County,MA,Tolland,2004,3.2,8,239,247
7137,Tolland,Hampden County,MA,Tolland,2005,3.6,9,242,251
7138,Tolland,Hampden County,MA,Tolland,2006,2.4,6,244,250
7139,Tolland,Hampden County,MA,Tolland,2007,3.1,8,246,254
7140,Tolland,Hampden County,MA,Tolland,2008,3.1,8,248,256
7141,Tolland,Hampden County,MA,Tolland,2009,5.9,15,240,255
7142,Tolland,Hampden County,MA,Tolland,2010,4.9,13,252,265
7143,Tolland,Hampden County,MA,Tolland,2011,5,13,249,262
7144,Tolland,Hampden County,MA,Tolland,2012,3.9,10,249,259
7145,Topsfield,Essex County,MA,Topsfield,1990,3.8,111,2836,2947
7146,Topsfield,Essex County,MA,Topsfield,1991,5.6,163,2729,2892
7147,Topsfield,Essex County,MA,Topsfield,1992,6.2,181,2737,2918
7148,Topsfield,Essex County,MA,Topsfield,1993,5.3,156,2803,2959
7149,Topsfield,Essex County,MA,Topsfield,1994,3.8,113,2858,2971
7150,Topsfield,Essex County,MA,Topsfield,1995,3.2,97,2894,2991
7151,Topsfield,Essex County,MA,Topsfield,1996,2,63,3020,3083
7152,Topsfield,Essex County,MA,Topsfield,1997,2.3,73,3132,3205
7153,Topsfield,Essex County,MA,Topsfield,1998,2,64,3115,3179
7154,Topsfield,Essex County,MA,Topsfield,1999,1.9,60,3167,3227
7155,Topsfield,Essex County,MA,Topsfield,2000,2,60,2997,3057
7156,Topsfield,Essex County,MA,Topsfield,2001,2.6,81,3020,3101
7157,Topsfield,Essex County,MA,Topsfield,2002,4,124,2972,3096
7158,Topsfield,Essex County,MA,Topsfield,2003,4.1,126,2932,3058
7159,Topsfield,Essex County,MA,Topsfield,2004,3.8,116,2917,3033
7160,Topsfield,Essex County,MA,Topsfield,2005,3.4,102,2929,3031
7161,Topsfield,Essex County,MA,Topsfield,2006,3.6,107,2844,2951
7162,Topsfield,Essex County,MA,Topsfield,2007,3.3,99,2861,2960
7163,Topsfield,Essex County,MA,Topsfield,2008,4,119,2867,2986
7164,Topsfield,Essex County,MA,Topsfield,2009,6.5,193,2777,2970
7165,Topsfield,Essex County,MA,Topsfield,2010,6.5,194,2792,2986
7166,Topsfield,Essex County,MA,Topsfield,2011,5.5,166,2826,2992
7167,Topsfield,Essex County,MA,Topsfield,2012,4.7,142,2857,2999
7168,Townsend,Middlesex County,MA,Townsend,1990,5.1,236,4353,4589
7169,Townsend,Middlesex County,MA,Townsend,1991,7.4,336,4220,4556
7170,Townsend,Middlesex County,MA,Townsend,1992,7.2,333,4304,4637
7171,Townsend,Middlesex County,MA,Townsend,1993,6.2,289,4386,4675
7172,Townsend,Middlesex County,MA,Townsend,1994,5,241,4543,4784
7173,Townsend,Middlesex County,MA,Townsend,1995,4.8,229,4521,4750
7174,Townsend,Middlesex County,MA,Townsend,1996,3.9,190,4640,4830
7175,Townsend,Middlesex County,MA,Townsend,1997,3.5,176,4785,4961
7176,Townsend,Middlesex County,MA,Townsend,1998,2.7,135,4894,5029
7177,Townsend,Middlesex County,MA,Townsend,1999,3.1,159,4966,5125
7178,Townsend,Middlesex County,MA,Townsend,2000,2.3,120,5007,5127
7179,Townsend,Middlesex County,MA,Townsend,2001,3.4,176,4971,5147
7180,Townsend,Middlesex County,MA,Townsend,2002,5.2,267,4861,5128
7181,Townsend,Middlesex County,MA,Townsend,2003,5.5,287,4960,5247
7182,Townsend,Middlesex County,MA,Townsend,2004,5,261,4990,5251
7183,Townsend,Middlesex County,MA,Townsend,2005,4.3,226,5032,5258
7184,Townsend,Middlesex County,MA,Townsend,2006,4,211,5055,5266
7185,Townsend,Middlesex County,MA,Townsend,2007,3.9,205,5086,5291
7186,Townsend,Middlesex County,MA,Townsend,2008,4.6,247,5080,5327
7187,Townsend,Middlesex County,MA,Townsend,2009,7.2,388,5003,5391
7188,Townsend,Middlesex County,MA,Townsend,2010,8,410,4687,5097
7189,Townsend,Middlesex County,MA,Townsend,2011,6.3,318,4702,5020
7190,Townsend,Middlesex County,MA,Townsend,2012,6,303,4743,5046
7191,Truro,Barnstable County,MA,Truro,1990,10.8,127,1049,1176
7192,Truro,Barnstable County,MA,Truro,1991,15.7,196,1051,1247
7193,Truro,Barnstable County,MA,Truro,1992,16.2,200,1037,1237
7194,Truro,Barnstable County,MA,Truro,1993,16.1,212,1106,1318
7195,Truro,Barnstable County,MA,Truro,1994,16.5,222,1121,1343
7196,Truro,Barnstable County,MA,Truro,1995,13.8,188,1170,1358
7197,Truro,Barnstable County,MA,Truro,1996,13.8,188,1176,1364
7198,Truro,Barnstable County,MA,Truro,1997,13.9,191,1183,1374
7199,Truro,Barnstable County,MA,Truro,1998,11.1,150,1207,1357
7200,Truro,Barnstable County,MA,Truro,1999,10.9,153,1250,1403
7201,Truro,Barnstable County,MA,Truro,2000,7.5,85,1047,1132
7202,Truro,Barnstable County,MA,Truro,2001,7.4,85,1061,1146
7203,Truro,Barnstable County,MA,Truro,2002,8.5,101,1086,1187
7204,Truro,Barnstable County,MA,Truro,2003,8.8,107,1113,1220
7205,Truro,Barnstable County,MA,Truro,2004,9.2,114,1129,1243
7206,Truro,Barnstable County,MA,Truro,2005,8,98,1127,1225
7207,Truro,Barnstable County,MA,Truro,2006,8.1,100,1132,1232
7208,Truro,Barnstable County,MA,Truro,2007,7.5,91,1129,1220
7209,Truro,Barnstable County,MA,Truro,2008,10.1,126,1123,1249
7210,Truro,Barnstable County,MA,Truro,2009,13.1,164,1091,1255
7211,Truro,Barnstable County,MA,Truro,2010,14.5,177,1043,1220
7212,Truro,Barnstable County,MA,Truro,2011,14,169,1042,1211
7213,Truro,Barnstable County,MA,Truro,2012,13.1,160,1059,1219
7214,Tyngsborough,Middlesex County,MA,Tyngsborough,1990,6.7,343,4810,5153
7215,Tyngsborough,Middlesex County,MA,Tyngsborough,1991,9.3,485,4732,5217
7216,Tyngsborough,Middlesex County,MA,Tyngsborough,1992,9.8,519,4800,5319
7217,Tyngsborough,Middlesex County,MA,Tyngsborough,1993,8.2,438,4887,5325
7218,Tyngsborough,Middlesex County,MA,Tyngsborough,1994,7.1,386,5072,5458
7219,Tyngsborough,Middlesex County,MA,Tyngsborough,1995,6,323,5057,5380
7220,Tyngsborough,Middlesex County,MA,Tyngsborough,1996,4.2,234,5344,5578
7221,Tyngsborough,Middlesex County,MA,Tyngsborough,1997,3.6,209,5649,5858
7222,Tyngsborough,Middlesex County,MA,Tyngsborough,1998,3.3,203,5909,6112
7223,Tyngsborough,Middlesex County,MA,Tyngsborough,1999,3.3,212,6206,6418
7224,Tyngsborough,Middlesex County,MA,Tyngsborough,2000,2.4,153,6172,6325
7225,Tyngsborough,Middlesex County,MA,Tyngsborough,2001,3.6,236,6252,6488
7226,Tyngsborough,Middlesex County,MA,Tyngsborough,2002,5.2,340,6154,6494
7227,Tyngsborough,Middlesex County,MA,Tyngsborough,2003,6,385,6057,6442
7228,Tyngsborough,Middlesex County,MA,Tyngsborough,2004,4.7,302,6065,6367
7229,Tyngsborough,Middlesex County,MA,Tyngsborough,2005,4.4,282,6083,6365
7230,Tyngsborough,Middlesex County,MA,Tyngsborough,2006,4.2,272,6186,6458
7231,Tyngsborough,Middlesex County,MA,Tyngsborough,2007,4.2,278,6354,6632
7232,Tyngsborough,Middlesex County,MA,Tyngsborough,2008,4.7,317,6421,6738
7233,Tyngsborough,Middlesex County,MA,Tyngsborough,2009,7.6,510,6220,6730
7234,Tyngsborough,Middlesex County,MA,Tyngsborough,2010,8.3,532,5901,6433
7235,Tyngsborough,Middlesex County,MA,Tyngsborough,2011,7.2,463,5965,6428
7236,Tyngsborough,Middlesex County,MA,Tyngsborough,2012,6.6,427,6031,6458
7237,Tyringham,Berkshire County,MA,Tyringham,1990,2.8,6,206,212
7238,Tyringham,Berkshire County,MA,Tyringham,1991,3.8,8,204,212
7239,Tyringham,Berkshire County,MA,Tyringham,1992,3.9,8,196,204
7240,Tyringham,Berkshire County,MA,Tyringham,1993,4,9,216,225
7241,Tyringham,Berkshire County,MA,Tyringham,1994,2.8,6,205,211
7242,Tyringham,Berkshire County,MA,Tyringham,1995,1.8,4,222,226
7243,Tyringham,Berkshire County,MA,Tyringham,1996,3,7,228,235
7244,Tyringham,Berkshire County,MA,Tyringham,1997,1.7,4,232,236
7245,Tyringham,Berkshire County,MA,Tyringham,1998,1.3,3,229,232
7246,Tyringham,Berkshire County,MA,Tyringham,1999,0.9,2,226,228
7247,Tyringham,Berkshire County,MA,Tyringham,2000,0.8,2,237,239
7248,Tyringham,Berkshire County,MA,Tyringham,2001,1.6,4,249,253
7249,Tyringham,Berkshire County,MA,Tyringham,2002,1.5,4,261,265
7250,Tyringham,Berkshire County,MA,Tyringham,2003,2.3,6,259,265
7251,Tyringham,Berkshire County,MA,Tyringham,2004,2.3,6,255,261
7252,Tyringham,Berkshire County,MA,Tyringham,2005,3,8,258,266
7253,Tyringham,Berkshire County,MA,Tyringham,2006,2.3,6,257,263
7254,Tyringham,Berkshire County,MA,Tyringham,2007,2.3,6,251,257
7255,Tyringham,Berkshire County,MA,Tyringham,2008,3.5,9,248,257
7256,Tyringham,Berkshire County,MA,Tyringham,2009,5.1,13,242,255
7257,Tyringham,Berkshire County,MA,Tyringham,2010,5.3,13,234,247
7258,Tyringham,Berkshire County,MA,Tyringham,2011,2.9,7,235,242
7259,Tyringham,Berkshire County,MA,Tyringham,2012,2.5,6,233,239
7260,Upton,Worcester County,MA,Upton,1990,6.2,166,2502,2668
7261,Upton,Worcester County,MA,Upton,1991,7.6,203,2480,2683
7262,Upton,Worcester County,MA,Upton,1992,8.5,237,2537,2774
7263,Upton,Worcester County,MA,Upton,1993,6,170,2667,2837
7264,Upton,Worcester County,MA,Upton,1994,5.4,160,2777,2937
7265,Upton,Worcester County,MA,Upton,1995,4.6,134,2749,2883
7266,Upton,Worcester County,MA,Upton,1996,4.2,124,2851,2975
7267,Upton,Worcester County,MA,Upton,1997,3.5,107,2975,3082
7268,Upton,Worcester County,MA,Upton,1998,2.6,81,3062,3143
7269,Upton,Worcester County,MA,Upton,1999,2.3,75,3122,3197
7270,Upton,Worcester County,MA,Upton,2000,2.2,66,2939,3005
7271,Upton,Worcester County,MA,Upton,2001,3.4,106,3012,3118
7272,Upton,Worcester County,MA,Upton,2002,6.2,202,3031,3233
7273,Upton,Worcester County,MA,Upton,2003,6.6,213,3029,3242
7274,Upton,Worcester County,MA,Upton,2004,5.2,170,3080,3250
7275,Upton,Worcester County,MA,Upton,2005,4.6,154,3195,3349
7276,Upton,Worcester County,MA,Upton,2006,4.4,151,3258,3409
7277,Upton,Worcester County,MA,Upton,2007,4.3,149,3319,3468
7278,Upton,Worcester County,MA,Upton,2008,5.1,181,3380,3561
7279,Upton,Worcester County,MA,Upton,2009,7.8,279,3287,3566
7280,Upton,Worcester County,MA,Upton,2010,7.3,286,3654,3940
7281,Upton,Worcester County,MA,Upton,2011,6,233,3665,3898
7282,Upton,Worcester County,MA,Upton,2012,5.7,224,3699,3923
7283,Uxbridge,Worcester County,MA,Uxbridge,1990,7.1,401,5213,5614
7284,Uxbridge,Worcester County,MA,Uxbridge,1991,9.8,550,5079,5629
7285,Uxbridge,Worcester County,MA,Uxbridge,1992,8,455,5209,5664
7286,Uxbridge,Worcester County,MA,Uxbridge,1993,7,416,5515,5931
7287,Uxbridge,Worcester County,MA,Uxbridge,1994,4.7,284,5695,5979
7288,Uxbridge,Worcester County,MA,Uxbridge,1995,4.9,276,5394,5670
7289,Uxbridge,Worcester County,MA,Uxbridge,1996,4.4,257,5521,5778
7290,Uxbridge,Worcester County,MA,Uxbridge,1997,3.7,220,5702,5922
7291,Uxbridge,Worcester County,MA,Uxbridge,1998,3,179,5860,6039
7292,Uxbridge,Worcester County,MA,Uxbridge,1999,2.7,165,5951,6116
7293,Uxbridge,Worcester County,MA,Uxbridge,2000,2.4,150,6083,6233
7294,Uxbridge,Worcester County,MA,Uxbridge,2001,3.8,244,6203,6447
7295,Uxbridge,Worcester County,MA,Uxbridge,2002,5.1,336,6234,6570
7296,Uxbridge,Worcester County,MA,Uxbridge,2003,5.6,374,6322,6696
7297,Uxbridge,Worcester County,MA,Uxbridge,2004,5.2,351,6405,6756
7298,Uxbridge,Worcester County,MA,Uxbridge,2005,4.6,314,6473,6787
7299,Uxbridge,Worcester County,MA,Uxbridge,2006,4.7,327,6618,6945
7300,Uxbridge,Worcester County,MA,Uxbridge,2007,4.7,329,6677,7006
7301,Uxbridge,Worcester County,MA,Uxbridge,2008,6,418,6574,6992
7302,Uxbridge,Worcester County,MA,Uxbridge,2009,8.9,630,6411,7041
7303,Uxbridge,Worcester County,MA,Uxbridge,2010,8.2,599,6719,7318
7304,Uxbridge,Worcester County,MA,Uxbridge,2011,7.4,538,6779,7317
7305,Uxbridge,Worcester County,MA,Uxbridge,2012,7.1,520,6777,7297
7306,Wakefield,Middlesex County,MA,Wakefield,1990,5.5,761,13135,13896
7307,Wakefield,Middlesex County,MA,Wakefield,1991,7.3,1005,12784,13789
7308,Wakefield,Middlesex County,MA,Wakefield,1992,7.6,1048,12735,13783
7309,Wakefield,Middlesex County,MA,Wakefield,1993,5.9,813,12906,13719
7310,Wakefield,Middlesex County,MA,Wakefield,1994,5.1,699,13054,13753
7311,Wakefield,Middlesex County,MA,Wakefield,1995,4.4,592,12906,13498
7312,Wakefield,Middlesex County,MA,Wakefield,1996,3.4,464,13173,13637
7313,Wakefield,Middlesex County,MA,Wakefield,1997,3,418,13486,13904
7314,Wakefield,Middlesex County,MA,Wakefield,1998,2.6,364,13674,14038
7315,Wakefield,Middlesex County,MA,Wakefield,1999,2.7,391,13833,14224
7316,Wakefield,Middlesex County,MA,Wakefield,2000,2.2,310,13649,13959
7317,Wakefield,Middlesex County,MA,Wakefield,2001,3.4,472,13586,14058
7318,Wakefield,Middlesex County,MA,Wakefield,2002,4.9,682,13298,13980
7319,Wakefield,Middlesex County,MA,Wakefield,2003,5.3,728,13090,13818
7320,Wakefield,Middlesex County,MA,Wakefield,2004,4.7,636,13010,13646
7321,Wakefield,Middlesex County,MA,Wakefield,2005,4.3,596,13155,13751
7322,Wakefield,Middlesex County,MA,Wakefield,2006,4.4,592,12972,13564
7323,Wakefield,Middlesex County,MA,Wakefield,2007,4.1,561,13101,13662
7324,Wakefield,Middlesex County,MA,Wakefield,2008,4.9,681,13153,13834
7325,Wakefield,Middlesex County,MA,Wakefield,2009,7.5,1041,12870,13911
7326,Wakefield,Middlesex County,MA,Wakefield,2010,7.2,1005,12926,13931
7327,Wakefield,Middlesex County,MA,Wakefield,2011,6,831,13117,13948
7328,Wakefield,Middlesex County,MA,Wakefield,2012,5.3,738,13260,13998
7329,Wales,Hampden County,MA,Wales,1990,7.3,62,791,853
7330,Wales,Hampden County,MA,Wales,1991,9.9,87,788,875
7331,Wales,Hampden County,MA,Wales,1992,9.4,80,772,852
7332,Wales,Hampden County,MA,Wales,1993,10.6,95,800,895
7333,Wales,Hampden County,MA,Wales,1994,7.5,64,788,852
7334,Wales,Hampden County,MA,Wales,1995,5.4,49,857,906
7335,Wales,Hampden County,MA,Wales,1996,6.3,61,901,962
7336,Wales,Hampden County,MA,Wales,1997,6.1,58,894,952
7337,Wales,Hampden County,MA,Wales,1998,4.3,38,849,887
7338,Wales,Hampden County,MA,Wales,1999,4.2,36,823,859
7339,Wales,Hampden County,MA,Wales,2000,2.8,28,976,1004
7340,Wales,Hampden County,MA,Wales,2001,4,41,983,1024
7341,Wales,Hampden County,MA,Wales,2002,5,52,983,1035
7342,Wales,Hampden County,MA,Wales,2003,6.1,64,981,1045
7343,Wales,Hampden County,MA,Wales,2004,6,63,988,1051
7344,Wales,Hampden County,MA,Wales,2005,4.6,48,1005,1053
7345,Wales,Hampden County,MA,Wales,2006,5.5,59,1022,1081
7346,Wales,Hampden County,MA,Wales,2007,5.3,58,1027,1085
7347,Wales,Hampden County,MA,Wales,2008,5.9,65,1039,1104
7348,Wales,Hampden County,MA,Wales,2009,8.6,94,1002,1096
7349,Wales,Hampden County,MA,Wales,2010,8.9,95,971,1066
7350,Wales,Hampden County,MA,Wales,2011,8.4,88,962,1050
7351,Wales,Hampden County,MA,Wales,2012,7.6,79,962,1041
7352,Walpole,Norfolk County,MA,Walpole,1990,5,570,10765,11335
7353,Walpole,Norfolk County,MA,Walpole,1991,7.6,862,10522,11384
7354,Walpole,Norfolk County,MA,Walpole,1992,7.1,815,10602,11417
7355,Walpole,Norfolk County,MA,Walpole,1993,5.8,676,10939,11615
7356,Walpole,Norfolk County,MA,Walpole,1994,4.7,560,11372,11932
7357,Walpole,Norfolk County,MA,Walpole,1995,4.1,491,11572,12063
7358,Walpole,Norfolk County,MA,Walpole,1996,3.5,430,11873,12303
7359,Walpole,Norfolk County,MA,Walpole,1997,3,380,12264,12644
7360,Walpole,Norfolk County,MA,Walpole,1998,2.4,313,12599,12912
7361,Walpole,Norfolk County,MA,Walpole,1999,2.2,291,12754,13045
7362,Walpole,Norfolk County,MA,Walpole,2000,2.3,282,11938,12220
7363,Walpole,Norfolk County,MA,Walpole,2001,3.2,392,11963,12355
7364,Walpole,Norfolk County,MA,Walpole,2002,4.3,531,11817,12348
7365,Walpole,Norfolk County,MA,Walpole,2003,5.1,621,11671,12292
7366,Walpole,Norfolk County,MA,Walpole,2004,4.2,518,11671,12189
7367,Walpole,Norfolk County,MA,Walpole,2005,4,489,11744,12233
7368,Walpole,Norfolk County,MA,Walpole,2006,4.2,505,11557,12062
7369,Walpole,Norfolk County,MA,Walpole,2007,4,484,11723,12207
7370,Walpole,Norfolk County,MA,Walpole,2008,4.5,553,11744,12297
7371,Walpole,Norfolk County,MA,Walpole,2009,7.1,864,11370,12234
7372,Walpole,Norfolk County,MA,Walpole,2010,7.1,901,11846,12747
7373,Walpole,Norfolk County,MA,Walpole,2011,6,762,11978,12740
7374,Walpole,Norfolk County,MA,Walpole,2012,5.4,685,12109,12794
7375,Waltham,Middlesex County,MA,Waltham,1990,5.5,1858,32209,34067
7376,Waltham,Middlesex County,MA,Waltham,1991,7.3,2393,30522,32915
7377,Waltham,Middlesex County,MA,Waltham,1992,8,2568,29584,32152
7378,Waltham,Middlesex County,MA,Waltham,1993,6.8,2176,29613,31789
7379,Waltham,Middlesex County,MA,Waltham,1994,5.9,1876,29899,31775
7380,Waltham,Middlesex County,MA,Waltham,1995,4.6,1512,31429,32941
7381,Waltham,Middlesex County,MA,Waltham,1996,3.8,1260,32042,33302
7382,Waltham,Middlesex County,MA,Waltham,1997,3.2,1088,33133,34221
7383,Waltham,Middlesex County,MA,Waltham,1998,2.6,890,33844,34734
7384,Waltham,Middlesex County,MA,Waltham,1999,2.5,867,34249,35116
7385,Waltham,Middlesex County,MA,Waltham,2000,2.3,818,34367,35185
7386,Waltham,Middlesex County,MA,Waltham,2001,3.4,1189,34157,35346
7387,Waltham,Middlesex County,MA,Waltham,2002,5.1,1777,33408,35185
7388,Waltham,Middlesex County,MA,Waltham,2003,5.4,1889,32830,34719
7389,Waltham,Middlesex County,MA,Waltham,2004,4.6,1582,33098,34680
7390,Waltham,Middlesex County,MA,Waltham,2005,4.2,1465,33627,35092
7391,Waltham,Middlesex County,MA,Waltham,2006,3.9,1361,33986,35347
7392,Waltham,Middlesex County,MA,Waltham,2007,3.6,1283,33907,35190
7393,Waltham,Middlesex County,MA,Waltham,2008,4.3,1539,33917,35456
7394,Waltham,Middlesex County,MA,Waltham,2009,6.6,2323,32655,34978
7395,Waltham,Middlesex County,MA,Waltham,2010,6.5,2289,33160,35449
7396,Waltham,Middlesex County,MA,Waltham,2011,5.5,1965,33604,35569
7397,Waltham,Middlesex County,MA,Waltham,2012,5,1801,33972,35773
7398,Ware,Hampshire County,MA,Ware,1990,7.3,365,4605,4970
7399,Ware,Hampshire County,MA,Ware,1991,10.5,523,4457,4980
7400,Ware,Hampshire County,MA,Ware,1992,9.2,448,4434,4882
7401,Ware,Hampshire County,MA,Ware,1993,8.5,409,4395,4804
7402,Ware,Hampshire County,MA,Ware,1994,7.1,337,4428,4765
7403,Ware,Hampshire County,MA,Ware,1995,5.7,268,4455,4723
7404,Ware,Hampshire County,MA,Ware,1996,5,236,4528,4764
7405,Ware,Hampshire County,MA,Ware,1997,4,193,4618,4811
7406,Ware,Hampshire County,MA,Ware,1998,4.8,233,4626,4859
7407,Ware,Hampshire County,MA,Ware,1999,4.3,210,4652,4862
7408,Ware,Hampshire County,MA,Ware,2000,2.9,150,5004,5154
7409,Ware,Hampshire County,MA,Ware,2001,4,210,5006,5216
7410,Ware,Hampshire County,MA,Ware,2002,5,263,4984,5247
7411,Ware,Hampshire County,MA,Ware,2003,6.1,324,4969,5293
7412,Ware,Hampshire County,MA,Ware,2004,5.9,316,5055,5371
7413,Ware,Hampshire County,MA,Ware,2005,5.4,291,5072,5363
7414,Ware,Hampshire County,MA,Ware,2006,5.7,308,5095,5403
7415,Ware,Hampshire County,MA,Ware,2007,5.8,315,5084,5399
7416,Ware,Hampshire County,MA,Ware,2008,6.5,344,4984,5328
7417,Ware,Hampshire County,MA,Ware,2009,9.4,497,4763,5260
7418,Ware,Hampshire County,MA,Ware,2010,9.5,503,4792,5295
7419,Ware,Hampshire County,MA,Ware,2011,9,467,4733,5200
7420,Ware,Hampshire County,MA,Ware,2012,8.3,430,4735,5165
7421,Wareham,Plymouth County,MA,Wareham,1990,9.5,865,8268,9133
7422,Wareham,Plymouth County,MA,Wareham,1991,12.5,1147,8058,9205
7423,Wareham,Plymouth County,MA,Wareham,1992,12.6,1157,8043,9200
7424,Wareham,Plymouth County,MA,Wareham,1993,11,1018,8195,9213
7425,Wareham,Plymouth County,MA,Wareham,1994,9,839,8463,9302
7426,Wareham,Plymouth County,MA,Wareham,1995,8.3,748,8270,9018
7427,Wareham,Plymouth County,MA,Wareham,1996,6.9,623,8437,9060
7428,Wareham,Plymouth County,MA,Wareham,1997,6.5,598,8669,9267
7429,Wareham,Plymouth County,MA,Wareham,1998,5.2,481,8825,9306
7430,Wareham,Plymouth County,MA,Wareham,1999,4.6,432,8959,9391
7431,Wareham,Plymouth County,MA,Wareham,2000,3.4,373,10508,10881
7432,Wareham,Plymouth County,MA,Wareham,2001,4.1,457,10652,11109
7433,Wareham,Plymouth County,MA,Wareham,2002,5.4,619,10886,11505
7434,Wareham,Plymouth County,MA,Wareham,2003,6,714,11142,11856
7435,Wareham,Plymouth County,MA,Wareham,2004,5.7,686,11361,12047
7436,Wareham,Plymouth County,MA,Wareham,2005,5.5,661,11447,12108
7437,Wareham,Plymouth County,MA,Wareham,2006,5.4,656,11572,12228
7438,Wareham,Plymouth County,MA,Wareham,2007,5.4,664,11548,12212
7439,Wareham,Plymouth County,MA,Wareham,2008,6.6,818,11568,12386
7440,Wareham,Plymouth County,MA,Wareham,2009,9.5,1188,11316,12504
7441,Wareham,Plymouth County,MA,Wareham,2010,9.2,1195,11730,12925
7442,Wareham,Plymouth County,MA,Wareham,2011,8.4,1082,11781,12863
7443,Wareham,Plymouth County,MA,Wareham,2012,7.8,1017,11979,12996
7444,Warren,Worcester County,MA,Warren,1990,6.2,142,2138,2280
7445,Warren,Worcester County,MA,Warren,1991,8.7,194,2045,2239
7446,Warren,Worcester County,MA,Warren,1992,9.7,210,1965,2175
7447,Warren,Worcester County,MA,Warren,1993,9.4,203,1959,2162
7448,Warren,Worcester County,MA,Warren,1994,8.5,182,1955,2137
7449,Warren,Worcester County,MA,Warren,1995,5.3,131,2364,2495
7450,Warren,Worcester County,MA,Warren,1996,5.2,136,2493,2629
7451,Warren,Worcester County,MA,Warren,1997,4.6,119,2491,2610
7452,Warren,Worcester County,MA,Warren,1998,4.6,115,2411,2526
7453,Warren,Worcester County,MA,Warren,1999,4.4,109,2352,2461
7454,Warren,Worcester County,MA,Warren,2000,3,71,2270,2341
7455,Warren,Worcester County,MA,Warren,2001,3.9,91,2257,2348
7456,Warren,Worcester County,MA,Warren,2002,5.5,131,2256,2387
7457,Warren,Worcester County,MA,Warren,2003,6.7,163,2265,2428
7458,Warren,Worcester County,MA,Warren,2004,6.8,167,2287,2454
7459,Warren,Worcester County,MA,Warren,2005,5.9,144,2309,2453
7460,Warren,Worcester County,MA,Warren,2006,6.9,178,2401,2579
7461,Warren,Worcester County,MA,Warren,2007,6.6,171,2411,2582
7462,Warren,Worcester County,MA,Warren,2008,6.6,166,2368,2534
7463,Warren,Worcester County,MA,Warren,2009,9.2,234,2308,2542
7464,Warren,Worcester County,MA,Warren,2010,10.3,258,2250,2508
7465,Warren,Worcester County,MA,Warren,2011,8.3,205,2269,2474
7466,Warren,Worcester County,MA,Warren,2012,8,197,2269,2466
7467,Warwick,Franklin County,MA,Warwick,1990,5.4,19,333,352
7468,Warwick,Franklin County,MA,Warwick,1991,9.1,31,311,342
7469,Warwick,Franklin County,MA,Warwick,1992,9.7,32,297,329
7470,Warwick,Franklin County,MA,Warwick,1993,8.9,27,275,302
7471,Warwick,Franklin County,MA,Warwick,1994,7.9,23,269,292
7472,Warwick,Franklin County,MA,Warwick,1995,5.3,18,320,338
7473,Warwick,Franklin County,MA,Warwick,1996,3.9,13,318,331
7474,Warwick,Franklin County,MA,Warwick,1997,4.5,15,322,337
7475,Warwick,Franklin County,MA,Warwick,1998,4.3,14,311,325
7476,Warwick,Franklin County,MA,Warwick,1999,5.8,19,311,330
7477,Warwick,Franklin County,MA,Warwick,2000,3.7,14,363,377
7478,Warwick,Franklin County,MA,Warwick,2001,3.3,12,356,368
7479,Warwick,Franklin County,MA,Warwick,2002,4.8,18,357,375
7480,Warwick,Franklin County,MA,Warwick,2003,6.9,26,350,376
7481,Warwick,Franklin County,MA,Warwick,2004,6.5,24,345,369
7482,Warwick,Franklin County,MA,Warwick,2005,6.8,25,343,368
7483,Warwick,Franklin County,MA,Warwick,2006,7.1,26,342,368
7484,Warwick,Franklin County,MA,Warwick,2007,4.3,15,334,349
7485,Warwick,Franklin County,MA,Warwick,2008,4.5,16,337,353
7486,Warwick,Franklin County,MA,Warwick,2009,8.5,30,321,351
7487,Warwick,Franklin County,MA,Warwick,2010,9.5,35,333,368
7488,Warwick,Franklin County,MA,Warwick,2011,7.5,27,332,359
7489,Warwick,Franklin County,MA,Warwick,2012,6.7,24,334,358
7490,Washington,Berkshire County,MA,Washington,1990,4.8,14,280,294
7491,Washington,Berkshire County,MA,Washington,1991,9.1,27,271,298
7492,Washington,Berkshire County,MA,Washington,1992,9,28,284,312
7493,Washington,Berkshire County,MA,Washington,1993,4.4,14,301,315
7494,Washington,Berkshire County,MA,Washington,1994,4.5,15,315,330
7495,Washington,Berkshire County,MA,Washington,1995,4.3,15,334,349
7496,Washington,Berkshire County,MA,Washington,1996,4.1,14,324,338
7497,Washington,Berkshire County,MA,Washington,1997,4.1,14,326,340
7498,Washington,Berkshire County,MA,Washington,1998,3.1,11,339,350
7499,Washington,Berkshire County,MA,Washington,1999,3.9,15,367,382
7500,Washington,Berkshire County,MA,Washington,2000,3.5,11,300,311
7501,Washington,Berkshire County,MA,Washington,2001,3.9,12,299,311
7502,Washington,Berkshire County,MA,Washington,2002,3.8,12,304,316
7503,Washington,Berkshire County,MA,Washington,2003,5.6,18,303,321
7504,Washington,Berkshire County,MA,Washington,2004,4.1,13,305,318
7505,Washington,Berkshire County,MA,Washington,2005,4,13,312,325
7506,Washington,Berkshire County,MA,Washington,2006,3.6,12,320,332
7507,Washington,Berkshire County,MA,Washington,2007,4.5,15,321,336
7508,Washington,Berkshire County,MA,Washington,2008,4.8,16,315,331
7509,Washington,Berkshire County,MA,Washington,2009,7,23,306,329
7510,Washington,Berkshire County,MA,Washington,2010,9.3,30,294,324
7511,Washington,Berkshire County,MA,Washington,2011,6.3,20,296,316
7512,Washington,Berkshire County,MA,Washington,2012,5.1,16,295,311
7513,Watertown,Middlesex County,MA,Watertown,1990,4.2,856,19591,20447
7514,Watertown,Middlesex County,MA,Watertown,1991,5.5,1100,18723,19823
7515,Watertown,Middlesex County,MA,Watertown,1992,6.1,1188,18216,19404
7516,Watertown,Middlesex County,MA,Watertown,1993,5.5,1057,18141,19198
7517,Watertown,Middlesex County,MA,Watertown,1994,4.6,876,18176,19052
7518,Watertown,Middlesex County,MA,Watertown,1995,3.9,762,18967,19729
7519,Watertown,Middlesex County,MA,Watertown,1996,3.2,644,19278,19922
7520,Watertown,Middlesex County,MA,Watertown,1997,2.5,505,19733,20238
7521,Watertown,Middlesex County,MA,Watertown,1998,2.1,425,19910,20335
7522,Watertown,Middlesex County,MA,Watertown,1999,2.2,446,19976,20422
7523,Watertown,Middlesex County,MA,Watertown,2000,2,414,19938,20352
7524,Watertown,Middlesex County,MA,Watertown,2001,3.2,661,19810,20471
7525,Watertown,Middlesex County,MA,Watertown,2002,4.7,959,19355,20314
7526,Watertown,Middlesex County,MA,Watertown,2003,4.8,969,19116,20085
7527,Watertown,Middlesex County,MA,Watertown,2004,3.9,770,18982,19752
7528,Watertown,Middlesex County,MA,Watertown,2005,3.6,700,19005,19705
7529,Watertown,Middlesex County,MA,Watertown,2006,3.5,699,19050,19749
7530,Watertown,Middlesex County,MA,Watertown,2007,3.2,640,19167,19807
7531,Watertown,Middlesex County,MA,Watertown,2008,3.8,751,19132,19883
7532,Watertown,Middlesex County,MA,Watertown,2009,6.2,1221,18593,19814
7533,Watertown,Middlesex County,MA,Watertown,2010,6.2,1205,18187,19392
7534,Watertown,Middlesex County,MA,Watertown,2011,5.2,1006,18456,19462
7535,Watertown,Middlesex County,MA,Watertown,2012,4.7,918,18658,19576
7536,Wayland,Middlesex County,MA,Wayland,1990,3.5,228,6318,6546
7537,Wayland,Middlesex County,MA,Wayland,1991,4.3,278,6168,6446
7538,Wayland,Middlesex County,MA,Wayland,1992,4.6,300,6220,6520
7539,Wayland,Middlesex County,MA,Wayland,1993,4.1,273,6308,6581
7540,Wayland,Middlesex County,MA,Wayland,1994,3.3,221,6443,6664
7541,Wayland,Middlesex County,MA,Wayland,1995,2.8,183,6287,6470
7542,Wayland,Middlesex County,MA,Wayland,1996,2.1,138,6444,6582
7543,Wayland,Middlesex County,MA,Wayland,1997,1.8,125,6682,6807
7544,Wayland,Middlesex County,MA,Wayland,1998,1.4,100,6800,6900
7545,Wayland,Middlesex County,MA,Wayland,1999,1.7,118,6899,7017
7546,Wayland,Middlesex County,MA,Wayland,2000,1.9,129,6721,6850
7547,Wayland,Middlesex County,MA,Wayland,2001,2.8,197,6728,6925
7548,Wayland,Middlesex County,MA,Wayland,2002,4.3,297,6601,6898
7549,Wayland,Middlesex County,MA,Wayland,2003,4.3,293,6483,6776
7550,Wayland,Middlesex County,MA,Wayland,2004,3.7,248,6442,6690
7551,Wayland,Middlesex County,MA,Wayland,2005,3.1,210,6480,6690
7552,Wayland,Middlesex County,MA,Wayland,2006,3.2,212,6453,6665
7553,Wayland,Middlesex County,MA,Wayland,2007,2.9,197,6523,6720
7554,Wayland,Middlesex County,MA,Wayland,2008,3.6,246,6563,6809
7555,Wayland,Middlesex County,MA,Wayland,2009,5.7,389,6421,6810
7556,Wayland,Middlesex County,MA,Wayland,2010,5.9,392,6272,6664
7557,Wayland,Middlesex County,MA,Wayland,2011,4.9,325,6365,6690
7558,Wayland,Middlesex County,MA,Wayland,2012,4.5,303,6435,6738
7559,Webster,Worcester County,MA,Webster,1990,8.2,689,7716,8405
7560,Webster,Worcester County,MA,Webster,1991,10.2,848,7448,8296
7561,Webster,Worcester County,MA,Webster,1992,10.7,894,7464,8358
7562,Webster,Worcester County,MA,Webster,1993,8.4,697,7598,8295
7563,Webster,Worcester County,MA,Webster,1994,6.1,505,7710,8215
7564,Webster,Worcester County,MA,Webster,1995,6.2,506,7634,8140
7565,Webster,Worcester County,MA,Webster,1996,4.9,398,7727,8125
7566,Webster,Worcester County,MA,Webster,1997,4.4,367,7895,8262
7567,Webster,Worcester County,MA,Webster,1998,4.4,383,8228,8611
7568,Webster,Worcester County,MA,Webster,1999,4,336,8167,8503
7569,Webster,Worcester County,MA,Webster,2000,3.4,277,7973,8250
7570,Webster,Worcester County,MA,Webster,2001,4.3,361,7969,8330
7571,Webster,Worcester County,MA,Webster,2002,6,508,7934,8442
7572,Webster,Worcester County,MA,Webster,2003,7.3,622,7932,8554
7573,Webster,Worcester County,MA,Webster,2004,6.4,543,7910,8453
7574,Webster,Worcester County,MA,Webster,2005,5.8,486,7872,8358
7575,Webster,Worcester County,MA,Webster,2006,6.1,513,7910,8423
7576,Webster,Worcester County,MA,Webster,2007,6,502,7914,8416
7577,Webster,Worcester County,MA,Webster,2008,7.1,589,7745,8334
7578,Webster,Worcester County,MA,Webster,2009,10.7,898,7520,8418
7579,Webster,Worcester County,MA,Webster,2010,10.2,851,7497,8348
7580,Webster,Worcester County,MA,Webster,2011,9.3,773,7563,8336
7581,Webster,Worcester County,MA,Webster,2012,8.7,717,7561,8278
7582,Wellesley,Norfolk County,MA,Wellesley,1990,2.6,353,13337,13690
7583,Wellesley,Norfolk County,MA,Wellesley,1991,3.4,452,12811,13263
7584,Wellesley,Norfolk County,MA,Wellesley,1992,3.6,484,12867,13351
7585,Wellesley,Norfolk County,MA,Wellesley,1993,3.1,412,13061,13473
7586,Wellesley,Norfolk County,MA,Wellesley,1994,2.7,369,13263,13632
7587,Wellesley,Norfolk County,MA,Wellesley,1995,2.4,326,13273,13599
7588,Wellesley,Norfolk County,MA,Wellesley,1996,1.6,219,13496,13715
7589,Wellesley,Norfolk County,MA,Wellesley,1997,1.4,202,13806,14008
7590,Wellesley,Norfolk County,MA,Wellesley,1998,1.4,199,13944,14143
7591,Wellesley,Norfolk County,MA,Wellesley,1999,1.3,191,14000,14191
7592,Wellesley,Norfolk County,MA,Wellesley,2000,1.8,235,13111,13346
7593,Wellesley,Norfolk County,MA,Wellesley,2001,2.5,340,13050,13390
7594,Wellesley,Norfolk County,MA,Wellesley,2002,3.7,499,12817,13316
7595,Wellesley,Norfolk County,MA,Wellesley,2003,3.8,494,12597,13091
7596,Wellesley,Norfolk County,MA,Wellesley,2004,3.5,453,12581,13034
7597,Wellesley,Norfolk County,MA,Wellesley,2005,3.2,424,12723,13147
7598,Wellesley,Norfolk County,MA,Wellesley,2006,3,390,12567,12957
7599,Wellesley,Norfolk County,MA,Wellesley,2007,3,395,12718,13113
7600,Wellesley,Norfolk County,MA,Wellesley,2008,3.6,482,12740,13222
7601,Wellesley,Norfolk County,MA,Wellesley,2009,5.7,742,12330,13072
7602,Wellesley,Norfolk County,MA,Wellesley,2010,5.2,705,12782,13487
7603,Wellesley,Norfolk County,MA,Wellesley,2011,4.4,598,12915,13513
7604,Wellesley,Norfolk County,MA,Wellesley,2012,4.1,565,13057,13622
7605,Wellfleet,Barnstable County,MA,Wellfleet,1990,8.6,157,1663,1820
7606,Wellfleet,Barnstable County,MA,Wellfleet,1991,11.3,212,1672,1884
7607,Wellfleet,Barnstable County,MA,Wellfleet,1992,12.9,251,1695,1946
7608,Wellfleet,Barnstable County,MA,Wellfleet,1993,11.5,231,1782,2013
7609,Wellfleet,Barnstable County,MA,Wellfleet,1994,11.7,239,1799,2038
7610,Wellfleet,Barnstable County,MA,Wellfleet,1995,11.5,239,1835,2074
7611,Wellfleet,Barnstable County,MA,Wellfleet,1996,7.8,156,1844,2000
7612,Wellfleet,Barnstable County,MA,Wellfleet,1997,7.6,152,1845,1997
7613,Wellfleet,Barnstable County,MA,Wellfleet,1998,7.6,154,1872,2026
7614,Wellfleet,Barnstable County,MA,Wellfleet,1999,6.5,133,1915,2048
7615,Wellfleet,Barnstable County,MA,Wellfleet,2000,4.8,74,1459,1533
7616,Wellfleet,Barnstable County,MA,Wellfleet,2001,5.2,81,1476,1557
7617,Wellfleet,Barnstable County,MA,Wellfleet,2002,6.2,99,1506,1605
7618,Wellfleet,Barnstable County,MA,Wellfleet,2003,6.7,110,1540,1650
7619,Wellfleet,Barnstable County,MA,Wellfleet,2004,6.2,103,1558,1661
7620,Wellfleet,Barnstable County,MA,Wellfleet,2005,6.5,108,1557,1665
7621,Wellfleet,Barnstable County,MA,Wellfleet,2006,6.8,114,1554,1668
7622,Wellfleet,Barnstable County,MA,Wellfleet,2007,6.3,103,1540,1643
7623,Wellfleet,Barnstable County,MA,Wellfleet,2008,7.8,129,1524,1653
7624,Wellfleet,Barnstable County,MA,Wellfleet,2009,11.4,199,1545,1744
7625,Wellfleet,Barnstable County,MA,Wellfleet,2010,11.6,199,1517,1716
7626,Wellfleet,Barnstable County,MA,Wellfleet,2011,12,206,1515,1721
7627,Wellfleet,Barnstable County,MA,Wellfleet,2012,10.7,184,1540,1724
7628,Wendell,Franklin County,MA,Wendell,1990,6,31,489,520
7629,Wendell,Franklin County,MA,Wendell,1991,9.1,50,497,547
7630,Wendell,Franklin County,MA,Wendell,1992,9.7,51,477,528
7631,Wendell,Franklin County,MA,Wendell,1993,7.2,37,479,516
7632,Wendell,Franklin County,MA,Wendell,1994,6.6,35,495,530
7633,Wendell,Franklin County,MA,Wendell,1995,3.7,20,520,540
7634,Wendell,Franklin County,MA,Wendell,1996,3.7,20,523,543
7635,Wendell,Franklin County,MA,Wendell,1997,3.4,19,536,555
7636,Wendell,Franklin County,MA,Wendell,1998,3.9,22,549,571
7637,Wendell,Franklin County,MA,Wendell,1999,2.6,15,563,578
7638,Wendell,Franklin County,MA,Wendell,2000,2,12,601,613
7639,Wendell,Franklin County,MA,Wendell,2001,3.3,20,592,612
7640,Wendell,Franklin County,MA,Wendell,2002,3.4,21,598,619
7641,Wendell,Franklin County,MA,Wendell,2003,3.6,22,592,614
7642,Wendell,Franklin County,MA,Wendell,2004,4.4,27,587,614
7643,Wendell,Franklin County,MA,Wendell,2005,3,18,586,604
7644,Wendell,Franklin County,MA,Wendell,2006,4.3,26,585,611
7645,Wendell,Franklin County,MA,Wendell,2007,3.4,20,561,581
7646,Wendell,Franklin County,MA,Wendell,2008,4.6,27,565,592
7647,Wendell,Franklin County,MA,Wendell,2009,6.9,40,542,582
7648,Wendell,Franklin County,MA,Wendell,2010,8.1,40,455,495
7649,Wendell,Franklin County,MA,Wendell,2011,7.2,35,454,489
7650,Wendell,Franklin County,MA,Wendell,2012,6.2,30,455,485
7651,Wenham,Essex County,MA,Wenham,1990,3.1,70,2225,2295
7652,Wenham,Essex County,MA,Wenham,1991,4.1,92,2151,2243
7653,Wenham,Essex County,MA,Wenham,1992,3.4,78,2183,2261
7654,Wenham,Essex County,MA,Wenham,1993,3.1,73,2251,2324
7655,Wenham,Essex County,MA,Wenham,1994,2.6,61,2289,2350
7656,Wenham,Essex County,MA,Wenham,1995,2.4,58,2310,2368
7657,Wenham,Essex County,MA,Wenham,1996,2.2,53,2352,2405
7658,Wenham,Essex County,MA,Wenham,1997,2.1,51,2419,2470
7659,Wenham,Essex County,MA,Wenham,1998,1.6,40,2504,2544
7660,Wenham,Essex County,MA,Wenham,1999,1.5,38,2539,2577
7661,Wenham,Essex County,MA,Wenham,2000,2.4,43,1771,1814
7662,Wenham,Essex County,MA,Wenham,2001,3.6,65,1758,1823
7663,Wenham,Essex County,MA,Wenham,2002,5.3,98,1734,1832
7664,Wenham,Essex County,MA,Wenham,2003,5.6,102,1709,1811
7665,Wenham,Essex County,MA,Wenham,2004,5,90,1703,1793
7666,Wenham,Essex County,MA,Wenham,2005,5,90,1715,1805
7667,Wenham,Essex County,MA,Wenham,2006,4.3,73,1636,1709
7668,Wenham,Essex County,MA,Wenham,2007,4,72,1733,1805
7669,Wenham,Essex County,MA,Wenham,2008,5.4,98,1727,1825
7670,Wenham,Essex County,MA,Wenham,2009,8.3,151,1671,1822
7671,Wenham,Essex County,MA,Wenham,2010,7.8,148,1742,1890
7672,Wenham,Essex County,MA,Wenham,2011,6.9,130,1759,1889
7673,Wenham,Essex County,MA,Wenham,2012,6.4,122,1778,1900
7674,West Boylston,Worcester County,MA,West Boylston,1990,5.4,172,2988,3160
7675,West Boylston,Worcester County,MA,West Boylston,1991,8,245,2834,3079
7676,West Boylston,Worcester County,MA,West Boylston,1992,8.2,254,2853,3107
7677,West Boylston,Worcester County,MA,West Boylston,1993,6.2,194,2937,3131
7678,West Boylston,Worcester County,MA,West Boylston,1994,5,157,2972,3129
7679,West Boylston,Worcester County,MA,West Boylston,1995,4.4,138,2969,3107
7680,West Boylston,Worcester County,MA,West Boylston,1996,3.1,95,3016,3111
7681,West Boylston,Worcester County,MA,West Boylston,1997,3,97,3105,3202
7682,West Boylston,Worcester County,MA,West Boylston,1998,2.4,78,3163,3241
7683,West Boylston,Worcester County,MA,West Boylston,1999,3,98,3148,3246
7684,West Boylston,Worcester County,MA,West Boylston,2000,2.7,87,3189,3276
7685,West Boylston,Worcester County,MA,West Boylston,2001,3.1,103,3194,3297
7686,West Boylston,Worcester County,MA,West Boylston,2002,4.8,158,3144,3302
7687,West Boylston,Worcester County,MA,West Boylston,2003,5.7,189,3150,3339
7688,West Boylston,Worcester County,MA,West Boylston,2004,5.1,170,3131,3301
7689,West Boylston,Worcester County,MA,West Boylston,2005,4.8,158,3155,3313
7690,West Boylston,Worcester County,MA,West Boylston,2006,5,174,3295,3469
7691,West Boylston,Worcester County,MA,West Boylston,2007,4.7,165,3347,3512
7692,West Boylston,Worcester County,MA,West Boylston,2008,5.5,189,3271,3460
7693,West Boylston,Worcester County,MA,West Boylston,2009,8.7,304,3173,3477
7694,West Boylston,Worcester County,MA,West Boylston,2010,9,298,3008,3306
7695,West Boylston,Worcester County,MA,West Boylston,2011,8.2,271,3033,3304
7696,West Boylston,Worcester County,MA,West Boylston,2012,7.3,239,3032,3271
7697,West Bridgewater,Plymouth County,MA,West Bridgewater,1990,6.3,225,3322,3547
7698,West Bridgewater,Plymouth County,MA,West Bridgewater,1991,9.4,329,3160,3489
7699,West Bridgewater,Plymouth County,MA,West Bridgewater,1992,10.2,355,3118,3473
7700,West Bridgewater,Plymouth County,MA,West Bridgewater,1993,8.3,297,3272,3569
7701,West Bridgewater,Plymouth County,MA,West Bridgewater,1994,6.4,234,3408,3642
7702,West Bridgewater,Plymouth County,MA,West Bridgewater,1995,5.5,204,3500,3704
7703,West Bridgewater,Plymouth County,MA,West Bridgewater,1996,4.8,180,3537,3717
7704,West Bridgewater,Plymouth County,MA,West Bridgewater,1997,4.3,164,3648,3812
7705,West Bridgewater,Plymouth County,MA,West Bridgewater,1998,3,113,3681,3794
7706,West Bridgewater,Plymouth County,MA,West Bridgewater,1999,2.7,104,3751,3855
7707,West Bridgewater,Plymouth County,MA,West Bridgewater,2000,2.6,91,3420,3511
7708,West Bridgewater,Plymouth County,MA,West Bridgewater,2001,3.3,118,3428,3546
7709,West Bridgewater,Plymouth County,MA,West Bridgewater,2002,5.1,184,3405,3589
7710,West Bridgewater,Plymouth County,MA,West Bridgewater,2003,5.5,193,3336,3529
7711,West Bridgewater,Plymouth County,MA,West Bridgewater,2004,5.2,181,3327,3508
7712,West Bridgewater,Plymouth County,MA,West Bridgewater,2005,5.1,178,3326,3504
7713,West Bridgewater,Plymouth County,MA,West Bridgewater,2006,4.8,167,3344,3511
7714,West Bridgewater,Plymouth County,MA,West Bridgewater,2007,4.7,165,3344,3509
7715,West Bridgewater,Plymouth County,MA,West Bridgewater,2008,5.6,198,3319,3517
7716,West Bridgewater,Plymouth County,MA,West Bridgewater,2009,8.6,301,3213,3514
7717,West Bridgewater,Plymouth County,MA,West Bridgewater,2010,8.4,304,3320,3624
7718,West Bridgewater,Plymouth County,MA,West Bridgewater,2011,7.7,279,3352,3631
7719,West Bridgewater,Plymouth County,MA,West Bridgewater,2012,7,254,3381,3635
7720,West Brookfield,Worcester County,MA,West Brookfield,1990,6.5,112,1622,1734
7721,West Brookfield,Worcester County,MA,West Brookfield,1991,8.8,153,1576,1729
7722,West Brookfield,Worcester County,MA,West Brookfield,1992,8.6,150,1595,1745
7723,West Brookfield,Worcester County,MA,West Brookfield,1993,6.6,117,1650,1767
7724,West Brookfield,Worcester County,MA,West Brookfield,1994,6.1,110,1683,1793
7725,West Brookfield,Worcester County,MA,West Brookfield,1995,5.6,97,1645,1742
7726,West Brookfield,Worcester County,MA,West Brookfield,1996,5.4,96,1678,1774
7727,West Brookfield,Worcester County,MA,West Brookfield,1997,4.5,82,1729,1811
7728,West Brookfield,Worcester County,MA,West Brookfield,1998,3.5,64,1776,1840
7729,West Brookfield,Worcester County,MA,West Brookfield,1999,2.9,54,1778,1832
7730,West Brookfield,Worcester County,MA,West Brookfield,2000,2.5,46,1828,1874
7731,West Brookfield,Worcester County,MA,West Brookfield,2001,3.4,65,1831,1896
7732,West Brookfield,Worcester County,MA,West Brookfield,2002,5.4,103,1819,1922
7733,West Brookfield,Worcester County,MA,West Brookfield,2003,6.1,118,1811,1929
7734,West Brookfield,Worcester County,MA,West Brookfield,2004,6.1,117,1806,1923
7735,West Brookfield,Worcester County,MA,West Brookfield,2005,5.4,102,1798,1900
7736,West Brookfield,Worcester County,MA,West Brookfield,2006,5.2,98,1799,1897
7737,West Brookfield,Worcester County,MA,West Brookfield,2007,5.1,97,1795,1892
7738,West Brookfield,Worcester County,MA,West Brookfield,2008,6.2,116,1753,1869
7739,West Brookfield,Worcester County,MA,West Brookfield,2009,9.5,179,1702,1881
7740,West Brookfield,Worcester County,MA,West Brookfield,2010,10.1,183,1636,1819
7741,West Brookfield,Worcester County,MA,West Brookfield,2011,9,163,1651,1814
7742,West Brookfield,Worcester County,MA,West Brookfield,2012,8,143,1650,1793
7743,West Newbury,Essex County,MA,West Newbury,1990,4.4,86,1878,1964
7744,West Newbury,Essex County,MA,West Newbury,1991,5.7,114,1886,2000
7745,West Newbury,Essex County,MA,West Newbury,1992,5.8,120,1959,2079
7746,West Newbury,Essex County,MA,West Newbury,1993,4.4,96,2106,2202
7747,West Newbury,Essex County,MA,West Newbury,1994,4.1,93,2157,2250
7748,West Newbury,Essex County,MA,West Newbury,1995,3.9,87,2121,2208
7749,West Newbury,Essex County,MA,West Newbury,1996,3,68,2211,2279
7750,West Newbury,Essex County,MA,West Newbury,1997,2.6,61,2256,2317
7751,West Newbury,Essex County,MA,West Newbury,1998,2.2,52,2318,2370
7752,West Newbury,Essex County,MA,West Newbury,1999,2.5,61,2391,2452
7753,West Newbury,Essex County,MA,West Newbury,2000,2.1,48,2281,2329
7754,West Newbury,Essex County,MA,West Newbury,2001,2.7,62,2271,2333
7755,West Newbury,Essex County,MA,West Newbury,2002,3.5,81,2218,2299
7756,West Newbury,Essex County,MA,West Newbury,2003,4.6,105,2175,2280
7757,West Newbury,Essex County,MA,West Newbury,2004,4,89,2164,2253
7758,West Newbury,Essex County,MA,West Newbury,2005,3.4,78,2186,2264
7759,West Newbury,Essex County,MA,West Newbury,2006,3.6,83,2197,2280
7760,West Newbury,Essex County,MA,West Newbury,2007,3.2,73,2191,2264
7761,West Newbury,Essex County,MA,West Newbury,2008,3.6,81,2159,2240
7762,West Newbury,Essex County,MA,West Newbury,2009,6.5,151,2159,2310
7763,West Newbury,Essex County,MA,West Newbury,2010,6.4,145,2123,2268
7764,West Newbury,Essex County,MA,West Newbury,2011,5.3,121,2150,2271
7765,West Newbury,Essex County,MA,West Newbury,2012,4.8,109,2178,2287
7766,West Springfield,Hampden County,MA,West Springfield,1990,6,897,14063,14960
7767,West Springfield,Hampden County,MA,West Springfield,1991,8.4,1238,13479,14717
7768,West Springfield,Hampden County,MA,West Springfield,1992,8.5,1245,13416,14661
7769,West Springfield,Hampden County,MA,West Springfield,1993,7.9,1143,13265,14408
7770,West Springfield,Hampden County,MA,West Springfield,1994,9.2,1338,13246,14584
7771,West Springfield,Hampden County,MA,West Springfield,1995,7.9,1127,13104,14231
7772,West Springfield,Hampden County,MA,West Springfield,1996,5.7,795,13202,13997
7773,West Springfield,Hampden County,MA,West Springfield,1997,5,714,13446,14160
7774,West Springfield,Hampden County,MA,West Springfield,1998,3.5,497,13522,14019
7775,West Springfield,Hampden County,MA,West Springfield,1999,3.5,497,13511,14008
7776,West Springfield,Hampden County,MA,West Springfield,2000,2.8,410,14043,14453
7777,West Springfield,Hampden County,MA,West Springfield,2001,3.9,563,14055,14618
7778,West Springfield,Hampden County,MA,West Springfield,2002,5,738,13992,14730
7779,West Springfield,Hampden County,MA,West Springfield,2003,5.7,839,13851,14690
7780,West Springfield,Hampden County,MA,West Springfield,2004,5.4,792,13836,14628
7781,West Springfield,Hampden County,MA,West Springfield,2005,5.3,779,13860,14639
7782,West Springfield,Hampden County,MA,West Springfield,2006,5,728,13885,14613
7783,West Springfield,Hampden County,MA,West Springfield,2007,4.9,706,13801,14507
7784,West Springfield,Hampden County,MA,West Springfield,2008,6.1,891,13606,14497
7785,West Springfield,Hampden County,MA,West Springfield,2009,8.8,1281,13306,14587
7786,West Springfield,Hampden County,MA,West Springfield,2010,9.2,1359,13461,14820
7787,West Springfield,Hampden County,MA,West Springfield,2011,8.1,1173,13327,14500
7788,West Springfield,Hampden County,MA,West Springfield,2012,7.6,1092,13335,14427
7789,West Stockbridge,Berkshire County,MA,West Stockbridge,1990,6.2,49,742,791
7790,West Stockbridge,Berkshire County,MA,West Stockbridge,1991,7.9,62,724,786
7791,West Stockbridge,Berkshire County,MA,West Stockbridge,1992,9.4,76,731,807
7792,West Stockbridge,Berkshire County,MA,West Stockbridge,1993,5,41,775,816
7793,West Stockbridge,Berkshire County,MA,West Stockbridge,1994,5.5,46,792,838
7794,West Stockbridge,Berkshire County,MA,West Stockbridge,1995,5,42,792,834
7795,West Stockbridge,Berkshire County,MA,West Stockbridge,1996,4.3,36,809,845
7796,West Stockbridge,Berkshire County,MA,West Stockbridge,1997,3.1,26,823,849
7797,West Stockbridge,Berkshire County,MA,West Stockbridge,1998,2.7,23,820,843
7798,West Stockbridge,Berkshire County,MA,West Stockbridge,1999,2.3,19,817,836
7799,West Stockbridge,Berkshire County,MA,West Stockbridge,2000,2.1,17,778,795
7800,West Stockbridge,Berkshire County,MA,West Stockbridge,2001,2,17,814,831
7801,West Stockbridge,Berkshire County,MA,West Stockbridge,2002,2.9,25,842,867
7802,West Stockbridge,Berkshire County,MA,West Stockbridge,2003,2.9,25,848,873
7803,West Stockbridge,Berkshire County,MA,West Stockbridge,2004,2.8,24,846,870
7804,West Stockbridge,Berkshire County,MA,West Stockbridge,2005,3,27,863,890
7805,West Stockbridge,Berkshire County,MA,West Stockbridge,2006,2.6,23,873,896
7806,West Stockbridge,Berkshire County,MA,West Stockbridge,2007,2.7,24,855,879
7807,West Stockbridge,Berkshire County,MA,West Stockbridge,2008,3.4,30,848,878
7808,West Stockbridge,Berkshire County,MA,West Stockbridge,2009,6,53,824,877
7809,West Stockbridge,Berkshire County,MA,West Stockbridge,2010,6.8,55,758,813
7810,West Stockbridge,Berkshire County,MA,West Stockbridge,2011,6.4,52,763,815
7811,West Stockbridge,Berkshire County,MA,West Stockbridge,2012,4.9,39,756,795
7812,West Tisbury,Dukes County,MA,West Tisbury,1990,1.1,12,1106,1118
7813,West Tisbury,Dukes County,MA,West Tisbury,1991,1.7,19,1130,1149
7814,West Tisbury,Dukes County,MA,West Tisbury,1992,2.4,27,1080,1107
7815,West Tisbury,Dukes County,MA,West Tisbury,1993,2.3,26,1129,1155
7816,West Tisbury,Dukes County,MA,West Tisbury,1994,1.9,24,1226,1250
7817,West Tisbury,Dukes County,MA,West Tisbury,1995,2.3,33,1402,1435
7818,West Tisbury,Dukes County,MA,West Tisbury,1996,2.4,36,1483,1519
7819,West Tisbury,Dukes County,MA,West Tisbury,1997,1.9,30,1540,1570
7820,West Tisbury,Dukes County,MA,West Tisbury,1998,1.7,27,1579,1606
7821,West Tisbury,Dukes County,MA,West Tisbury,1999,1.7,28,1618,1646
7822,West Tisbury,Dukes County,MA,West Tisbury,2000,1.5,26,1751,1777
7823,West Tisbury,Dukes County,MA,West Tisbury,2001,1.4,26,1782,1808
7824,West Tisbury,Dukes County,MA,West Tisbury,2002,2.1,39,1858,1897
7825,West Tisbury,Dukes County,MA,West Tisbury,2003,2.5,49,1937,1986
7826,West Tisbury,Dukes County,MA,West Tisbury,2004,2.5,51,1970,2021
7827,West Tisbury,Dukes County,MA,West Tisbury,2005,2.3,46,1954,2000
7828,West Tisbury,Dukes County,MA,West Tisbury,2006,2.4,48,1961,2009
7829,West Tisbury,Dukes County,MA,West Tisbury,2007,2.1,42,1975,2017
7830,West Tisbury,Dukes County,MA,West Tisbury,2008,2.7,54,1978,2032
7831,West Tisbury,Dukes County,MA,West Tisbury,2009,4.4,88,1912,2000
7832,West Tisbury,Dukes County,MA,West Tisbury,2010,5.3,107,1915,2022
7833,West Tisbury,Dukes County,MA,West Tisbury,2011,4.6,93,1930,2023
7834,West Tisbury,Dukes County,MA,West Tisbury,2012,4.3,87,1949,2036
7835,Westborough,Worcester County,MA,Westborough,1990,4.2,342,7721,8063
7836,Westborough,Worcester County,MA,Westborough,1991,6.3,509,7564,8073
7837,Westborough,Worcester County,MA,Westborough,1992,6.4,524,7622,8146
7838,Westborough,Worcester County,MA,Westborough,1993,5,421,8017,8438
7839,Westborough,Worcester County,MA,Westborough,1994,4.1,357,8282,8639
7840,Westborough,Worcester County,MA,Westborough,1995,3.7,306,7947,8253
7841,Westborough,Worcester County,MA,Westborough,1996,2.6,223,8284,8507
7842,Westborough,Worcester County,MA,Westborough,1997,2.4,207,8594,8801
7843,Westborough,Worcester County,MA,Westborough,1998,2.1,185,8802,8987
7844,Westborough,Worcester County,MA,Westborough,1999,2.5,229,8848,9077
7845,Westborough,Worcester County,MA,Westborough,2000,2.1,189,8931,9120
7846,Westborough,Worcester County,MA,Westborough,2001,3.2,296,8982,9278
7847,Westborough,Worcester County,MA,Westborough,2002,4.9,463,8968,9431
7848,Westborough,Worcester County,MA,Westborough,2003,5.1,489,9012,9501
7849,Westborough,Worcester County,MA,Westborough,2004,4.2,390,8957,9347
7850,Westborough,Worcester County,MA,Westborough,2005,3.7,342,8927,9269
7851,Westborough,Worcester County,MA,Westborough,2006,3.7,339,8785,9124
7852,Westborough,Worcester County,MA,Westborough,2007,3.5,315,8804,9119
7853,Westborough,Worcester County,MA,Westborough,2008,4.2,380,8608,8988
7854,Westborough,Worcester County,MA,Westborough,2009,6.5,583,8361,8944
7855,Westborough,Worcester County,MA,Westborough,2010,6.6,591,8335,8926
7856,Westborough,Worcester County,MA,Westborough,2011,5.8,520,8409,8929
7857,Westborough,Worcester County,MA,Westborough,2012,5.1,453,8406,8859
7858,Westfield,Hampden County,MA,Westfield,1990,5.4,1066,18690,19756
7859,Westfield,Hampden County,MA,Westfield,1991,9.3,1845,18010,19855
7860,Westfield,Hampden County,MA,Westfield,1992,8.4,1634,17813,19447
7861,Westfield,Hampden County,MA,Westfield,1993,7.5,1444,17860,19304
7862,Westfield,Hampden County,MA,Westfield,1994,5.5,1044,18002,19046
7863,Westfield,Hampden County,MA,Westfield,1995,4.4,829,17818,18647
7864,Westfield,Hampden County,MA,Westfield,1996,3.5,646,18037,18683
7865,Westfield,Hampden County,MA,Westfield,1997,3.5,662,18493,19155
7866,Westfield,Hampden County,MA,Westfield,1998,3.4,648,18635,19283
7867,Westfield,Hampden County,MA,Westfield,1999,3.5,670,18723,19393
7868,Westfield,Hampden County,MA,Westfield,2000,2.7,573,20409,20982
7869,Westfield,Hampden County,MA,Westfield,2001,3.3,707,20423,21130
7870,Westfield,Hampden County,MA,Westfield,2002,4.6,988,20364,21352
7871,Westfield,Hampden County,MA,Westfield,2003,5.2,1118,20225,21343
7872,Westfield,Hampden County,MA,Westfield,2004,4.9,1041,20228,21269
7873,Westfield,Hampden County,MA,Westfield,2005,4.6,984,20290,21274
7874,Westfield,Hampden County,MA,Westfield,2006,4.7,995,20395,21390
7875,Westfield,Hampden County,MA,Westfield,2007,4.6,988,20301,21289
7876,Westfield,Hampden County,MA,Westfield,2008,5.4,1150,20344,21494
7877,Westfield,Hampden County,MA,Westfield,2009,8,1744,20146,21890
7878,Westfield,Hampden County,MA,Westfield,2010,8.3,1788,19699,21487
7879,Westfield,Hampden County,MA,Westfield,2011,7.7,1631,19501,21132
7880,Westfield,Hampden County,MA,Westfield,2012,7.2,1520,19513,21033
7881,Westford,Middlesex County,MA,Westford,1990,4.8,474,9386,9860
7882,Westford,Middlesex County,MA,Westford,1991,6.9,683,9210,9893
7883,Westford,Middlesex County,MA,Westford,1992,7.5,756,9374,10130
7884,Westford,Middlesex County,MA,Westford,1993,5.9,602,9601,10203
7885,Westford,Middlesex County,MA,Westford,1994,4.9,516,9941,10457
7886,Westford,Middlesex County,MA,Westford,1995,4.3,441,9920,10361
7887,Westford,Middlesex County,MA,Westford,1996,3.1,339,10433,10772
7888,Westford,Middlesex County,MA,Westford,1997,2.4,272,11034,11306
7889,Westford,Middlesex County,MA,Westford,1998,2.1,249,11511,11760
7890,Westford,Middlesex County,MA,Westford,1999,2.2,269,12103,12372
7891,Westford,Middlesex County,MA,Westford,2000,1.8,206,11323,11529
7892,Westford,Middlesex County,MA,Westford,2001,3.1,364,11452,11816
7893,Westford,Middlesex County,MA,Westford,2002,5.5,659,11307,11966
7894,Westford,Middlesex County,MA,Westford,2003,5.9,698,11189,11887
7895,Westford,Middlesex County,MA,Westford,2004,4.3,500,11207,11707
7896,Westford,Middlesex County,MA,Westford,2005,3.8,448,11280,11728
7897,Westford,Middlesex County,MA,Westford,2006,3.8,447,11292,11739
7898,Westford,Middlesex County,MA,Westford,2007,3.5,418,11436,11854
7899,Westford,Middlesex County,MA,Westford,2008,4,482,11550,12032
7900,Westford,Middlesex County,MA,Westford,2009,6.8,843,11508,12351
7901,Westford,Middlesex County,MA,Westford,2010,6.7,807,11239,12046
7902,Westford,Middlesex County,MA,Westford,2011,5.3,634,11360,11994
7903,Westford,Middlesex County,MA,Westford,2012,5.2,624,11485,12109
7904,Westhampton,Hampshire County,MA,Westhampton,1990,2.7,21,764,785
7905,Westhampton,Hampshire County,MA,Westhampton,1991,6,47,732,779
7906,Westhampton,Hampshire County,MA,Westhampton,1992,5.5,47,806,853
7907,Westhampton,Hampshire County,MA,Westhampton,1993,4.7,40,814,854
7908,Westhampton,Hampshire County,MA,Westhampton,1994,4,36,874,910
7909,Westhampton,Hampshire County,MA,Westhampton,1995,3.6,35,938,973
7910,Westhampton,Hampshire County,MA,Westhampton,1996,2.6,25,927,952
7911,Westhampton,Hampshire County,MA,Westhampton,1997,3.5,34,943,977
7912,Westhampton,Hampshire County,MA,Westhampton,1998,2.8,28,982,1010
7913,Westhampton,Hampshire County,MA,Westhampton,1999,2.4,26,1071,1097
7914,Westhampton,Hampshire County,MA,Westhampton,2000,1.9,17,875,892
7915,Westhampton,Hampshire County,MA,Westhampton,2001,2.4,22,887,909
7916,Westhampton,Hampshire County,MA,Westhampton,2002,3.1,28,890,918
7917,Westhampton,Hampshire County,MA,Westhampton,2003,3.6,33,894,927
7918,Westhampton,Hampshire County,MA,Westhampton,2004,3.3,31,909,940
7919,Westhampton,Hampshire County,MA,Westhampton,2005,2.9,27,917,944
7920,Westhampton,Hampshire County,MA,Westhampton,2006,2.7,26,934,960
7921,Westhampton,Hampshire County,MA,Westhampton,2007,3.1,30,936,966
7922,Westhampton,Hampshire County,MA,Westhampton,2008,4.4,42,922,964
7923,Westhampton,Hampshire County,MA,Westhampton,2009,6.8,65,886,951
7924,Westhampton,Hampshire County,MA,Westhampton,2010,6,57,899,956
7925,Westhampton,Hampshire County,MA,Westhampton,2011,6.2,59,889,948
7926,Westhampton,Hampshire County,MA,Westhampton,2012,5.5,52,889,941
7927,Westminster,Worcester County,MA,Westminster,1990,8.9,306,3128,3434
7928,Westminster,Worcester County,MA,Westminster,1991,9.5,322,3057,3379
7929,Westminster,Worcester County,MA,Westminster,1992,9.1,318,3178,3496
7930,Westminster,Worcester County,MA,Westminster,1993,7,245,3255,3500
7931,Westminster,Worcester County,MA,Westminster,1994,6.6,235,3316,3551
7932,Westminster,Worcester County,MA,Westminster,1995,5.4,188,3292,3480
7933,Westminster,Worcester County,MA,Westminster,1996,4.6,159,3299,3458
7934,Westminster,Worcester County,MA,Westminster,1997,3.9,138,3382,3520
7935,Westminster,Worcester County,MA,Westminster,1998,3.4,121,3406,3527
7936,Westminster,Worcester County,MA,Westminster,1999,3.9,138,3439,3577
7937,Westminster,Worcester County,MA,Westminster,2000,2.9,108,3649,3757
7938,Westminster,Worcester County,MA,Westminster,2001,3.8,142,3638,3780
7939,Westminster,Worcester County,MA,Westminster,2002,6,233,3636,3869
7940,Westminster,Worcester County,MA,Westminster,2003,6.4,250,3645,3895
7941,Westminster,Worcester County,MA,Westminster,2004,5.9,230,3641,3871
7942,Westminster,Worcester County,MA,Westminster,2005,5.8,222,3635,3857
7943,Westminster,Worcester County,MA,Westminster,2006,5.6,218,3693,3911
7944,Westminster,Worcester County,MA,Westminster,2007,5,196,3691,3887
7945,Westminster,Worcester County,MA,Westminster,2008,5.8,226,3643,3869
7946,Westminster,Worcester County,MA,Westminster,2009,9.1,346,3476,3822
7947,Westminster,Worcester County,MA,Westminster,2010,9.1,347,3459,3806
7948,Westminster,Worcester County,MA,Westminster,2011,8.1,305,3457,3762
7949,Westminster,Worcester County,MA,Westminster,2012,8.1,306,3455,3761
7950,Weston,Middlesex County,MA,Weston,1990,2.5,128,5076,5204
7951,Weston,Middlesex County,MA,Weston,1991,3.3,164,4856,5020
7952,Weston,Middlesex County,MA,Weston,1992,3,152,4861,5013
7953,Weston,Middlesex County,MA,Weston,1993,2.7,134,4907,5041
7954,Weston,Middlesex County,MA,Weston,1994,2.4,123,5035,5158
7955,Weston,Middlesex County,MA,Weston,1995,2.2,115,5127,5242
7956,Weston,Middlesex County,MA,Weston,1996,1.8,94,5240,5334
7957,Weston,Middlesex County,MA,Weston,1997,1.4,76,5413,5489
7958,Weston,Middlesex County,MA,Weston,1998,1.1,62,5540,5602
7959,Weston,Middlesex County,MA,Weston,1999,1.1,62,5610,5672
7960,Weston,Middlesex County,MA,Weston,2000,1.6,89,5320,5409
7961,Weston,Middlesex County,MA,Weston,2001,2.3,126,5328,5454
7962,Weston,Middlesex County,MA,Weston,2002,3.5,190,5256,5446
7963,Weston,Middlesex County,MA,Weston,2003,3.9,208,5178,5386
7964,Weston,Middlesex County,MA,Weston,2004,3.2,169,5170,5339
7965,Weston,Middlesex County,MA,Weston,2005,2.8,149,5218,5367
7966,Weston,Middlesex County,MA,Weston,2006,2.8,151,5166,5317
7967,Weston,Middlesex County,MA,Weston,2007,2.8,148,5229,5377
7968,Weston,Middlesex County,MA,Weston,2008,3.2,174,5240,5414
7969,Weston,Middlesex County,MA,Weston,2009,5.2,280,5117,5397
7970,Weston,Middlesex County,MA,Weston,2010,4.9,252,4914,5166
7971,Weston,Middlesex County,MA,Weston,2011,4.2,216,4984,5200
7972,Weston,Middlesex County,MA,Weston,2012,3.7,195,5038,5233
7973,Westport,Bristol County,MA,Westport,1990,8.2,626,7021,7647
7974,Westport,Bristol County,MA,Westport,1991,12.4,959,6764,7723
7975,Westport,Bristol County,MA,Westport,1992,12.4,978,6889,7867
7976,Westport,Bristol County,MA,Westport,1993,11.8,937,7036,7973
7977,Westport,Bristol County,MA,Westport,1994,9.3,725,7104,7829
7978,Westport,Bristol County,MA,Westport,1995,8.4,656,7112,7768
7979,Westport,Bristol County,MA,Westport,1996,8.2,636,7141,7777
7980,Westport,Bristol County,MA,Westport,1997,6.5,503,7293,7796
7981,Westport,Bristol County,MA,Westport,1998,4.7,370,7428,7798
7982,Westport,Bristol County,MA,Westport,1999,4.6,368,7546,7914
7983,Westport,Bristol County,MA,Westport,2000,4,315,7511,7826
7984,Westport,Bristol County,MA,Westport,2001,4.8,380,7503,7883
7985,Westport,Bristol County,MA,Westport,2002,6,489,7602,8091
7986,Westport,Bristol County,MA,Westport,2003,6.5,536,7654,8190
7987,Westport,Bristol County,MA,Westport,2004,6.5,535,7717,8252
7988,Westport,Bristol County,MA,Westport,2005,6.2,525,7946,8471
7989,Westport,Bristol County,MA,Westport,2006,6.3,544,8065,8609
7990,Westport,Bristol County,MA,Westport,2007,6.2,531,8085,8616
7991,Westport,Bristol County,MA,Westport,2008,7.3,635,8112,8747
7992,Westport,Bristol County,MA,Westport,2009,10.8,941,7795,8736
7993,Westport,Bristol County,MA,Westport,2010,11.5,1011,7767,8778
7994,Westport,Bristol County,MA,Westport,2011,11,964,7823,8787
7995,Westport,Bristol County,MA,Westport,2012,10.1,877,7836,8713
7996,Westwood,Norfolk County,MA,Westwood,1990,4.4,297,6416,6713
7997,Westwood,Norfolk County,MA,Westwood,1991,5.6,375,6347,6722
7998,Westwood,Norfolk County,MA,Westwood,1992,6,408,6383,6791
7999,Westwood,Norfolk County,MA,Westwood,1993,4.6,314,6501,6815
8000,Westwood,Norfolk County,MA,Westwood,1994,3.9,274,6674,6948
8001,Westwood,Norfolk County,MA,Westwood,1995,3.9,260,6491,6751
8002,Westwood,Norfolk County,MA,Westwood,1996,2.7,185,6646,6831
8003,Westwood,Norfolk County,MA,Westwood,1997,2.7,190,6847,7037
8004,Westwood,Norfolk County,MA,Westwood,1998,2.2,155,6978,7133
8005,Westwood,Norfolk County,MA,Westwood,1999,1.9,139,7085,7224
8006,Westwood,Norfolk County,MA,Westwood,2000,2.1,146,6754,6900
8007,Westwood,Norfolk County,MA,Westwood,2001,3,211,6739,6950
8008,Westwood,Norfolk County,MA,Westwood,2002,4.1,285,6613,6898
8009,Westwood,Norfolk County,MA,Westwood,2003,4.5,308,6490,6798
8010,Westwood,Norfolk County,MA,Westwood,2004,3.8,257,6458,6715
8011,Westwood,Norfolk County,MA,Westwood,2005,3.5,232,6469,6701
8012,Westwood,Norfolk County,MA,Westwood,2006,3.2,212,6346,6558
8013,Westwood,Norfolk County,MA,Westwood,2007,3.1,208,6501,6709
8014,Westwood,Norfolk County,MA,Westwood,2008,3.8,259,6583,6842
8015,Westwood,Norfolk County,MA,Westwood,2009,6.1,411,6360,6771
8016,Westwood,Norfolk County,MA,Westwood,2010,5.8,406,6589,6995
8017,Westwood,Norfolk County,MA,Westwood,2011,4.8,337,6664,7001
8018,Westwood,Norfolk County,MA,Westwood,2012,4.6,322,6737,7059
8019,Weymouth,Norfolk County,MA,Weymouth,1990,6.1,1931,29558,31489
8020,Weymouth,Norfolk County,MA,Weymouth,1991,8.5,2677,28736,31413
8021,Weymouth,Norfolk County,MA,Weymouth,1992,8.5,2675,28760,31435
8022,Weymouth,Norfolk County,MA,Weymouth,1993,6.9,2151,28815,30966
8023,Weymouth,Norfolk County,MA,Weymouth,1994,5.7,1780,29385,31165
8024,Weymouth,Norfolk County,MA,Weymouth,1995,5.4,1678,29657,31335
8025,Weymouth,Norfolk County,MA,Weymouth,1996,4.5,1433,30150,31583
8026,Weymouth,Norfolk County,MA,Weymouth,1997,3.9,1249,30873,32122
8027,Weymouth,Norfolk County,MA,Weymouth,1998,3,965,31222,32187
8028,Weymouth,Norfolk County,MA,Weymouth,1999,2.8,916,31354,32270
8029,Weymouth,Norfolk County,MA,Weymouth,2000,2.6,791,29322,30113
8030,Weymouth,Norfolk County,MA,Weymouth,2001,3.3,996,29202,30198
8031,Weymouth,Norfolk County,MA,Weymouth,2002,4.8,1477,28995,30472
8032,Weymouth,Norfolk County,MA,Weymouth,2003,5.8,1754,28478,30232
8033,Weymouth,Norfolk County,MA,Weymouth,2004,5.2,1568,28351,29919
8034,Weymouth,Norfolk County,MA,Weymouth,2005,4.9,1455,28425,29880
8035,Weymouth,Norfolk County,MA,Weymouth,2006,5,1460,27936,29396
8036,Weymouth,Norfolk County,MA,Weymouth,2007,4.6,1343,28131,29474
8037,Weymouth,Norfolk County,MA,Weymouth,2008,5.4,1604,28137,29741
8038,Weymouth,Norfolk County,MA,Weymouth,2009,8.3,2466,27219,29685
8039,Weymouth,Norfolk County,MA,Weymouth,2010,8.7,2614,27509,30123
8040,Weymouth,Norfolk County,MA,Weymouth,2011,7.3,2176,27818,29994
8041,Weymouth,Norfolk County,MA,Weymouth,2012,6.4,1918,28123,30041
8042,Whately,Franklin County,MA,Whately,1990,3.6,30,797,827
8043,Whately,Franklin County,MA,Whately,1991,4.5,38,814,852
8044,Whately,Franklin County,MA,Whately,1992,4.2,35,795,830
8045,Whately,Franklin County,MA,Whately,1993,3.4,28,795,823
8046,Whately,Franklin County,MA,Whately,1994,2,15,750,765
8047,Whately,Franklin County,MA,Whately,1995,2.2,19,844,863
8048,Whately,Franklin County,MA,Whately,1996,1.8,16,854,870
8049,Whately,Franklin County,MA,Whately,1997,1.9,17,876,893
8050,Whately,Franklin County,MA,Whately,1998,1.3,11,805,816
8051,Whately,Franklin County,MA,Whately,1999,1.6,13,825,838
8052,Whately,Franklin County,MA,Whately,2000,1.6,15,952,967
8053,Whately,Franklin County,MA,Whately,2001,2,19,955,974
8054,Whately,Franklin County,MA,Whately,2002,2.6,25,955,980
8055,Whately,Franklin County,MA,Whately,2003,2.9,28,940,968
8056,Whately,Franklin County,MA,Whately,2004,3.3,32,948,980
8057,Whately,Franklin County,MA,Whately,2005,3,29,951,980
8058,Whately,Franklin County,MA,Whately,2006,2.9,28,952,980
8059,Whately,Franklin County,MA,Whately,2007,2.6,25,942,967
8060,Whately,Franklin County,MA,Whately,2008,3.6,35,941,976
8061,Whately,Franklin County,MA,Whately,2009,4.9,46,900,946
8062,Whately,Franklin County,MA,Whately,2010,4.4,40,860,900
8063,Whately,Franklin County,MA,Whately,2011,4.3,38,853,891
8064,Whately,Franklin County,MA,Whately,2012,3.8,34,854,888
8065,Whitman,Plymouth County,MA,Whitman,1990,7,501,6668,7169
8066,Whitman,Plymouth County,MA,Whitman,1991,10.9,783,6411,7194
8067,Whitman,Plymouth County,MA,Whitman,1992,11.2,796,6325,7121
8068,Whitman,Plymouth County,MA,Whitman,1993,8.5,607,6531,7138
8069,Whitman,Plymouth County,MA,Whitman,1994,6.2,450,6866,7316
8070,Whitman,Plymouth County,MA,Whitman,1995,5.4,402,6986,7388
8071,Whitman,Plymouth County,MA,Whitman,1996,5.3,395,7078,7473
8072,Whitman,Plymouth County,MA,Whitman,1997,4,303,7350,7653
8073,Whitman,Plymouth County,MA,Whitman,1998,3.3,256,7499,7755
8074,Whitman,Plymouth County,MA,Whitman,1999,3,242,7708,7950
8075,Whitman,Plymouth County,MA,Whitman,2000,2.5,197,7829,8026
8076,Whitman,Plymouth County,MA,Whitman,2001,3.3,270,7898,8168
8077,Whitman,Plymouth County,MA,Whitman,2002,4.7,387,7816,8203
8078,Whitman,Plymouth County,MA,Whitman,2003,5.7,461,7640,8101
8079,Whitman,Plymouth County,MA,Whitman,2004,5.2,416,7618,8034
8080,Whitman,Plymouth County,MA,Whitman,2005,5,404,7689,8093
8081,Whitman,Plymouth County,MA,Whitman,2006,5.2,430,7800,8230
8082,Whitman,Plymouth County,MA,Whitman,2007,4.9,404,7866,8270
8083,Whitman,Plymouth County,MA,Whitman,2008,5.6,466,7845,8311
8084,Whitman,Plymouth County,MA,Whitman,2009,8.9,730,7445,8175
8085,Whitman,Plymouth County,MA,Whitman,2010,8.5,706,7594,8300
8086,Whitman,Plymouth County,MA,Whitman,2011,7.9,655,7667,8322
8087,Whitman,Plymouth County,MA,Whitman,2012,6.9,573,7734,8307
8088,Wilbraham,Hampden County,MA,Wilbraham,1990,4.4,293,6423,6716
8089,Wilbraham,Hampden County,MA,Wilbraham,1991,6.1,399,6126,6525
8090,Wilbraham,Hampden County,MA,Wilbraham,1992,5.7,371,6155,6526
8091,Wilbraham,Hampden County,MA,Wilbraham,1993,6,396,6163,6559
8092,Wilbraham,Hampden County,MA,Wilbraham,1994,5.1,331,6182,6513
8093,Wilbraham,Hampden County,MA,Wilbraham,1995,4.4,280,6154,6434
8094,Wilbraham,Hampden County,MA,Wilbraham,1996,3.5,226,6237,6463
8095,Wilbraham,Hampden County,MA,Wilbraham,1997,3,197,6388,6585
8096,Wilbraham,Hampden County,MA,Wilbraham,1998,2.8,189,6471,6660
8097,Wilbraham,Hampden County,MA,Wilbraham,1999,2.3,155,6525,6680
8098,Wilbraham,Hampden County,MA,Wilbraham,2000,2.5,171,6543,6714
8099,Wilbraham,Hampden County,MA,Wilbraham,2001,3,203,6621,6824
8100,Wilbraham,Hampden County,MA,Wilbraham,2002,3.9,265,6602,6867
8101,Wilbraham,Hampden County,MA,Wilbraham,2003,4.5,313,6582,6895
8102,Wilbraham,Hampden County,MA,Wilbraham,2004,4.4,301,6616,6917
8103,Wilbraham,Hampden County,MA,Wilbraham,2005,4.1,285,6673,6958
8104,Wilbraham,Hampden County,MA,Wilbraham,2006,4.3,305,6738,7043
8105,Wilbraham,Hampden County,MA,Wilbraham,2007,3.9,275,6751,7026
8106,Wilbraham,Hampden County,MA,Wilbraham,2008,4.6,320,6661,6981
8107,Wilbraham,Hampden County,MA,Wilbraham,2009,6.9,474,6442,6916
8108,Wilbraham,Hampden County,MA,Wilbraham,2010,6.9,480,6488,6968
8109,Wilbraham,Hampden County,MA,Wilbraham,2011,6.4,437,6423,6860
8110,Wilbraham,Hampden County,MA,Wilbraham,2012,5.8,396,6427,6823
8111,Williamsburg,Hampshire County,MA,Williamsburg,1990,5.9,92,1455,1547
8112,Williamsburg,Hampshire County,MA,Williamsburg,1991,8.1,123,1404,1527
8113,Williamsburg,Hampshire County,MA,Williamsburg,1992,9.2,141,1397,1538
8114,Williamsburg,Hampshire County,MA,Williamsburg,1993,6.6,100,1410,1510
8115,Williamsburg,Hampshire County,MA,Williamsburg,1994,7.9,121,1418,1539
8116,Williamsburg,Hampshire County,MA,Williamsburg,1995,6.2,95,1449,1544
8117,Williamsburg,Hampshire County,MA,Williamsburg,1996,5,78,1471,1549
8118,Williamsburg,Hampshire County,MA,Williamsburg,1997,4.1,64,1500,1564
8119,Williamsburg,Hampshire County,MA,Williamsburg,1998,3.5,57,1551,1608
8120,Williamsburg,Hampshire County,MA,Williamsburg,1999,3.5,56,1557,1613
8121,Williamsburg,Hampshire County,MA,Williamsburg,2000,2.6,39,1462,1501
8122,Williamsburg,Hampshire County,MA,Williamsburg,2001,3.2,48,1454,1502
8123,Williamsburg,Hampshire County,MA,Williamsburg,2002,4.7,71,1453,1524
8124,Williamsburg,Hampshire County,MA,Williamsburg,2003,4.8,73,1443,1516
8125,Williamsburg,Hampshire County,MA,Williamsburg,2004,4.3,65,1441,1506
8126,Williamsburg,Hampshire County,MA,Williamsburg,2005,4.6,69,1444,1513
8127,Williamsburg,Hampshire County,MA,Williamsburg,2006,3.9,59,1457,1516
8128,Williamsburg,Hampshire County,MA,Williamsburg,2007,3.8,57,1462,1519
8129,Williamsburg,Hampshire County,MA,Williamsburg,2008,4.4,69,1489,1558
8130,Williamsburg,Hampshire County,MA,Williamsburg,2009,7.7,118,1421,1539
8131,Williamsburg,Hampshire County,MA,Williamsburg,2010,8,122,1410,1532
8132,Williamsburg,Hampshire County,MA,Williamsburg,2011,7.1,107,1392,1499
8133,Williamsburg,Hampshire County,MA,Williamsburg,2012,5.9,87,1392,1479
8134,Williamstown,Berkshire County,MA,Williamstown,1990,5.5,213,3679,3892
8135,Williamstown,Berkshire County,MA,Williamstown,1991,7,265,3532,3797
8136,Williamstown,Berkshire County,MA,Williamstown,1992,6.4,245,3568,3813
8137,Williamstown,Berkshire County,MA,Williamstown,1993,5.5,212,3651,3863
8138,Williamstown,Berkshire County,MA,Williamstown,1994,4.5,172,3676,3848
8139,Williamstown,Berkshire County,MA,Williamstown,1995,3.3,123,3600,3723
8140,Williamstown,Berkshire County,MA,Williamstown,1996,3,111,3640,3751
8141,Williamstown,Berkshire County,MA,Williamstown,1997,3,115,3675,3790
8142,Williamstown,Berkshire County,MA,Williamstown,1998,2.1,80,3795,3875
8143,Williamstown,Berkshire County,MA,Williamstown,1999,2.1,84,3831,3915
8144,Williamstown,Berkshire County,MA,Williamstown,2000,2.6,102,3857,3959
8145,Williamstown,Berkshire County,MA,Williamstown,2001,3.2,126,3871,3997
8146,Williamstown,Berkshire County,MA,Williamstown,2002,4,162,3856,4018
8147,Williamstown,Berkshire County,MA,Williamstown,2003,4.1,165,3816,3981
8148,Williamstown,Berkshire County,MA,Williamstown,2004,4.3,170,3798,3968
8149,Williamstown,Berkshire County,MA,Williamstown,2005,4.1,164,3813,3977
8150,Williamstown,Berkshire County,MA,Williamstown,2006,4,159,3847,4006
8151,Williamstown,Berkshire County,MA,Williamstown,2007,3.8,153,3863,4016
8152,Williamstown,Berkshire County,MA,Williamstown,2008,4.2,168,3801,3969
8153,Williamstown,Berkshire County,MA,Williamstown,2009,6.5,259,3747,4006
8154,Williamstown,Berkshire County,MA,Williamstown,2010,6.6,251,3558,3809
8155,Williamstown,Berkshire County,MA,Williamstown,2011,5.6,211,3558,3769
8156,Williamstown,Berkshire County,MA,Williamstown,2012,5.2,194,3512,3706
8157,Wilmington,Middlesex County,MA,Wilmington,1990,6.4,657,9632,10289
8158,Wilmington,Middlesex County,MA,Wilmington,1991,8.7,910,9501,10411
8159,Wilmington,Middlesex County,MA,Wilmington,1992,9.4,1000,9646,10646
8160,Wilmington,Middlesex County,MA,Wilmington,1993,6.8,726,9888,10614
8161,Wilmington,Middlesex County,MA,Wilmington,1994,5.9,642,10226,10868
8162,Wilmington,Middlesex County,MA,Wilmington,1995,4.9,544,10483,11027
8163,Wilmington,Middlesex County,MA,Wilmington,1996,4.4,505,10867,11372
8164,Wilmington,Middlesex County,MA,Wilmington,1997,3.3,385,11315,11700
8165,Wilmington,Middlesex County,MA,Wilmington,1998,2.8,338,11681,12019
8166,Wilmington,Middlesex County,MA,Wilmington,1999,2.6,320,11884,12204
8167,Wilmington,Middlesex County,MA,Wilmington,2000,2.5,302,11883,12185
8168,Wilmington,Middlesex County,MA,Wilmington,2001,3.4,417,11890,12307
8169,Wilmington,Middlesex County,MA,Wilmington,2002,5,611,11701,12312
8170,Wilmington,Middlesex County,MA,Wilmington,2003,5.3,647,11532,12179
8171,Wilmington,Middlesex County,MA,Wilmington,2004,4.9,588,11534,12122
8172,Wilmington,Middlesex County,MA,Wilmington,2005,4.2,505,11604,12109
8173,Wilmington,Middlesex County,MA,Wilmington,2006,4.1,502,11660,12162
8174,Wilmington,Middlesex County,MA,Wilmington,2007,3.8,468,11795,12263
8175,Wilmington,Middlesex County,MA,Wilmington,2008,4.6,565,11820,12385
8176,Wilmington,Middlesex County,MA,Wilmington,2009,7.6,943,11536,12479
8177,Wilmington,Middlesex County,MA,Wilmington,2010,7.2,912,11687,12599
8178,Wilmington,Middlesex County,MA,Wilmington,2011,6.1,769,11858,12627
8179,Wilmington,Middlesex County,MA,Wilmington,2012,5.5,700,11988,12688
8180,Winchendon,Worcester County,MA,Winchendon,1990,8.1,352,3997,4349
8181,Winchendon,Worcester County,MA,Winchendon,1991,10.6,468,3956,4424
8182,Winchendon,Worcester County,MA,Winchendon,1992,9.3,411,4023,4434
8183,Winchendon,Worcester County,MA,Winchendon,1993,6.5,287,4129,4416
8184,Winchendon,Worcester County,MA,Winchendon,1994,7.2,322,4180,4502
8185,Winchendon,Worcester County,MA,Winchendon,1995,7.9,345,4029,4374
8186,Winchendon,Worcester County,MA,Winchendon,1996,6,256,4011,4267
8187,Winchendon,Worcester County,MA,Winchendon,1997,5.3,232,4121,4353
8188,Winchendon,Worcester County,MA,Winchendon,1998,4.1,180,4164,4344
8189,Winchendon,Worcester County,MA,Winchendon,1999,4,174,4213,4387
8190,Winchendon,Worcester County,MA,Winchendon,2000,3,145,4620,4765
8191,Winchendon,Worcester County,MA,Winchendon,2001,3.8,182,4587,4769
8192,Winchendon,Worcester County,MA,Winchendon,2002,6.5,320,4593,4913
8193,Winchendon,Worcester County,MA,Winchendon,2003,6.8,333,4569,4902
8194,Winchendon,Worcester County,MA,Winchendon,2004,6.2,300,4560,4860
8195,Winchendon,Worcester County,MA,Winchendon,2005,6.4,313,4540,4853
8196,Winchendon,Worcester County,MA,Winchendon,2006,6.1,300,4599,4899
8197,Winchendon,Worcester County,MA,Winchendon,2007,5.9,288,4611,4899
8198,Winchendon,Worcester County,MA,Winchendon,2008,7.2,352,4564,4916
8199,Winchendon,Worcester County,MA,Winchendon,2009,10.7,525,4368,4893
8200,Winchendon,Worcester County,MA,Winchendon,2010,11.1,556,4460,5016
8201,Winchendon,Worcester County,MA,Winchendon,2011,10.2,509,4458,4967
8202,Winchendon,Worcester County,MA,Winchendon,2012,9.3,456,4455,4911
8203,Winchester,Middlesex County,MA,Winchester,1990,3.6,396,10560,10956
8204,Winchester,Middlesex County,MA,Winchester,1991,5.3,568,10244,10812
8205,Winchester,Middlesex County,MA,Winchester,1992,5.3,569,10233,10802
8206,Winchester,Middlesex County,MA,Winchester,1993,4.2,456,10389,10845
8207,Winchester,Middlesex County,MA,Winchester,1994,3.6,390,10572,10962
8208,Winchester,Middlesex County,MA,Winchester,1995,3.1,337,10477,10814
8209,Winchester,Middlesex County,MA,Winchester,1996,2.4,263,10674,10937
8210,Winchester,Middlesex County,MA,Winchester,1997,2.4,273,10905,11178
8211,Winchester,Middlesex County,MA,Winchester,1998,1.8,206,11090,11296
8212,Winchester,Middlesex County,MA,Winchester,1999,1.8,203,11220,11423
8213,Winchester,Middlesex County,MA,Winchester,2000,2.1,223,10566,10789
8214,Winchester,Middlesex County,MA,Winchester,2001,2.9,316,10580,10896
8215,Winchester,Middlesex County,MA,Winchester,2002,4.3,468,10412,10880
8216,Winchester,Middlesex County,MA,Winchester,2003,4.4,473,10309,10782
8217,Winchester,Middlesex County,MA,Winchester,2004,3.8,413,10330,10743
8218,Winchester,Middlesex County,MA,Winchester,2005,3.3,351,10445,10796
8219,Winchester,Middlesex County,MA,Winchester,2006,3.4,358,10296,10654
8220,Winchester,Middlesex County,MA,Winchester,2007,3.2,339,10377,10716
8221,Winchester,Middlesex County,MA,Winchester,2008,3.7,395,10371,10766
8222,Winchester,Middlesex County,MA,Winchester,2009,6,641,10115,10756
8223,Winchester,Middlesex County,MA,Winchester,2010,5.5,590,10210,10800
8224,Winchester,Middlesex County,MA,Winchester,2011,5,542,10359,10901
8225,Winchester,Middlesex County,MA,Winchester,2012,4.4,479,10472,10951
8226,Windsor,Berkshire County,MA,Windsor,1990,3.9,16,397,413
8227,Windsor,Berkshire County,MA,Windsor,1991,9.7,42,390,432
8228,Windsor,Berkshire County,MA,Windsor,1992,5.5,25,433,458
8229,Windsor,Berkshire County,MA,Windsor,1993,6.3,31,459,490
8230,Windsor,Berkshire County,MA,Windsor,1994,4.6,24,496,520
8231,Windsor,Berkshire County,MA,Windsor,1995,4.1,20,464,484
8232,Windsor,Berkshire County,MA,Windsor,1996,3,14,449,463
8233,Windsor,Berkshire County,MA,Windsor,1997,4,19,452,471
8234,Windsor,Berkshire County,MA,Windsor,1998,2.9,14,471,485
8235,Windsor,Berkshire County,MA,Windsor,1999,3.4,18,509,527
8236,Windsor,Berkshire County,MA,Windsor,2000,2.8,14,478,492
8237,Windsor,Berkshire County,MA,Windsor,2001,2.5,12,476,488
8238,Windsor,Berkshire County,MA,Windsor,2002,4,20,481,501
8239,Windsor,Berkshire County,MA,Windsor,2003,4.8,24,478,502
8240,Windsor,Berkshire County,MA,Windsor,2004,4.4,22,478,500
8241,Windsor,Berkshire County,MA,Windsor,2005,3.7,19,488,507
8242,Windsor,Berkshire County,MA,Windsor,2006,3.5,18,497,515
8243,Windsor,Berkshire County,MA,Windsor,2007,3.5,18,499,517
8244,Windsor,Berkshire County,MA,Windsor,2008,4.5,23,489,512
8245,Windsor,Berkshire County,MA,Windsor,2009,6.7,35,489,524
8246,Windsor,Berkshire County,MA,Windsor,2010,7.6,40,488,528
8247,Windsor,Berkshire County,MA,Windsor,2011,7.2,38,492,530
8248,Windsor,Berkshire County,MA,Windsor,2012,7,37,490,527
8249,Winthrop,Suffolk County,MA,Winthrop,1990,4.9,512,10007,10519
8250,Winthrop,Suffolk County,MA,Winthrop,1991,8,836,9594,10430
8251,Winthrop,Suffolk County,MA,Winthrop,1992,7.4,765,9547,10312
8252,Winthrop,Suffolk County,MA,Winthrop,1993,6.5,669,9607,10276
8253,Winthrop,Suffolk County,MA,Winthrop,1994,6.3,657,9723,10380
8254,Winthrop,Suffolk County,MA,Winthrop,1995,5.4,539,9510,10049
8255,Winthrop,Suffolk County,MA,Winthrop,1996,3.7,370,9619,9989
8256,Winthrop,Suffolk County,MA,Winthrop,1997,3.5,359,9788,10147
8257,Winthrop,Suffolk County,MA,Winthrop,1998,2.7,279,9962,10241
8258,Winthrop,Suffolk County,MA,Winthrop,1999,2.9,298,10015,10313
8259,Winthrop,Suffolk County,MA,Winthrop,2000,2.6,259,9877,10136
8260,Winthrop,Suffolk County,MA,Winthrop,2001,3.4,347,9836,10183
8261,Winthrop,Suffolk County,MA,Winthrop,2002,5.2,527,9586,10113
8262,Winthrop,Suffolk County,MA,Winthrop,2003,6.1,599,9287,9886
8263,Winthrop,Suffolk County,MA,Winthrop,2004,5.3,505,9069,9574
8264,Winthrop,Suffolk County,MA,Winthrop,2005,4.9,458,8970,9428
8265,Winthrop,Suffolk County,MA,Winthrop,2006,4.5,453,9548,10001
8266,Winthrop,Suffolk County,MA,Winthrop,2007,4.2,430,9731,10161
8267,Winthrop,Suffolk County,MA,Winthrop,2008,4.9,502,9656,10158
8268,Winthrop,Suffolk County,MA,Winthrop,2009,7.5,779,9646,10425
8269,Winthrop,Suffolk County,MA,Winthrop,2010,8.1,781,8906,9687
8270,Winthrop,Suffolk County,MA,Winthrop,2011,6.8,662,9067,9729
8271,Winthrop,Suffolk County,MA,Winthrop,2012,6.3,620,9166,9786
8272,Woburn,Middlesex County,MA,Woburn,1990,5.9,1291,20409,21700
8273,Woburn,Middlesex County,MA,Woburn,1991,8.5,1847,19934,21781
8274,Woburn,Middlesex County,MA,Woburn,1992,8.6,1854,19779,21633
8275,Woburn,Middlesex County,MA,Woburn,1993,6.3,1339,20059,21398
8276,Woburn,Middlesex County,MA,Woburn,1994,5.9,1271,20239,21510
8277,Woburn,Middlesex County,MA,Woburn,1995,4.7,1007,20484,21491
8278,Woburn,Middlesex County,MA,Woburn,1996,3.9,848,20914,21762
8279,Woburn,Middlesex County,MA,Woburn,1997,3.4,754,21533,22287
8280,Woburn,Middlesex County,MA,Woburn,1998,2.7,610,22024,22634
8281,Woburn,Middlesex County,MA,Woburn,1999,2.7,613,22285,22898
8282,Woburn,Middlesex County,MA,Woburn,2000,2.3,489,20975,21464
8283,Woburn,Middlesex County,MA,Woburn,2001,3.4,733,20976,21709
8284,Woburn,Middlesex County,MA,Woburn,2002,5.1,1117,20796,21913
8285,Woburn,Middlesex County,MA,Woburn,2003,5.5,1185,20410,21595
8286,Woburn,Middlesex County,MA,Woburn,2004,4.8,1021,20269,21290
8287,Woburn,Middlesex County,MA,Woburn,2005,4.4,933,20319,21252
8288,Woburn,Middlesex County,MA,Woburn,2006,4.3,945,20809,21754
8289,Woburn,Middlesex County,MA,Woburn,2007,4.1,890,20949,21839
8290,Woburn,Middlesex County,MA,Woburn,2008,4.7,1024,20911,21935
8291,Woburn,Middlesex County,MA,Woburn,2009,7.8,1716,20347,22063
8292,Woburn,Middlesex County,MA,Woburn,2010,7.5,1645,20195,21840
8293,Woburn,Middlesex County,MA,Woburn,2011,6.2,1356,20495,21851
8294,Woburn,Middlesex County,MA,Woburn,2012,5.8,1268,20720,21988
8295,Worcester,Worcester County,MA,Worcester,1990,7.6,6164,74802,80966
8296,Worcester,Worcester County,MA,Worcester,1991,10.6,8433,71439,79872
8297,Worcester,Worcester County,MA,Worcester,1992,9.6,7518,70763,78281
8298,Worcester,Worcester County,MA,Worcester,1993,7.5,5818,71979,77797
8299,Worcester,Worcester County,MA,Worcester,1994,5.7,4439,72850,77289
8300,Worcester,Worcester County,MA,Worcester,1995,5.3,4107,73269,77376
8301,Worcester,Worcester County,MA,Worcester,1996,4.6,3538,74077,77615
8302,Worcester,Worcester County,MA,Worcester,1997,4.2,3307,75699,79006
8303,Worcester,Worcester County,MA,Worcester,1998,3.7,2943,76865,79808
8304,Worcester,Worcester County,MA,Worcester,1999,3.8,2985,76208,79193
8305,Worcester,Worcester County,MA,Worcester,2000,3.1,2564,79653,82217
8306,Worcester,Worcester County,MA,Worcester,2001,4.5,3708,79428,83136
8307,Worcester,Worcester County,MA,Worcester,2002,6.1,5168,78882,84050
8308,Worcester,Worcester County,MA,Worcester,2003,6.7,5643,78444,84087
8309,Worcester,Worcester County,MA,Worcester,2004,6.1,5094,78352,83446
8310,Worcester,Worcester County,MA,Worcester,2005,5.8,4797,78076,82873
8311,Worcester,Worcester County,MA,Worcester,2006,5.7,4726,77958,82684
8312,Worcester,Worcester County,MA,Worcester,2007,5.4,4460,77543,82003
8313,Worcester,Worcester County,MA,Worcester,2008,6.3,5394,80007,85401
8314,Worcester,Worcester County,MA,Worcester,2009,9.4,8068,77511,85579
8315,Worcester,Worcester County,MA,Worcester,2010,9.7,8293,76921,85214
8316,Worcester,Worcester County,MA,Worcester,2011,8.9,7561,77590,85151
8317,Worcester,Worcester County,MA,Worcester,2012,8.4,7073,77564,84637
8341,Worthington,Hampshire County,MA,Worthington,1990,4.1,24,562,586
8342,Worthington,Hampshire County,MA,Worthington,1991,7.5,44,541,585
8343,Worthington,Hampshire County,MA,Worthington,1992,7.7,51,609,660
8344,Worthington,Hampshire County,MA,Worthington,1993,7,46,612,658
8345,Worthington,Hampshire County,MA,Worthington,1994,5.7,39,650,689
8346,Worthington,Hampshire County,MA,Worthington,1995,5.1,37,682,719
8347,Worthington,Hampshire County,MA,Worthington,1996,5.8,41,665,706
8348,Worthington,Hampshire County,MA,Worthington,1997,4.8,34,669,703
8349,Worthington,Hampshire County,MA,Worthington,1998,3,22,703,725
8350,Worthington,Hampshire County,MA,Worthington,1999,3.8,30,767,797
8351,Worthington,Hampshire County,MA,Worthington,2000,2.6,18,667,685
8352,Worthington,Hampshire County,MA,Worthington,2001,3.2,22,672,694
8353,Worthington,Hampshire County,MA,Worthington,2002,3.9,27,670,697
8354,Worthington,Hampshire County,MA,Worthington,2003,4.6,32,668,700
8355,Worthington,Hampshire County,MA,Worthington,2004,5.4,38,666,704
8356,Worthington,Hampshire County,MA,Worthington,2005,4.7,33,665,698
8357,Worthington,Hampshire County,MA,Worthington,2006,5.4,38,666,704
8358,Worthington,Hampshire County,MA,Worthington,2007,4.6,32,661,693
8359,Worthington,Hampshire County,MA,Worthington,2008,5.6,39,656,695
8360,Worthington,Hampshire County,MA,Worthington,2009,7.4,50,628,678
8361,Worthington,Hampshire County,MA,Worthington,2010,7.5,46,570,616
8362,Worthington,Hampshire County,MA,Worthington,2011,6.3,38,563,601
8363,Worthington,Hampshire County,MA,Worthington,2012,7.4,45,564,609
8364,Wrentham,Norfolk County,MA,Wrentham,1990,5.4,252,4430,4682
8365,Wrentham,Norfolk County,MA,Wrentham,1991,7.1,337,4431,4768
8366,Wrentham,Norfolk County,MA,Wrentham,1992,7.5,361,4473,4834
8367,Wrentham,Norfolk County,MA,Wrentham,1993,6.3,311,4609,4920
8368,Wrentham,Norfolk County,MA,Wrentham,1994,4.6,236,4880,5116
8369,Wrentham,Norfolk County,MA,Wrentham,1995,4.3,214,4801,5015
8370,Wrentham,Norfolk County,MA,Wrentham,1996,4,208,4942,5150
8371,Wrentham,Norfolk County,MA,Wrentham,1997,2.9,154,5104,5258
8372,Wrentham,Norfolk County,MA,Wrentham,1998,2.7,145,5215,5360
8373,Wrentham,Norfolk County,MA,Wrentham,1999,2.9,158,5336,5494
8374,Wrentham,Norfolk County,MA,Wrentham,2000,2.3,126,5461,5587
8375,Wrentham,Norfolk County,MA,Wrentham,2001,3,173,5551,5724
8376,Wrentham,Norfolk County,MA,Wrentham,2002,4.5,261,5508,5769
8377,Wrentham,Norfolk County,MA,Wrentham,2003,5.3,307,5473,5780
8378,Wrentham,Norfolk County,MA,Wrentham,2004,4.8,279,5499,5778
8379,Wrentham,Norfolk County,MA,Wrentham,2005,4.3,248,5559,5807
8380,Wrentham,Norfolk County,MA,Wrentham,2006,4.5,255,5474,5729
8381,Wrentham,Norfolk County,MA,Wrentham,2007,4,229,5529,5758
8382,Wrentham,Norfolk County,MA,Wrentham,2008,5,289,5541,5830
8383,Wrentham,Norfolk County,MA,Wrentham,2009,7.5,435,5364,5799
8384,Wrentham,Norfolk County,MA,Wrentham,2010,7.7,443,5318,5761
8385,Wrentham,Norfolk County,MA,Wrentham,2011,6.7,386,5375,5761
8386,Wrentham,Norfolk County,MA,Wrentham,2012,5.9,339,5434,5773
8387,Yarmouth,Barnstable County,MA,Yarmouth,1990,6.7,676,9369,10045
8388,Yarmouth,Barnstable County,MA,Yarmouth,1991,9.6,958,9015,9973
8389,Yarmouth,Barnstable County,MA,Yarmouth,1992,11,1097,8891,9988
8390,Yarmouth,Barnstable County,MA,Yarmouth,1993,9.8,996,9126,10122
8391,Yarmouth,Barnstable County,MA,Yarmouth,1994,9,913,9250,10163
8392,Yarmouth,Barnstable County,MA,Yarmouth,1995,7.5,780,9610,10390
8393,Yarmouth,Barnstable County,MA,Yarmouth,1996,6.1,634,9812,10446
8394,Yarmouth,Barnstable County,MA,Yarmouth,1997,5.8,605,9906,10511
8395,Yarmouth,Barnstable County,MA,Yarmouth,1998,4.9,520,10041,10561
8396,Yarmouth,Barnstable County,MA,Yarmouth,1999,4.3,468,10407,10875
8397,Yarmouth,Barnstable County,MA,Yarmouth,2000,3.5,405,11246,11651
8398,Yarmouth,Barnstable County,MA,Yarmouth,2001,4.1,478,11317,11795
8399,Yarmouth,Barnstable County,MA,Yarmouth,2002,4.9,590,11489,12079
8400,Yarmouth,Barnstable County,MA,Yarmouth,2003,5.6,696,11653,12349
8401,Yarmouth,Barnstable County,MA,Yarmouth,2004,5.3,657,11714,12371
8402,Yarmouth,Barnstable County,MA,Yarmouth,2005,5.2,636,11617,12253
8403,Yarmouth,Barnstable County,MA,Yarmouth,2006,5.4,668,11602,12270
8404,Yarmouth,Barnstable County,MA,Yarmouth,2007,5.4,651,11504,12155
8405,Yarmouth,Barnstable County,MA,Yarmouth,2008,6.8,829,11378,12207
8406,Yarmouth,Barnstable County,MA,Yarmouth,2009,9.7,1186,11094,12280
8407,Yarmouth,Barnstable County,MA,Yarmouth,2010,10,1243,11227,12470
8408,Yarmouth,Barnstable County,MA,Yarmouth,2011,9,1112,11208,12320
8409,Yarmouth,Barnstable County,MA,Yarmouth,2012,8.1,1003,11396,12399
